id,name,team,gamesPlayed,points,goals,assists
0,Wayne Gretzky,Oilers,79,137,51,86
0,Wayne Gretzky,Oilers,80,164,55,109
0,Wayne Gretzky,Oilers,80,212,92,120
0,Wayne Gretzky,Oilers,80,196,71,125
0,Wayne Gretzky,Oilers,74,205,87,118
0,Wayne Gretzky,Oilers,80,208,73,135
0,Wayne Gretzky,Oilers,80,215,52,163
0,Wayne Gretzky,Oilers,79,183,62,121
0,Wayne Gretzky,Oilers,64,149,40,109
0,Wayne Gretzky,Kings,78,168,54,114
0,Wayne Gretzky,Kings,73,142,40,102
0,Wayne Gretzky,Kings,78,163,41,122
0,Wayne Gretzky,Kings,74,121,31,90
0,Wayne Gretzky,Kings,45,65,16,49
0,Wayne Gretzky,Kings,81,130,38,92
0,Wayne Gretzky,Kings,48,48,11,37
0,Wayne Gretzky,Kings,62,81,15,66
0,Wayne Gretzky,Blues,18,21,8,13
0,Wayne Gretzky,Rangers,82,97,25,72
0,Wayne Gretzky,Rangers,82,90,23,67
0,Wayne Gretzky,Rangers,70,62,9,53
1,Mark Messier,Oilers,75,33,12,21
1,Mark Messier,Oilers,72,63,23,40
1,Mark Messier,Oilers,78,88,50,38
1,Mark Messier,Oilers,77,106,48,58
1,Mark Messier,Oilers,73,101,37,64
1,Mark Messier,Oilers,55,54,23,31
1,Mark Messier,Oilers,63,84,35,49
1,Mark Messier,Oilers,77,107,37,70
1,Mark Messier,Oilers,77,111,37,74
1,Mark Messier,Oilers,72,94,33,61
1,Mark Messier,Oilers,79,129,45,84
1,Mark Messier,Oilers,53,64,12,52
1,Mark Messier,Rangers,79,107,35,72
1,Mark Messier,Rangers,75,91,25,66
1,Mark Messier,Rangers,76,84,26,58
1,Mark Messier,Rangers,46,53,14,39
1,Mark Messier,Rangers,74,99,47,52
1,Mark Messier,Rangers,71,84,36,48
1,Mark Messier,Canucks,82,60,22,38
1,Mark Messier,Canucks,59,48,13,35
1,Mark Messier,Canucks,66,54,17,37
1,Mark Messier,Rangers,82,67,24,43
1,Mark Messier,Rangers,41,23,7,16
1,Mark Messier,Rangers,78,40,18,22
1,Mark Messier,Rangers,76,43,18,25
2,Gordie Howe,Red Wings,58,22,7,15
2,Gordie Howe,Red Wings,60,44,16,28
2,Gordie Howe,Red Wings,40,37,12,25
2,Gordie Howe,Red Wings,70,68,35,33
2,Gordie Howe,Red Wings,70,86,43,43
2,Gordie Howe,Red Wings,70,86,47,39
2,Gordie Howe,Red Wings,70,95,49,46
2,Gordie Howe,Red Wings,70,81,33,48
2,Gordie Howe,Red Wings,64,62,29,33
2,Gordie Howe,Red Wings,70,79,38,41
2,Gordie Howe,Red Wings,70,89,44,45
2,Gordie Howe,Red Wings,64,77,33,44
2,Gordie Howe,Red Wings,70,78,32,46
2,Gordie Howe,Red Wings,70,73,28,45
2,Gordie Howe,Red Wings,64,72,23,49
2,Gordie Howe,Red Wings,70,77,33,44
2,Gordie Howe,Red Wings,70,86,38,48
2,Gordie Howe,Red Wings,69,73,26,47
2,Gordie Howe,Red Wings,70,76,29,47
2,Gordie Howe,Red Wings,70,75,29,46
2,Gordie Howe,Red Wings,69,65,25,40
2,Gordie Howe,Red Wings,74,82,39,43
2,Gordie Howe,Red Wings,76,103,44,59
2,Gordie Howe,Red Wings,76,71,31,40
2,Gordie Howe,Red Wings,63,52,23,29
2,Gordie Howe,Whalers,80,41,15,26
3,Ron Francis,Whalers,59,68,25,43
3,Ron Francis,Whalers,79,90,31,59
3,Ron Francis,Whalers,72,83,23,60
3,Ron Francis,Whalers,80,81,24,57
3,Ron Francis,Whalers,53,77,24,53
3,Ron Francis,Whalers,75,93,30,63
3,Ron Francis,Whalers,80,75,25,50
3,Ron Francis,Whalers,69,77,29,48
3,Ron Francis,Whalers,80,101,32,69
3,Ron Francis,Whalers,67,76,21,55
3,Ron Francis,Penguins,14,11,2,9
3,Ron Francis,Penguins,70,54,21,33
3,Ron Francis,Penguins,84,100,24,76
3,Ron Francis,Penguins,82,93,27,66
3,Ron Francis,Penguins,44,59,11,48
3,Ron Francis,Penguins,77,119,27,92
3,Ron Francis,Penguins,81,90,27,63
3,Ron Francis,Penguins,81,87,25,62
3,Ron Francis,Hurricanes,82,52,21,31
3,Ron Francis,Hurricanes,78,73,23,50
3,Ron Francis,Hurricanes,82,65,15,50
3,Ron Francis,Hurricanes,80,77,27,50
3,Ron Francis,Hurricanes,82,57,22,35
3,Ron Francis,Hurricanes,68,30,10,20
3,Ron Francis,Maple Leafs,12,10,3,7
4,Marcel Dionne,Red Wings,78,77,28,49
4,Marcel Dionne,Red Wings,77,90,40,50
4,Marcel Dionne,Red Wings,74,78,24,54
4,Marcel Dionne,Red Wings,80,121,47,74
4,Marcel Dionne,Kings,80,94,40,54
4,Marcel Dionne,Kings,80,122,53,69
4,Marcel Dionne,Kings,70,79,36,43
4,Marcel Dionne,Kings,80,130,59,71
4,Marcel Dionne,Kings,80,137,53,84
4,Marcel Dionne,Kings,80,135,58,77
4,Marcel Dionne,Kings,78,117,50,67
4,Marcel Dionne,Kings,80,107,56,51
4,Marcel Dionne,Kings,66,92,39,53
4,Marcel Dionne,Kings,80,126,46,80
4,Marcel Dionne,Kings,80,94,36,58
4,Marcel Dionne,Kings,67,74,24,50
4,Marcel Dionne,Rangers,14,10,4,6
4,Marcel Dionne,Rangers,67,65,31,34
4,Marcel Dionne,Rangers,37,23,7,16
5,Jaromir Jagr,Penguins,80,57,27,30
5,Jaromir Jagr,Penguins,70,69,32,37
5,Jaromir Jagr,Penguins,81,94,34,60
5,Jaromir Jagr,Penguins,80,99,32,67
5,Jaromir Jagr,Penguins,48,70,32,38
5,Jaromir Jagr,Penguins,82,149,62,87
5,Jaromir Jagr,Penguins,63,95,47,48
5,Jaromir Jagr,Penguins,77,102,35,67
5,Jaromir Jagr,Penguins,81,127,44,83
5,Jaromir Jagr,Penguins,63,96,42,54
5,Jaromir Jagr,Penguins,81,121,52,69
5,Jaromir Jagr,Capitals,69,79,31,48
5,Jaromir Jagr,Capitals,75,77,36,41
5,Jaromir Jagr,Capitals,46,45,16,29
5,Jaromir Jagr,Rangers,31,29,15,14
5,Jaromir Jagr,Rangers,82,123,54,69
5,Jaromir Jagr,Rangers,82,96,30,66
5,Jaromir Jagr,Rangers,82,71,25,46
5,Jaromir Jagr,Flyers,73,54,19,35
5,Jaromir Jagr,Stars,34,26,14,12
5,Jaromir Jagr,Bruins,11,9,2,7
5,Jaromir Jagr,Devils,82,67,24,43
5,Jaromir Jagr,Devils,14,9,2,7
6,Steve Yzerman,Red Wings,80,87,39,48
6,Steve Yzerman,Red Wings,80,89,30,59
6,Steve Yzerman,Red Wings,51,42,14,28
6,Steve Yzerman,Red Wings,80,90,31,59
6,Steve Yzerman,Red Wings,64,102,50,52
6,Steve Yzerman,Red Wings,80,155,65,90
6,Steve Yzerman,Red Wings,79,127,62,65
6,Steve Yzerman,Red Wings,80,108,51,57
6,Steve Yzerman,Red Wings,79,103,45,58
6,Steve Yzerman,Red Wings,84,137,58,79
6,Steve Yzerman,Red Wings,58,82,24,58
6,Steve Yzerman,Red Wings,47,38,12,26
6,Steve Yzerman,Red Wings,80,95,36,59
6,Steve Yzerman,Red Wings,81,85,22,63
6,Steve Yzerman,Red Wings,75,69,24,45
6,Steve Yzerman,Red Wings,80,74,29,45
6,Steve Yzerman,Red Wings,78,79,35,44
6,Steve Yzerman,Red Wings,54,52,18,34
6,Steve Yzerman,Red Wings,52,48,13,35
6,Steve Yzerman,Red Wings,16,8,2,6
6,Steve Yzerman,Red Wings,75,51,18,33
6,Steve Yzerman,Red Wings,61,34,14,20
7,Mario Lemieux,Penguins,73,100,43,57
7,Mario Lemieux,Penguins,79,141,48,93
7,Mario Lemieux,Penguins,63,107,54,53
7,Mario Lemieux,Penguins,77,168,70,98
7,Mario Lemieux,Penguins,76,199,85,114
7,Mario Lemieux,Penguins,59,123,45,78
7,Mario Lemieux,Penguins,26,45,19,26
7,Mario Lemieux,Penguins,64,131,44,87
7,Mario Lemieux,Penguins,60,160,69,91
7,Mario Lemieux,Penguins,22,37,17,20
7,Mario Lemieux,Penguins,70,161,69,92
7,Mario Lemieux,Penguins,76,122,50,72
7,Mario Lemieux,Penguins,43,76,35,41
7,Mario Lemieux,Penguins,24,31,6,25
7,Mario Lemieux,Penguins,67,91,28,63
7,Mario Lemieux,Penguins,10,9,1,8
7,Mario Lemieux,Penguins,26,22,7,15
8,Joe Sakic,Nordiques,70,62,23,39
8,Joe Sakic,Nordiques,80,102,39,63
8,Joe Sakic,Nordiques,80,109,48,61
8,Joe Sakic,Nordiques,69,94,29,65
8,Joe Sakic,Nordiques,78,105,48,57
8,Joe Sakic,Nordiques,84,92,28,64
8,Joe Sakic,Nordiques,47,62,19,43
8,Joe Sakic,Avalanche,82,120,51,69
8,Joe Sakic,Avalanche,65,74,22,52
8,Joe Sakic,Avalanche,64,63,27,36
8,Joe Sakic,Avalanche,73,96,41,55
8,Joe Sakic,Avalanche,60,81,28,53
8,Joe Sakic,Avalanche,82,118,54,64
8,Joe Sakic,Avalanche,82,79,26,53
8,Joe Sakic,Avalanche,58,58,26,32
8,Joe Sakic,Avalanche,81,87,33,54
8,Joe Sakic,Avalanche,82,87,32,55
8,Joe Sakic,Avalanche,82,100,36,64
8,Joe Sakic,Avalanche,44,40,13,27
8,Joe Sakic,Avalanche,15,12,2,10
9,Phil Esposito,Blackhawks,27,5,3,2
9,Phil Esposito,Blackhawks,70,55,23,32
9,Phil Esposito,Blackhawks,69,53,27,26
9,Phil Esposito,Blackhawks,69,61,21,40
9,Phil Esposito,Bruins,74,84,35,49
9,Phil Esposito,Bruins,74,126,49,77
9,Phil Esposito,Bruins,76,99,43,56
9,Phil Esposito,Bruins,78,152,76,76
9,Phil Esposito,Bruins,76,133,66,67
9,Phil Esposito,Bruins,78,130,55,75
9,Phil Esposito,Bruins,78,145,68,77
9,Phil Esposito,Bruins,79,127,61,66
9,Phil Esposito,Bruins,12,16,6,10
9,Phil Esposito,Rangers,62,67,29,38
9,Phil Esposito,Rangers,80,80,34,46
9,Phil Esposito,Rangers,79,81,38,43
9,Phil Esposito,Rangers,80,78,42,36
9,Phil Esposito,Rangers,80,78,34,44
9,Phil Esposito,Rangers,41,20,7,13
10,Ray Bourque,Bruins,80,65,17,48
10,Ray Bourque,Bruins,67,56,27,29
10,Ray Bourque,Bruins,65,66,17,49
10,Ray Bourque,Bruins,65,73,22,51
10,Ray Bourque,Bruins,78,96,31,65
10,Ray Bourque,Bruins,73,86,20,66
10,Ray Bourque,Bruins,74,77,19,58
10,Ray Bourque,Bruins,78,95,23,72
10,Ray Bourque,Bruins,78,81,17,64
10,Ray Bourque,Bruins,60,61,18,43
10,Ray Bourque,Bruins,76,84,19,65
10,Ray Bourque,Bruins,76,94,21,73
10,Ray Bourque,Bruins,80,81,21,60
10,Ray Bourque,Bruins,78,82,19,63
10,Ray Bourque,Bruins,72,91,20,71
10,Ray Bourque,Bruins,46,43,12,31
10,Ray Bourque,Bruins,82,82,20,62
10,Ray Bourque,Bruins,62,50,19,31
10,Ray Bourque,Bruins,82,48,13,35
10,Ray Bourque,Bruins,81,57,10,47
10,Ray Bourque,Bruins,65,38,10,28
10,Ray Bourque,Avalanche,14,14,8,6
10,Ray Bourque,Avalanche,80,59,7,52
11,Mark Recchi,Penguins,15,2,1,1
11,Mark Recchi,Penguins,74,67,30,37
11,Mark Recchi,Penguins,78,113,40,73
11,Mark Recchi,Penguins,58,70,33,37
11,Mark Recchi,Flyers,22,27,10,17
11,Mark Recchi,Flyers,84,123,53,70
11,Mark Recchi,Flyers,84,107,40,67
11,Mark Recchi,Flyers,10,5,2,3
11,Mark Recchi,Canadiens,39,43,14,29
11,Mark Recchi,Canadiens,82,78,28,50
11,Mark Recchi,Canadiens,82,80,34,46
11,Mark Recchi,Canadiens,82,74,32,42
11,Mark Recchi,Canadiens,61,47,12,35
11,Mark Recchi,Flyers,10,6,4,2
11,Mark Recchi,Flyers,82,91,28,63
11,Mark Recchi,Flyers,69,77,27,50
11,Mark Recchi,Flyers,80,64,22,42
11,Mark Recchi,Flyers,79,52,20,32
11,Mark Recchi,Flyers,82,75,26,49
11,Mark Recchi,Penguins,63,57,24,33
11,Mark Recchi,Hurricanes,20,7,4,3
11,Mark Recchi,Penguins,82,68,24,44
11,Mark Recchi,Penguins,19,8,2,6
11,Mark Recchi,Thrashers,53,40,12,28
11,Mark Recchi,Lightning,62,45,13,32
11,Mark Recchi,Bruins,18,16,10,6
11,Mark Recchi,Bruins,81,43,18,25
11,Mark Recchi,Bruins,81,48,14,34
12,Paul Coffey,Oilers,74,32,9,23
12,Paul Coffey,Oilers,80,89,29,60
12,Paul Coffey,Oilers,80,96,29,67
12,Paul Coffey,Oilers,80,126,40,86
12,Paul Coffey,Oilers,80,121,37,84
12,Paul Coffey,Oilers,79,138,48,90
12,Paul Coffey,Oilers,59,67,17,50
12,Paul Coffey,Penguins,46,67,15,52
12,Paul Coffey,Penguins,75,113,30,83
12,Paul Coffey,Penguins,80,103,29,74
12,Paul Coffey,Penguins,76,93,24,69
12,Paul Coffey,Penguins,54,64,10,54
12,Paul Coffey,Kings,10,5,1,4
12,Paul Coffey,Kings,50,57,8,49
12,Paul Coffey,Red Wings,30,30,4,26
12,Paul Coffey,Red Wings,80,77,14,63
12,Paul Coffey,Red Wings,45,58,14,44
12,Paul Coffey,Red Wings,76,74,14,60
12,Paul Coffey,Whalers,20,8,3,5
12,Paul Coffey,Flyers,37,26,6,20
12,Paul Coffey,Flyers,57,29,2,27
12,Paul Coffey,Blackhawks,10,4,0,4
12,Paul Coffey,Hurricanes,44,10,2,8
12,Paul Coffey,Hurricanes,69,40,11,29
12,Paul Coffey,Bruins,18,4,0,4
13,Stan Mikita,Blackhawks,3,1,0,1
13,Stan Mikita,Blackhawks,67,26,8,18
13,Stan Mikita,Blackhawks,66,53,19,34
13,Stan Mikita,Blackhawks,70,77,25,52
13,Stan Mikita,Blackhawks,65,76,31,45
13,Stan Mikita,Blackhawks,70,89,39,50
13,Stan Mikita,Blackhawks,70,87,28,59
13,Stan Mikita,Blackhawks,68,78,30,48
13,Stan Mikita,Blackhawks,70,97,35,62
13,Stan Mikita,Blackhawks,72,87,40,47
13,Stan Mikita,Blackhawks,74,97,30,67
13,Stan Mikita,Blackhawks,76,86,39,47
13,Stan Mikita,Blackhawks,74,72,24,48
13,Stan Mikita,Blackhawks,74,65,26,39
13,Stan Mikita,Blackhawks,57,83,27,56
13,Stan Mikita,Blackhawks,76,80,30,50
13,Stan Mikita,Blackhawks,79,86,36,50
13,Stan Mikita,Blackhawks,48,57,16,41
13,Stan Mikita,Blackhawks,57,49,19,30
13,Stan Mikita,Blackhawks,76,59,18,41
13,Stan Mikita,Blackhawks,65,55,19,36
13,Stan Mikita,Blackhawks,17,7,2,5
14,Teemu Selanne,Jets (1979),84,132,76,56
14,Teemu Selanne,Jets (1979),51,54,25,29
14,Teemu Selanne,Jets (1979),45,48,22,26
14,Teemu Selanne,Jets (1979),51,72,24,48
14,Teemu Selanne,Ducks,28,36,16,20
14,Teemu Selanne,Ducks,78,109,51,58
14,Teemu Selanne,Ducks,73,86,52,34
14,Teemu Selanne,Ducks,75,107,47,60
14,Teemu Selanne,Ducks,79,85,33,52
14,Teemu Selanne,Ducks,61,59,26,33
14,Teemu Selanne,Sharks,12,13,7,6
14,Teemu Selanne,Sharks,82,54,29,25
14,Teemu Selanne,Sharks,82,64,28,36
14,Teemu Selanne,Avalanche,78,32,16,16
14,Teemu Selanne,Ducks,80,90,40,50
14,Teemu Selanne,Ducks,82,94,48,46
14,Teemu Selanne,Ducks,26,23,12,11
14,Teemu Selanne,Ducks,65,54,27,27
14,Teemu Selanne,Ducks,54,48,27,21
14,Teemu Selanne,Ducks,73,80,31,49
14,Teemu Selanne,Ducks,82,66,26,40
14,Teemu Selanne,Ducks,46,24,12,12
14,Teemu Selanne,Ducks,64,27,9,18
15,Bryan Trottier,Islanders,80,95,32,63
15,Bryan Trottier,Islanders,76,72,30,42
15,Bryan Trottier,Islanders,77,123,46,77
15,Bryan Trottier,Islanders,76,134,47,87
15,Bryan Trottier,Islanders,78,104,42,62
15,Bryan Trottier,Islanders,73,103,31,72
15,Bryan Trottier,Islanders,80,129,50,79
15,Bryan Trottier,Islanders,80,89,34,55
15,Bryan Trottier,Islanders,68,111,40,71
15,Bryan Trottier,Islanders,68,59,28,31
15,Bryan Trottier,Islanders,78,96,37,59
15,Bryan Trottier,Islanders,80,87,23,64
15,Bryan Trottier,Islanders,77,82,30,52
15,Bryan Trottier,Islanders,73,45,17,28
15,Bryan Trottier,Islanders,59,24,13,11
15,Bryan Trottier,Penguins,52,28,9,19
15,Bryan Trottier,Penguins,63,29,11,18
15,Bryan Trottier,Penguins,41,15,4,11
16,Adam Oates,Red Wings,38,20,9,11
16,Adam Oates,Red Wings,76,47,15,32
16,Adam Oates,Red Wings,63,54,14,40
16,Adam Oates,Red Wings,69,78,16,62
16,Adam Oates,Blues,80,102,23,79
16,Adam Oates,Blues,61,115,25,90
16,Adam Oates,Blues,54,69,10,59
16,Adam Oates,Bruins,26,30,10,20
16,Adam Oates,Bruins,84,142,45,97
16,Adam Oates,Bruins,77,112,32,80
16,Adam Oates,Bruins,48,53,12,41
16,Adam Oates,Bruins,70,92,25,67
16,Adam Oates,Bruins,63,70,18,52
16,Adam Oates,Capitals,17,12,4,8
16,Adam Oates,Capitals,82,76,18,58
16,Adam Oates,Capitals,59,54,12,42
16,Adam Oates,Capitals,82,71,15,56
16,Adam Oates,Capitals,81,82,13,69
16,Adam Oates,Capitals,66,68,11,57
16,Adam Oates,Flyers,14,10,3,7
16,Adam Oates,Ducks,67,45,9,36
16,Adam Oates,Oilers,60,18,2,16
17,Doug Gilmour,Blues,80,53,25,28
17,Doug Gilmour,Blues,78,57,21,36
17,Doug Gilmour,Blues,74,53,25,28
17,Doug Gilmour,Blues,80,105,42,63
17,Doug Gilmour,Blues,72,86,36,50
17,Doug Gilmour,Flames,72,85,26,59
17,Doug Gilmour,Flames,78,91,24,67
17,Doug Gilmour,Flames,78,81,20,61
17,Doug Gilmour,Flames,38,38,11,27
17,Doug Gilmour,Maple Leafs,40,49,15,34
17,Doug Gilmour,Maple Leafs,83,127,32,95
17,Doug Gilmour,Maple Leafs,83,111,27,84
17,Doug Gilmour,Maple Leafs,44,33,10,23
17,Doug Gilmour,Maple Leafs,81,72,32,40
17,Doug Gilmour,Maple Leafs,61,60,15,45
17,Doug Gilmour,Devils,20,22,7,15
17,Doug Gilmour,Devils,63,53,13,40
17,Doug Gilmour,Blackhawks,72,56,16,40
17,Doug Gilmour,Blackhawks,63,56,22,34
17,Doug Gilmour,Sabres,11,17,3,14
17,Doug Gilmour,Sabres,71,38,7,31
17,Doug Gilmour,Canadiens,70,41,10,31
17,Doug Gilmour,Canadiens,61,30,11,19
17,Doug Gilmour,Maple Leafs,1,0,0,0
18,Dale Hawerchuk,Jets (1979),80,103,45,58
18,Dale Hawerchuk,Jets (1979),79,91,40,51
18,Dale Hawerchuk,Jets (1979),80,102,37,65
18,Dale Hawerchuk,Jets (1979),80,130,53,77
18,Dale Hawerchuk,Jets (1979),80,105,46,59
18,Dale Hawerchuk,Jets (1979),80,100,47,53
18,Dale Hawerchuk,Jets (1979),80,121,44,77
18,Dale Hawerchuk,Jets (1979),75,96,41,55
18,Dale Hawerchuk,Jets (1979),79,81,26,55
18,Dale Hawerchuk,Sabres,80,89,31,58
18,Dale Hawerchuk,Sabres,77,98,23,75
18,Dale Hawerchuk,Sabres,81,96,16,80
18,Dale Hawerchuk,Sabres,81,86,35,51
18,Dale Hawerchuk,Sabres,23,16,5,11
18,Dale Hawerchuk,Blues,66,41,13,28
18,Dale Hawerchuk,Flyers,16,20,4,16
18,Dale Hawerchuk,Flyers,51,34,12,22
19,Jari Kurri,Oilers,75,75,32,43
19,Jari Kurri,Oilers,71,86,32,54
19,Jari Kurri,Oilers,80,104,45,59
19,Jari Kurri,Oilers,64,113,52,61
19,Jari Kurri,Oilers,73,135,71,64
19,Jari Kurri,Oilers,78,131,68,63
19,Jari Kurri,Oilers,79,108,54,54
19,Jari Kurri,Oilers,80,96,43,53
19,Jari Kurri,Oilers,76,102,44,58
19,Jari Kurri,Oilers,78,93,33,60
19,Jari Kurri,Kings,73,60,23,37
19,Jari Kurri,Kings,82,87,27,60
19,Jari Kurri,Kings,81,77,31,46
19,Jari Kurri,Kings,38,29,10,19
19,Jari Kurri,Kings,57,40,17,23
19,Jari Kurri,Rangers,14,5,1,4
19,Jari Kurri,Ducks,82,35,13,22
19,Jari Kurri,Avalanche,70,22,5,17
20,Luc Robitaille,Kings,79,84,45,39
20,Luc Robitaille,Kings,80,111,53,58
20,Luc Robitaille,Kings,78,98,46,52
20,Luc Robitaille,Kings,80,101,52,49
20,Luc Robitaille,Kings,76,91,45,46
20,Luc Robitaille,Kings,80,107,44,63
20,Luc Robitaille,Kings,84,125,63,62
20,Luc Robitaille,Kings,83,86,44,42
20,Luc Robitaille,Penguins,46,42,23,19
20,Luc Robitaille,Rangers,77,69,23,46
20,Luc Robitaille,Rangers,69,48,24,24
20,Luc Robitaille,Kings,57,40,16,24
20,Luc Robitaille,Kings,82,74,39,35
20,Luc Robitaille,Kings,71,74,36,38
20,Luc Robitaille,Kings,82,88,37,51
20,Luc Robitaille,Red Wings,81,50,30,20
20,Luc Robitaille,Red Wings,81,31,11,20
20,Luc Robitaille,Kings,80,51,22,29
20,Luc Robitaille,Kings,65,24,15,9
21,Brett Hull,Flames,5,1,1,0
21,Brett Hull,Flames,52,50,26,24
21,Brett Hull,Blues,13,14,6,8
21,Brett Hull,Blues,78,84,41,43
21,Brett Hull,Blues,80,113,72,41
21,Brett Hull,Blues,78,131,86,45
21,Brett Hull,Blues,73,109,70,39
21,Brett Hull,Blues,80,101,54,47
21,Brett Hull,Blues,81,97,57,40
21,Brett Hull,Blues,48,50,29,21
21,Brett Hull,Blues,70,83,43,40
21,Brett Hull,Blues,77,82,42,40
21,Brett Hull,Blues,66,72,27,45
21,Brett Hull,Stars,60,58,32,26
21,Brett Hull,Stars,79,59,24,35
21,Brett Hull,Stars,79,79,39,40
21,Brett Hull,Red Wings,82,63,30,33
21,Brett Hull,Red Wings,82,76,37,39
21,Brett Hull,Red Wings,81,68,25,43
21,Brett Hull,Coyotes,5,1,0,1
22,Mike Modano,North Stars,80,75,29,46
22,Mike Modano,North Stars,79,64,28,36
22,Mike Modano,North Stars,76,77,33,44
22,Mike Modano,North Stars,82,93,33,60
22,Mike Modano,Stars,76,93,50,43
22,Mike Modano,Stars,30,29,12,17
22,Mike Modano,Stars,78,81,36,45
22,Mike Modano,Stars,80,83,35,48
22,Mike Modano,Stars,52,59,21,38
22,Mike Modano,Stars,77,81,34,47
22,Mike Modano,Stars,77,81,38,43
22,Mike Modano,Stars,81,84,33,51
22,Mike Modano,Stars,78,77,34,43
22,Mike Modano,Stars,79,85,28,57
22,Mike Modano,Stars,76,44,14,30
22,Mike Modano,Stars,78,77,27,50
22,Mike Modano,Stars,59,43,22,21
22,Mike Modano,Stars,82,57,21,36
22,Mike Modano,Stars,80,46,15,31
22,Mike Modano,Stars,59,30,14,16
22,Mike Modano,Red Wings,40,15,4,11
23,John Bucyk,Red Wings,38,9,1,8
23,John Bucyk,Red Wings,66,21,10,11
23,John Bucyk,Bruins,68,52,21,31
23,John Bucyk,Bruins,69,60,24,36
23,John Bucyk,Bruins,56,52,16,36
23,John Bucyk,Bruins,70,39,19,20
23,John Bucyk,Bruins,67,60,20,40
23,John Bucyk,Bruins,69,66,27,39
23,John Bucyk,Bruins,62,54,18,36
23,John Bucyk,Bruins,68,55,26,29
23,John Bucyk,Bruins,63,57,27,30
23,John Bucyk,Bruins,59,48,18,30
23,John Bucyk,Bruins,72,69,30,39
23,John Bucyk,Bruins,70,66,24,42
23,John Bucyk,Bruins,76,69,31,38
23,John Bucyk,Bruins,78,116,51,65
23,John Bucyk,Bruins,78,83,32,51
23,John Bucyk,Bruins,78,93,40,53
23,John Bucyk,Bruins,76,75,31,44
23,John Bucyk,Bruins,78,81,29,52
23,John Bucyk,Bruins,77,83,36,47
23,John Bucyk,Bruins,49,43,20,23
23,John Bucyk,Bruins,53,18,5,13
24,Brendan Shanahan,Devils,65,26,7,19
24,Brendan Shanahan,Devils,68,50,22,28
24,Brendan Shanahan,Devils,73,72,30,42
24,Brendan Shanahan,Devils,75,66,29,37
24,Brendan Shanahan,Blues,80,69,33,36
24,Brendan Shanahan,Blues,71,94,51,43
24,Brendan Shanahan,Blues,81,102,52,50
24,Brendan Shanahan,Blues,45,41,20,21
24,Brendan Shanahan,Whalers,74,78,44,34
24,Brendan Shanahan,Whalers,2,1,1,0
24,Brendan Shanahan,Red Wings,79,87,46,41
24,Brendan Shanahan,Red Wings,75,57,28,29
24,Brendan Shanahan,Red Wings,81,58,31,27
24,Brendan Shanahan,Red Wings,78,78,41,37
24,Brendan Shanahan,Red Wings,81,76,31,45
24,Brendan Shanahan,Red Wings,80,75,37,38
24,Brendan Shanahan,Red Wings,78,68,30,38
24,Brendan Shanahan,Red Wings,82,53,25,28
24,Brendan Shanahan,Red Wings,82,81,40,41
24,Brendan Shanahan,Rangers,67,62,29,33
24,Brendan Shanahan,Rangers,73,46,23,23
24,Brendan Shanahan,Devils,34,14,6,8
25,Guy Lafleur,Canadiens,73,64,29,35
25,Guy Lafleur,Canadiens,69,55,28,27
25,Guy Lafleur,Canadiens,73,56,21,35
25,Guy Lafleur,Canadiens,70,119,53,66
25,Guy Lafleur,Canadiens,80,125,56,69
25,Guy Lafleur,Canadiens,80,136,56,80
25,Guy Lafleur,Canadiens,78,132,60,72
25,Guy Lafleur,Canadiens,80,129,52,77
25,Guy Lafleur,Canadiens,74,125,50,75
25,Guy Lafleur,Canadiens,51,70,27,43
25,Guy Lafleur,Canadiens,66,84,27,57
25,Guy Lafleur,Canadiens,68,76,27,49
25,Guy Lafleur,Canadiens,80,70,30,40
25,Guy Lafleur,Canadiens,19,5,2,3
25,Guy Lafleur,Rangers,67,45,18,27
25,Guy Lafleur,Nordiques,39,34,12,22
25,Guy Lafleur,Nordiques,59,28,12,16
26,Mats Sundin,Nordiques,80,59,23,36
26,Mats Sundin,Nordiques,80,76,33,43
26,Mats Sundin,Nordiques,80,114,47,67
26,Mats Sundin,Nordiques,84,85,32,53
26,Mats Sundin,Maple Leafs,47,47,23,24
26,Mats Sundin,Maple Leafs,76,83,33,50
26,Mats Sundin,Maple Leafs,82,94,41,53
26,Mats Sundin,Maple Leafs,82,74,33,41
26,Mats Sundin,Maple Leafs,82,83,31,52
26,Mats Sundin,Maple Leafs,73,73,32,41
26,Mats Sundin,Maple Leafs,82,74,28,46
26,Mats Sundin,Maple Leafs,82,80,41,39
26,Mats Sundin,Maple Leafs,75,72,37,35
26,Mats Sundin,Maple Leafs,81,75,31,44
26,Mats Sundin,Maple Leafs,70,78,31,47
26,Mats Sundin,Maple Leafs,75,76,27,49
26,Mats Sundin,Maple Leafs,74,78,32,46
26,Mats Sundin,Canucks,41,28,9,19
27,Dave Andreychuk,Sabres,43,37,14,23
27,Dave Andreychuk,Sabres,78,80,38,42
27,Dave Andreychuk,Sabres,64,61,31,30
27,Dave Andreychuk,Sabres,80,87,36,51
27,Dave Andreychuk,Sabres,77,73,25,48
27,Dave Andreychuk,Sabres,80,78,30,48
27,Dave Andreychuk,Sabres,56,52,28,24
27,Dave Andreychuk,Sabres,73,82,40,42
27,Dave Andreychuk,Sabres,80,69,36,33
27,Dave Andreychuk,Sabres,80,91,41,50
27,Dave Andreychuk,Sabres,52,61,29,32
27,Dave Andreychuk,Maple Leafs,31,38,25,13
27,Dave Andreychuk,Maple Leafs,83,99,53,46
27,Dave Andreychuk,Maple Leafs,48,38,22,16
27,Dave Andreychuk,Maple Leafs,61,44,20,24
27,Dave Andreychuk,Devils,15,13,8,5
27,Dave Andreychuk,Devils,82,61,27,34
27,Dave Andreychuk,Devils,75,48,14,34
27,Dave Andreychuk,Devils,52,28,15,13
27,Dave Andreychuk,Bruins,63,33,19,14
27,Dave Andreychuk,Avalanche,14,3,1,2
27,Dave Andreychuk,Sabres,74,33,20,13
27,Dave Andreychuk,Lightning,82,38,21,17
27,Dave Andreychuk,Lightning,72,34,20,14
27,Dave Andreychuk,Lightning,82,39,21,18
27,Dave Andreychuk,Lightning,42,18,6,12
28,Denis Savard,Blackhawks,76,75,28,47
28,Denis Savard,Blackhawks,80,119,32,87
28,Denis Savard,Blackhawks,78,121,35,86
28,Denis Savard,Blackhawks,75,94,37,57
28,Denis Savard,Blackhawks,79,105,38,67
28,Denis Savard,Blackhawks,80,116,47,69
28,Denis Savard,Blackhawks,70,90,40,50
28,Denis Savard,Blackhawks,80,131,44,87
28,Denis Savard,Blackhawks,58,82,23,59
28,Denis Savard,Blackhawks,60,80,27,53
28,Denis Savard,Canadiens,70,59,28,31
28,Denis Savard,Canadiens,77,70,28,42
28,Denis Savard,Canadiens,63,50,16,34
28,Denis Savard,Lightning,74,46,18,28
28,Denis Savard,Lightning,31,17,6,11
28,Denis Savard,Blackhawks,12,8,4,4
28,Denis Savard,Blackhawks,69,48,13,35
28,Denis Savard,Blackhawks,64,27,9,18
29,Mike Gartner,Capitals,77,68,36,32
29,Mike Gartner,Capitals,80,94,48,46
29,Mike Gartner,Capitals,80,80,35,45
29,Mike Gartner,Capitals,73,76,38,38
29,Mike Gartner,Capitals,80,85,40,45
29,Mike Gartner,Capitals,80,102,50,52
29,Mike Gartner,Capitals,74,75,35,40
29,Mike Gartner,Capitals,78,73,41,32
29,Mike Gartner,Capitals,80,81,48,33
29,Mike Gartner,Capitals,56,55,26,29
29,Mike Gartner,North Stars,13,14,7,7
29,Mike Gartner,North Stars,67,70,34,36
29,Mike Gartner,Rangers,12,16,11,5
29,Mike Gartner,Rangers,79,69,49,20
29,Mike Gartner,Rangers,76,81,40,41
29,Mike Gartner,Rangers,84,68,45,23
29,Mike Gartner,Rangers,71,52,28,24
29,Mike Gartner,Maple Leafs,10,12,6,6
29,Mike Gartner,Maple Leafs,38,20,12,8
29,Mike Gartner,Maple Leafs,82,54,35,19
29,Mike Gartner,Coyotes,82,63,32,31
29,Mike Gartner,Coyotes,60,27,12,15
30,Pierre Turgeon,Sabres,76,42,14,28
30,Pierre Turgeon,Sabres,80,88,34,54
30,Pierre Turgeon,Sabres,80,106,40,66
30,Pierre Turgeon,Sabres,78,79,32,47
30,Pierre Turgeon,Sabres,8,8,2,6
30,Pierre Turgeon,Islanders,69,87,38,49
30,Pierre Turgeon,Islanders,83,132,58,74
30,Pierre Turgeon,Islanders,69,94,38,56
30,Pierre Turgeon,Islanders,34,27,13,14
30,Pierre Turgeon,Canadiens,15,20,11,9
30,Pierre Turgeon,Canadiens,80,96,38,58
30,Pierre Turgeon,Canadiens,9,11,1,10
30,Pierre Turgeon,Blues,69,74,25,49
30,Pierre Turgeon,Blues,60,68,22,46
30,Pierre Turgeon,Blues,67,65,31,34
30,Pierre Turgeon,Blues,52,66,26,40
30,Pierre Turgeon,Blues,79,82,30,52
30,Pierre Turgeon,Stars,66,47,15,32
30,Pierre Turgeon,Stars,65,42,12,30
30,Pierre Turgeon,Stars,76,40,15,25
30,Pierre Turgeon,Avalanche,62,46,16,30
30,Pierre Turgeon,Avalanche,17,7,4,3
31,Gilbert Perreault,Sabres,78,72,38,34
31,Gilbert Perreault,Sabres,76,74,26,48
31,Gilbert Perreault,Sabres,78,88,28,60
31,Gilbert Perreault,Sabres,55,51,18,33
31,Gilbert Perreault,Sabres,68,96,39,57
31,Gilbert Perreault,Sabres,80,113,44,69
31,Gilbert Perreault,Sabres,80,95,39,56
31,Gilbert Perreault,Sabres,79,89,41,48
31,Gilbert Perreault,Sabres,79,85,27,58
31,Gilbert Perreault,Sabres,80,106,40,66
31,Gilbert Perreault,Sabres,56,59,20,39
31,Gilbert Perreault,Sabres,62,73,31,42
31,Gilbert Perreault,Sabres,77,76,30,46
31,Gilbert Perreault,Sabres,73,90,31,59
31,Gilbert Perreault,Sabres,78,83,30,53
31,Gilbert Perreault,Sabres,72,60,21,39
31,Gilbert Perreault,Sabres,20,16,9,7
32,Alex Delvecchio,Red Wings,1,0,0,0
32,Alex Delvecchio,Red Wings,65,37,15,22
32,Alex Delvecchio,Red Wings,70,59,16,43
32,Alex Delvecchio,Red Wings,69,29,11,18
32,Alex Delvecchio,Red Wings,69,48,17,31
32,Alex Delvecchio,Red Wings,70,51,25,26
32,Alex Delvecchio,Red Wings,48,41,16,25
32,Alex Delvecchio,Red Wings,70,59,21,38
32,Alex Delvecchio,Red Wings,70,54,19,35
32,Alex Delvecchio,Red Wings,70,47,19,28
32,Alex Delvecchio,Red Wings,70,62,27,35
32,Alex Delvecchio,Red Wings,70,69,26,43
32,Alex Delvecchio,Red Wings,70,64,20,44
32,Alex Delvecchio,Red Wings,70,53,23,30
32,Alex Delvecchio,Red Wings,68,67,25,42
32,Alex Delvecchio,Red Wings,70,69,31,38
32,Alex Delvecchio,Red Wings,70,55,17,38
32,Alex Delvecchio,Red Wings,74,70,22,48
32,Alex Delvecchio,Red Wings,72,83,25,58
32,Alex Delvecchio,Red Wings,73,68,21,47
32,Alex Delvecchio,Red Wings,77,55,21,34
32,Alex Delvecchio,Red Wings,75,65,20,45
32,Alex Delvecchio,Red Wings,77,71,18,53
32,Alex Delvecchio,Red Wings,11,5,1,4
33,Al MacInnis,Flames,2,0,0,0
33,Al MacInnis,Flames,14,4,1,3
33,Al MacInnis,Flames,51,45,11,34
33,Al MacInnis,Flames,67,66,14,52
33,Al MacInnis,Flames,77,68,11,57
33,Al MacInnis,Flames,79,76,20,56
33,Al MacInnis,Flames,80,83,25,58
33,Al MacInnis,Flames,79,74,16,58
33,Al MacInnis,Flames,79,90,28,62
33,Al MacInnis,Flames,78,103,28,75
33,Al MacInnis,Flames,72,77,20,57
33,Al MacInnis,Flames,50,54,11,43
33,Al MacInnis,Flames,75,82,28,54
33,Al MacInnis,Blues,32,28,8,20
33,Al MacInnis,Blues,82,61,17,44
33,Al MacInnis,Blues,72,43,13,30
33,Al MacInnis,Blues,71,49,19,30
33,Al MacInnis,Blues,82,62,20,42
33,Al MacInnis,Blues,61,39,11,28
33,Al MacInnis,Blues,59,54,12,42
33,Al MacInnis,Blues,71,46,11,35
33,Al MacInnis,Blues,80,68,16,52
33,Al MacInnis,Blues,3,2,0,2
34,Jean Ratelle,Rangers,3,3,2,1
34,Jean Ratelle,Rangers,31,12,4,8
34,Jean Ratelle,Rangers,48,20,11,9
34,Jean Ratelle,Rangers,15,7,0,7
34,Jean Ratelle,Rangers,54,35,14,21
34,Jean Ratelle,Rangers,67,51,21,30
34,Jean Ratelle,Rangers,41,11,6,5
34,Jean Ratelle,Rangers,74,78,32,46
34,Jean Ratelle,Rangers,75,78,32,46
34,Jean Ratelle,Rangers,75,74,32,42
34,Jean Ratelle,Rangers,78,72,26,46
34,Jean Ratelle,Rangers,63,109,46,63
34,Jean Ratelle,Rangers,78,94,41,53
34,Jean Ratelle,Rangers,68,67,28,39
34,Jean Ratelle,Rangers,79,91,36,55
34,Jean Ratelle,Rangers,13,15,5,10
34,Jean Ratelle,Bruins,67,90,31,59
34,Jean Ratelle,Bruins,78,94,33,61
34,Jean Ratelle,Bruins,80,84,25,59
34,Jean Ratelle,Bruins,80,72,27,45
34,Jean Ratelle,Bruins,67,73,28,45
34,Jean Ratelle,Bruins,47,37,11,26
35,Peter Stastny,Nordiques,77,109,39,70
35,Peter Stastny,Nordiques,80,139,46,93
35,Peter Stastny,Nordiques,75,124,47,77
35,Peter Stastny,Nordiques,80,119,46,73
35,Peter Stastny,Nordiques,75,100,32,68
35,Peter Stastny,Nordiques,76,122,41,81
35,Peter Stastny,Nordiques,64,77,24,53
35,Peter Stastny,Nordiques,76,111,46,65
35,Peter Stastny,Nordiques,72,85,35,50
35,Peter Stastny,Nordiques,62,62,24,38
35,Peter Stastny,Devils,12,11,5,6
35,Peter Stastny,Devils,77,60,18,42
35,Peter Stastny,Devils,66,62,24,38
35,Peter Stastny,Devils,62,40,17,23
35,Peter Stastny,Blues,17,16,5,11
35,Peter Stastny,Blues,6,2,1,1
36,Phil Housley,Sabres,77,66,19,47
36,Phil Housley,Sabres,75,77,31,46
36,Phil Housley,Sabres,73,69,16,53
36,Phil Housley,Sabres,79,62,15,47
36,Phil Housley,Sabres,78,67,21,46
36,Phil Housley,Sabres,74,66,29,37
36,Phil Housley,Sabres,72,70,26,44
36,Phil Housley,Sabres,80,81,21,60
36,Phil Housley,Jets (1979),78,76,23,53
36,Phil Housley,Jets (1979),74,86,23,63
36,Phil Housley,Jets (1979),80,97,18,79
36,Phil Housley,Blues,26,22,7,15
36,Phil Housley,Flames,43,43,8,35
36,Phil Housley,Flames,59,52,16,36
36,Phil Housley,Devils,22,16,1,15
36,Phil Housley,Capitals,77,40,11,29
36,Phil Housley,Capitals,64,31,6,25
36,Phil Housley,Flames,79,54,11,43
36,Phil Housley,Flames,78,55,11,44
36,Phil Housley,Flames,69,34,4,30
36,Phil Housley,Blackhawks,80,39,15,24
36,Phil Housley,Blackhawks,57,29,6,23
36,Phil Housley,Maple Leafs,1,0,0,0
37,Norm Ullman,Red Wings,66,18,9,9
37,Norm Ullman,Red Wings,64,52,16,36
37,Norm Ullman,Red Wings,69,51,23,28
37,Norm Ullman,Red Wings,69,58,22,36
37,Norm Ullman,Red Wings,70,58,24,34
37,Norm Ullman,Red Wings,70,70,28,42
37,Norm Ullman,Red Wings,70,64,26,38
37,Norm Ullman,Red Wings,70,56,26,30
37,Norm Ullman,Red Wings,61,51,21,30
37,Norm Ullman,Red Wings,70,83,42,41
37,Norm Ullman,Red Wings,70,72,31,41
37,Norm Ullman,Red Wings,68,70,26,44
37,Norm Ullman,Red Wings,58,55,30,25
37,Norm Ullman,Maple Leafs,13,17,5,12
37,Norm Ullman,Maple Leafs,75,77,35,42
37,Norm Ullman,Maple Leafs,74,60,18,42
37,Norm Ullman,Maple Leafs,73,85,34,51
37,Norm Ullman,Maple Leafs,77,73,23,50
37,Norm Ullman,Maple Leafs,65,55,20,35
37,Norm Ullman,Maple Leafs,78,69,22,47
37,Norm Ullman,Maple Leafs,80,35,9,26
38,Jean Beliveau,Canadiens,2,2,1,1
38,Jean Beliveau,Canadiens,3,5,5,0
38,Jean Beliveau,Canadiens,44,34,13,21
38,Jean Beliveau,Canadiens,70,73,37,36
38,Jean Beliveau,Canadiens,70,88,47,41
38,Jean Beliveau,Canadiens,69,84,33,51
38,Jean Beliveau,Canadiens,55,59,27,32
38,Jean Beliveau,Canadiens,64,91,45,46
38,Jean Beliveau,Canadiens,60,74,34,40
38,Jean Beliveau,Canadiens,69,90,32,58
38,Jean Beliveau,Canadiens,43,41,18,23
38,Jean Beliveau,Canadiens,69,67,18,49
38,Jean Beliveau,Canadiens,68,78,28,50
38,Jean Beliveau,Canadiens,58,43,20,23
38,Jean Beliveau,Canadiens,67,77,29,48
38,Jean Beliveau,Canadiens,53,38,12,26
38,Jean Beliveau,Canadiens,59,68,31,37
38,Jean Beliveau,Canadiens,69,82,33,49
38,Jean Beliveau,Canadiens,63,49,19,30
38,Jean Beliveau,Canadiens,70,76,25,51
39,Jeremy Roenick,Blackhawks,20,18,9,9
39,Jeremy Roenick,Blackhawks,78,66,26,40
39,Jeremy Roenick,Blackhawks,79,94,41,53
39,Jeremy Roenick,Blackhawks,80,103,53,50
39,Jeremy Roenick,Blackhawks,84,107,50,57
39,Jeremy Roenick,Blackhawks,84,107,46,61
39,Jeremy Roenick,Blackhawks,33,34,10,24
39,Jeremy Roenick,Blackhawks,66,67,32,35
39,Jeremy Roenick,Coyotes,72,69,29,40
39,Jeremy Roenick,Coyotes,79,56,24,32
39,Jeremy Roenick,Coyotes,78,72,24,48
39,Jeremy Roenick,Coyotes,75,78,34,44
39,Jeremy Roenick,Coyotes,80,76,30,46
39,Jeremy Roenick,Flyers,75,67,21,46
39,Jeremy Roenick,Flyers,79,59,27,32
39,Jeremy Roenick,Flyers,62,47,19,28
39,Jeremy Roenick,Kings,58,22,9,13
39,Jeremy Roenick,Coyotes,70,28,11,17
39,Jeremy Roenick,Sharks,69,33,14,19
39,Jeremy Roenick,Sharks,42,13,4,9
40,Larry Murphy,Kings,80,76,16,60
40,Larry Murphy,Kings,79,66,22,44
40,Larry Murphy,Kings,77,62,14,48
40,Larry Murphy,Kings,6,3,0,3
40,Larry Murphy,Capitals,72,46,13,33
40,Larry Murphy,Capitals,79,55,13,42
40,Larry Murphy,Capitals,78,65,21,44
40,Larry Murphy,Capitals,80,81,23,58
40,Larry Murphy,Capitals,79,61,8,53
40,Larry Murphy,Capitals,65,36,7,29
40,Larry Murphy,North Stars,13,10,4,6
40,Larry Murphy,North Stars,77,68,10,58
40,Larry Murphy,North Stars,31,15,4,11
40,Larry Murphy,Penguins,44,28,5,23
40,Larry Murphy,Penguins,77,77,21,56
40,Larry Murphy,Penguins,83,85,22,63
40,Larry Murphy,Penguins,84,73,17,56
40,Larry Murphy,Penguins,48,38,13,25
40,Larry Murphy,Maple Leafs,82,61,12,49
40,Larry Murphy,Maple Leafs,69,39,7,32
40,Larry Murphy,Red Wings,12,6,2,4
40,Larry Murphy,Red Wings,82,52,11,41
40,Larry Murphy,Red Wings,80,52,10,42
40,Larry Murphy,Red Wings,81,40,10,30
40,Larry Murphy,Red Wings,57,21,2,19
41,Bobby Clarke,Flyers,76,46,15,31
41,Bobby Clarke,Flyers,77,63,27,36
41,Bobby Clarke,Flyers,78,81,35,46
41,Bobby Clarke,Flyers,78,104,37,67
41,Bobby Clarke,Flyers,77,87,35,52
41,Bobby Clarke,Flyers,80,116,27,89
41,Bobby Clarke,Flyers,76,119,30,89
41,Bobby Clarke,Flyers,80,90,27,63
41,Bobby Clarke,Flyers,71,89,21,68
41,Bobby Clarke,Flyers,80,73,16,57
41,Bobby Clarke,Flyers,76,69,12,57
41,Bobby Clarke,Flyers,80,65,19,46
41,Bobby Clarke,Flyers,62,63,17,46
41,Bobby Clarke,Flyers,80,85,23,62
41,Bobby Clarke,Flyers,73,60,17,43
42,Bernie Nicholls,Kings,22,32,14,18
42,Bernie Nicholls,Kings,71,50,28,22
42,Bernie Nicholls,Kings,78,95,41,54
42,Bernie Nicholls,Kings,80,100,46,54
42,Bernie Nicholls,Kings,80,97,36,61
42,Bernie Nicholls,Kings,80,81,33,48
42,Bernie Nicholls,Kings,65,78,32,46
42,Bernie Nicholls,Kings,79,150,70,80
42,Bernie Nicholls,Kings,47,75,27,48
42,Bernie Nicholls,Rangers,32,37,12,25
42,Bernie Nicholls,Rangers,71,73,25,48
42,Bernie Nicholls,Rangers,1,0,0,0
42,Bernie Nicholls,Oilers,49,49,20,29
42,Bernie Nicholls,Oilers,46,40,8,32
42,Bernie Nicholls,Devils,23,20,5,15
42,Bernie Nicholls,Devils,61,46,19,27
42,Bernie Nicholls,Blackhawks,48,51,22,29
42,Bernie Nicholls,Blackhawks,59,60,19,41
42,Bernie Nicholls,Sharks,65,45,12,33
42,Bernie Nicholls,Sharks,60,28,6,22
42,Bernie Nicholls,Sharks,10,2,0,2
43,Vincent Damphousse,Maple Leafs,80,46,21,25
43,Vincent Damphousse,Maple Leafs,75,48,12,36
43,Vincent Damphousse,Maple Leafs,80,68,26,42
43,Vincent Damphousse,Maple Leafs,80,94,33,61
43,Vincent Damphousse,Maple Leafs,79,73,26,47
43,Vincent Damphousse,Oilers,80,89,38,51
43,Vincent Damphousse,Canadiens,84,97,39,58
43,Vincent Damphousse,Canadiens,84,91,40,51
43,Vincent Damphousse,Canadiens,48,40,10,30
43,Vincent Damphousse,Canadiens,80,94,38,56
43,Vincent Damphousse,Canadiens,82,81,27,54
43,Vincent Damphousse,Canadiens,76,59,18,41
43,Vincent Damphousse,Canadiens,65,36,12,24
43,Vincent Damphousse,Sharks,12,13,7,6
43,Vincent Damphousse,Sharks,82,70,21,49
43,Vincent Damphousse,Sharks,45,46,9,37
43,Vincent Damphousse,Sharks,82,58,20,38
43,Vincent Damphousse,Sharks,82,61,23,38
43,Vincent Damphousse,Sharks,82,41,12,29
44,Joe Thornton,Bruins,55,7,3,4
44,Joe Thornton,Bruins,81,41,16,25
44,Joe Thornton,Bruins,81,60,23,37
44,Joe Thornton,Bruins,72,71,37,34
44,Joe Thornton,Bruins,66,68,22,46
44,Joe Thornton,Bruins,77,101,36,65
44,Joe Thornton,Bruins,77,73,23,50
44,Joe Thornton,Bruins,23,33,9,24
44,Joe Thornton,Sharks,58,92,20,72
44,Joe Thornton,Sharks,82,114,22,92
44,Joe Thornton,Sharks,82,96,29,67
44,Joe Thornton,Sharks,82,86,25,61
44,Joe Thornton,Sharks,79,89,20,69
44,Joe Thornton,Sharks,80,70,21,49
44,Joe Thornton,Sharks,82,77,18,59
44,Joe Thornton,Sharks,48,40,7,33
44,Joe Thornton,Sharks,82,76,11,65
44,Joe Thornton,Sharks,14,11,3,8
45,Dino Ciccarelli,North Stars,32,30,18,12
45,Dino Ciccarelli,North Stars,76,106,55,51
45,Dino Ciccarelli,North Stars,77,75,37,38
45,Dino Ciccarelli,North Stars,79,71,38,33
45,Dino Ciccarelli,North Stars,51,32,15,17
45,Dino Ciccarelli,North Stars,75,89,44,45
45,Dino Ciccarelli,North Stars,80,103,52,51
45,Dino Ciccarelli,North Stars,67,86,41,45
45,Dino Ciccarelli,North Stars,65,59,32,27
45,Dino Ciccarelli,Capitals,11,15,12,3
45,Dino Ciccarelli,Capitals,80,79,41,38
45,Dino Ciccarelli,Capitals,54,39,21,18
45,Dino Ciccarelli,Capitals,78,76,38,38
45,Dino Ciccarelli,Red Wings,82,97,41,56
45,Dino Ciccarelli,Red Wings,66,57,28,29
45,Dino Ciccarelli,Red Wings,42,43,16,27
45,Dino Ciccarelli,Red Wings,64,43,22,21
45,Dino Ciccarelli,Lightning,77,60,35,25
45,Dino Ciccarelli,Lightning,34,17,11,6
45,Dino Ciccarelli,Panthers,28,16,5,11
45,Dino Ciccarelli,Panthers,14,7,6,1
46,Rod Brind'Amour,Blues,79,61,26,35
46,Rod Brind'Amour,Blues,78,49,17,32
46,Rod Brind'Amour,Flyers,80,77,33,44
46,Rod Brind'Amour,Flyers,81,86,37,49
46,Rod Brind'Amour,Flyers,84,97,35,62
46,Rod Brind'Amour,Flyers,48,39,12,27
46,Rod Brind'Amour,Flyers,82,87,26,61
46,Rod Brind'Amour,Flyers,82,59,27,32
46,Rod Brind'Amour,Flyers,82,74,36,38
46,Rod Brind'Amour,Flyers,82,74,24,50
46,Rod Brind'Amour,Flyers,12,8,5,3
46,Rod Brind'Amour,Hurricanes,33,14,4,10
46,Rod Brind'Amour,Hurricanes,79,56,20,36
46,Rod Brind'Amour,Hurricanes,81,55,23,32
46,Rod Brind'Amour,Hurricanes,48,37,14,23
46,Rod Brind'Amour,Hurricanes,78,38,12,26
46,Rod Brind'Amour,Hurricanes,78,70,31,39
46,Rod Brind'Amour,Hurricanes,78,82,26,56
46,Rod Brind'Amour,Hurricanes,59,51,19,32
46,Rod Brind'Amour,Hurricanes,80,51,16,35
46,Rod Brind'Amour,Hurricanes,80,19,9,10
47,Sergei Fedorov,Red Wings,77,79,31,48
47,Sergei Fedorov,Red Wings,80,86,32,54
47,Sergei Fedorov,Red Wings,73,87,34,53
47,Sergei Fedorov,Red Wings,82,120,56,64
47,Sergei Fedorov,Red Wings,42,50,20,30
47,Sergei Fedorov,Red Wings,78,107,39,68
47,Sergei Fedorov,Red Wings,74,63,30,33
47,Sergei Fedorov,Red Wings,21,17,6,11
47,Sergei Fedorov,Red Wings,77,63,26,37
47,Sergei Fedorov,Red Wings,68,62,27,35
47,Sergei Fedorov,Red Wings,75,69,32,37
47,Sergei Fedorov,Red Wings,81,68,31,37
47,Sergei Fedorov,Red Wings,80,83,36,47
47,Sergei Fedorov,Ducks,80,65,31,34
47,Sergei Fedorov,Ducks,5,1,0,1
47,Sergei Fedorov,Blue Jackets,62,43,12,31
47,Sergei Fedorov,Blue Jackets,73,42,18,24
47,Sergei Fedorov,Blue Jackets,50,28,9,19
47,Sergei Fedorov,Capitals,18,13,2,11
47,Sergei Fedorov,Capitals,52,33,11,22
48,Jarome Iginla,Flames,82,50,21,29
48,Jarome Iginla,Flames,70,32,13,19
48,Jarome Iginla,Flames,82,51,28,23
48,Jarome Iginla,Flames,77,63,29,34
48,Jarome Iginla,Flames,77,71,31,40
48,Jarome Iginla,Flames,82,96,52,44
48,Jarome Iginla,Flames,75,67,35,32
48,Jarome Iginla,Flames,81,73,41,32
48,Jarome Iginla,Flames,82,67,35,32
48,Jarome Iginla,Flames,70,94,39,55
48,Jarome Iginla,Flames,82,98,50,48
48,Jarome Iginla,Flames,82,89,35,54
48,Jarome Iginla,Flames,82,69,32,37
48,Jarome Iginla,Flames,82,86,43,43
48,Jarome Iginla,Flames,82,67,32,35
48,Jarome Iginla,Flames,31,22,9,13
48,Jarome Iginla,Penguins,13,11,5,6
48,Jarome Iginla,Bruins,78,61,30,31
48,Jarome Iginla,Avalanche,15,9,2,7
49,Bobby Hull,Blackhawks,70,47,13,34
49,Bobby Hull,Blackhawks,70,50,18,32
49,Bobby Hull,Blackhawks,70,81,39,42
49,Bobby Hull,Blackhawks,67,56,31,25
49,Bobby Hull,Blackhawks,70,84,50,34
49,Bobby Hull,Blackhawks,65,62,31,31
49,Bobby Hull,Blackhawks,70,87,43,44
49,Bobby Hull,Blackhawks,61,71,39,32
49,Bobby Hull,Blackhawks,65,97,54,43
49,Bobby Hull,Blackhawks,66,80,52,28
49,Bobby Hull,Blackhawks,71,75,44,31
49,Bobby Hull,Blackhawks,74,107,58,49
49,Bobby Hull,Blackhawks,61,67,38,29
49,Bobby Hull,Blackhawks,78,96,44,52
49,Bobby Hull,Blackhawks,78,93,50,43
49,Bobby Hull,Jets (1979),18,10,4,6
49,Bobby Hull,Whalers,9,7,2,5
50,Daniel Alfredsson,Senators,82,61,26,35
50,Daniel Alfredsson,Senators,76,71,24,47
50,Daniel Alfredsson,Senators,55,45,17,28
50,Daniel Alfredsson,Senators,58,33,11,22
50,Daniel Alfredsson,Senators,57,59,21,38
50,Daniel Alfredsson,Senators,68,70,24,46
50,Daniel Alfredsson,Senators,78,71,37,34
50,Daniel Alfredsson,Senators,78,78,27,51
50,Daniel Alfredsson,Senators,77,80,32,48
50,Daniel Alfredsson,Senators,77,103,43,60
50,Daniel Alfredsson,Senators,77,87,29,58
50,Daniel Alfredsson,Senators,70,89,40,49
50,Daniel Alfredsson,Senators,79,74,24,50
50,Daniel Alfredsson,Senators,70,71,20,51
50,Daniel Alfredsson,Senators,54,31,14,17
50,Daniel Alfredsson,Senators,75,59,27,32
50,Daniel Alfredsson,Senators,47,26,10,16
50,Daniel Alfredsson,Red Wings,68,49,18,31
51,Michel Goulet,Nordiques,77,54,22,32
51,Michel Goulet,Nordiques,76,71,32,39
51,Michel Goulet,Nordiques,80,84,42,42
51,Michel Goulet,Nordiques,80,105,57,48
51,Michel Goulet,Nordiques,75,121,56,65
51,Michel Goulet,Nordiques,69,95,55,40
51,Michel Goulet,Nordiques,75,104,53,51
51,Michel Goulet,Nordiques,75,96,49,47
51,Michel Goulet,Nordiques,80,106,48,58
51,Michel Goulet,Nordiques,69,64,26,38
51,Michel Goulet,Nordiques,57,45,16,29
51,Michel Goulet,Blackhawks,8,5,4,1
51,Michel Goulet,Blackhawks,74,65,27,38
51,Michel Goulet,Blackhawks,75,63,22,41
51,Michel Goulet,Blackhawks,63,44,23,21
51,Michel Goulet,Blackhawks,56,30,16,14
52,Nicklas Lidstrom,Red Wings,80,60,11,49
52,Nicklas Lidstrom,Red Wings,84,41,7,34
52,Nicklas Lidstrom,Red Wings,84,56,10,46
52,Nicklas Lidstrom,Red Wings,43,26,10,16
52,Nicklas Lidstrom,Red Wings,81,67,17,50
52,Nicklas Lidstrom,Red Wings,79,57,15,42
52,Nicklas Lidstrom,Red Wings,80,59,17,42
52,Nicklas Lidstrom,Red Wings,81,57,14,43
52,Nicklas Lidstrom,Red Wings,81,73,20,53
52,Nicklas Lidstrom,Red Wings,82,71,15,56
52,Nicklas Lidstrom,Red Wings,78,59,9,50
52,Nicklas Lidstrom,Red Wings,82,62,18,44
52,Nicklas Lidstrom,Red Wings,81,38,10,28
52,Nicklas Lidstrom,Red Wings,80,80,16,64
52,Nicklas Lidstrom,Red Wings,80,62,13,49
52,Nicklas Lidstrom,Red Wings,76,70,10,60
52,Nicklas Lidstrom,Red Wings,78,59,16,43
52,Nicklas Lidstrom,Red Wings,82,49,9,40
52,Nicklas Lidstrom,Red Wings,82,62,16,46
52,Nicklas Lidstrom,Red Wings,70,34,11,23
53,Bernard Federko,Blues,31,23,14,9
53,Bernard Federko,Blues,72,41,17,24
53,Bernard Federko,Blues,74,95,31,64
53,Bernard Federko,Blues,79,94,38,56
53,Bernard Federko,Blues,78,104,31,73
53,Bernard Federko,Blues,74,92,30,62
53,Bernard Federko,Blues,75,84,24,60
53,Bernard Federko,Blues,79,107,41,66
53,Bernard Federko,Blues,76,103,30,73
53,Bernard Federko,Blues,80,102,34,68
53,Bernard Federko,Blues,64,72,20,52
53,Bernard Federko,Blues,79,89,20,69
53,Bernard Federko,Blues,66,67,22,45
53,Bernard Federko,Red Wings,73,57,17,40
54,Mike Bossy,Islanders,73,91,53,38
54,Mike Bossy,Islanders,80,126,69,57
54,Mike Bossy,Islanders,75,92,51,41
54,Mike Bossy,Islanders,79,119,68,51
54,Mike Bossy,Islanders,80,147,64,83
54,Mike Bossy,Islanders,79,118,60,58
54,Mike Bossy,Islanders,67,118,51,67
54,Mike Bossy,Islanders,76,117,58,59
54,Mike Bossy,Islanders,80,123,61,62
54,Mike Bossy,Islanders,63,75,38,37
55,Joe Nieuwendyk,Flames,9,6,5,1
55,Joe Nieuwendyk,Flames,75,92,51,41
55,Joe Nieuwendyk,Flames,77,82,51,31
55,Joe Nieuwendyk,Flames,79,95,45,50
55,Joe Nieuwendyk,Flames,79,85,45,40
55,Joe Nieuwendyk,Flames,69,56,22,34
55,Joe Nieuwendyk,Flames,79,75,38,37
55,Joe Nieuwendyk,Flames,64,75,36,39
55,Joe Nieuwendyk,Flames,46,50,21,29
55,Joe Nieuwendyk,Stars,52,32,14,18
55,Joe Nieuwendyk,Stars,66,51,30,21
55,Joe Nieuwendyk,Stars,73,69,39,30
55,Joe Nieuwendyk,Stars,67,55,28,27
55,Joe Nieuwendyk,Stars,48,34,15,19
55,Joe Nieuwendyk,Stars,69,52,29,23
55,Joe Nieuwendyk,Stars,67,47,23,24
55,Joe Nieuwendyk,Devils,14,11,2,9
55,Joe Nieuwendyk,Devils,80,45,17,28
55,Joe Nieuwendyk,Maple Leafs,64,50,22,28
55,Joe Nieuwendyk,Panthers,65,56,26,30
55,Joe Nieuwendyk,Panthers,15,8,5,3
56,Darryl Sittler,Maple Leafs,49,18,10,8
56,Darryl Sittler,Maple Leafs,74,32,15,17
56,Darryl Sittler,Maple Leafs,78,77,29,48
56,Darryl Sittler,Maple Leafs,78,84,38,46
56,Darryl Sittler,Maple Leafs,72,80,36,44
56,Darryl Sittler,Maple Leafs,79,100,41,59
56,Darryl Sittler,Maple Leafs,73,90,38,52
56,Darryl Sittler,Maple Leafs,80,117,45,72
56,Darryl Sittler,Maple Leafs,70,87,36,51
56,Darryl Sittler,Maple Leafs,73,97,40,57
56,Darryl Sittler,Maple Leafs,80,96,43,53
56,Darryl Sittler,Maple Leafs,38,38,18,20
56,Darryl Sittler,Flyers,35,32,14,18
56,Darryl Sittler,Flyers,80,83,43,40
56,Darryl Sittler,Flyers,76,63,27,36
56,Darryl Sittler,Red Wings,61,27,11,16
57,Francis Mahovlich,Maple Leafs,3,1,1,0
57,Francis Mahovlich,Maple Leafs,67,36,20,16
57,Francis Mahovlich,Maple Leafs,63,49,22,27
57,Francis Mahovlich,Maple Leafs,70,39,18,21
57,Francis Mahovlich,Maple Leafs,70,84,48,36
57,Francis Mahovlich,Maple Leafs,70,71,33,38
57,Francis Mahovlich,Maple Leafs,67,73,36,37
57,Francis Mahovlich,Maple Leafs,70,55,26,29
57,Francis Mahovlich,Maple Leafs,59,51,23,28
57,Francis Mahovlich,Maple Leafs,68,56,32,24
57,Francis Mahovlich,Maple Leafs,63,46,18,28
57,Francis Mahovlich,Maple Leafs,50,36,19,17
57,Francis Mahovlich,Red Wings,13,16,7,9
57,Francis Mahovlich,Red Wings,76,78,49,29
57,Francis Mahovlich,Red Wings,74,70,38,32
57,Francis Mahovlich,Red Wings,35,32,14,18
57,Francis Mahovlich,Canadiens,38,41,17,24
57,Francis Mahovlich,Canadiens,76,96,43,53
57,Francis Mahovlich,Canadiens,78,93,38,55
57,Francis Mahovlich,Canadiens,71,80,31,49
58,Glenn Anderson,Oilers,58,53,30,23
58,Glenn Anderson,Oilers,80,105,38,67
58,Glenn Anderson,Oilers,72,104,48,56
58,Glenn Anderson,Oilers,80,99,54,45
58,Glenn Anderson,Oilers,80,81,42,39
58,Glenn Anderson,Oilers,72,102,54,48
58,Glenn Anderson,Oilers,80,73,35,38
58,Glenn Anderson,Oilers,80,88,38,50
58,Glenn Anderson,Oilers,79,64,16,48
58,Glenn Anderson,Oilers,73,72,34,38
58,Glenn Anderson,Oilers,74,55,24,31
58,Glenn Anderson,Maple Leafs,72,57,24,33
58,Glenn Anderson,Maple Leafs,76,65,22,43
58,Glenn Anderson,Maple Leafs,73,35,17,18
58,Glenn Anderson,Rangers,12,6,4,2
58,Glenn Anderson,Blues,36,26,12,14
58,Glenn Anderson,Oilers,17,10,4,6
58,Glenn Anderson,Blues,15,4,2,2
59,Theo Fleury,Flames,36,34,14,20
59,Theo Fleury,Flames,80,66,31,35
59,Theo Fleury,Flames,79,104,51,53
59,Theo Fleury,Flames,80,73,33,40
59,Theo Fleury,Flames,83,100,34,66
59,Theo Fleury,Flames,83,85,40,45
59,Theo Fleury,Flames,47,58,29,29
59,Theo Fleury,Flames,80,96,46,50
59,Theo Fleury,Flames,81,67,29,38
59,Theo Fleury,Flames,82,78,27,51
59,Theo Fleury,Flames,60,69,30,39
59,Theo Fleury,Avalanche,15,24,10,14
59,Theo Fleury,Rangers,80,64,15,49
59,Theo Fleury,Rangers,62,74,30,44
59,Theo Fleury,Rangers,82,63,24,39
59,Theo Fleury,Blackhawks,54,33,12,21
60,Dave Taylor,Kings,64,43,22,21
60,Dave Taylor,Kings,78,91,43,48
60,Dave Taylor,Kings,61,90,37,53
60,Dave Taylor,Kings,72,112,47,65
60,Dave Taylor,Kings,78,106,39,67
60,Dave Taylor,Kings,46,58,21,37
60,Dave Taylor,Kings,63,69,20,49
60,Dave Taylor,Kings,79,92,41,51
60,Dave Taylor,Kings,76,71,33,38
60,Dave Taylor,Kings,67,62,18,44
60,Dave Taylor,Kings,68,67,26,41
60,Dave Taylor,Kings,70,63,26,37
60,Dave Taylor,Kings,58,41,15,26
60,Dave Taylor,Kings,73,53,23,30
60,Dave Taylor,Kings,77,29,10,19
60,Dave Taylor,Kings,48,15,6,9
60,Dave Taylor,Kings,33,7,4,3
61,Keith Tkachuk,Jets (1979),17,8,3,5
61,Keith Tkachuk,Jets (1979),83,51,28,23
61,Keith Tkachuk,Jets (1979),84,81,41,40
61,Keith Tkachuk,Jets (1979),48,51,22,29
61,Keith Tkachuk,Jets (1979),76,98,50,48
61,Keith Tkachuk,Coyotes,81,86,52,34
61,Keith Tkachuk,Coyotes,69,66,40,26
61,Keith Tkachuk,Coyotes,68,68,36,32
61,Keith Tkachuk,Coyotes,50,43,22,21
61,Keith Tkachuk,Coyotes,64,71,29,42
61,Keith Tkachuk,Blues,12,8,6,2
61,Keith Tkachuk,Blues,73,75,38,37
61,Keith Tkachuk,Blues,56,55,31,24
61,Keith Tkachuk,Blues,75,71,33,38
61,Keith Tkachuk,Blues,41,36,15,21
61,Keith Tkachuk,Blues,61,43,20,23
61,Keith Tkachuk,Thrashers,18,15,7,8
61,Keith Tkachuk,Blues,79,58,27,31
61,Keith Tkachuk,Blues,79,49,25,24
61,Keith Tkachuk,Blues,67,32,13,19
62,Ray Whitney,Sharks,2,3,0,3
62,Ray Whitney,Sharks,26,10,4,6
62,Ray Whitney,Sharks,61,40,14,26
62,Ray Whitney,Sharks,39,25,13,12
62,Ray Whitney,Sharks,60,41,17,24
62,Ray Whitney,Sharks,12,2,0,2
62,Ray Whitney,Oilers,9,4,1,3
62,Ray Whitney,Panthers,68,61,32,29
62,Ray Whitney,Panthers,81,64,26,38
62,Ray Whitney,Panthers,81,71,29,42
62,Ray Whitney,Panthers,43,31,10,21
62,Ray Whitney,Blue Jackets,3,3,0,3
62,Ray Whitney,Blue Jackets,67,61,21,40
62,Ray Whitney,Blue Jackets,81,76,24,52
62,Ray Whitney,Red Wings,67,43,14,29
62,Ray Whitney,Hurricanes,63,55,17,38
62,Ray Whitney,Hurricanes,81,83,32,51
62,Ray Whitney,Hurricanes,66,61,25,36
62,Ray Whitney,Hurricanes,82,77,24,53
62,Ray Whitney,Hurricanes,80,58,21,37
62,Ray Whitney,Coyotes,75,57,17,40
62,Ray Whitney,Coyotes,82,77,24,53
62,Ray Whitney,Stars,32,29,11,18
62,Ray Whitney,Stars,69,32,9,23
63,Pat Verbeek,Devils,6,5,3,2
63,Pat Verbeek,Devils,79,47,20,27
63,Pat Verbeek,Devils,78,33,15,18
63,Pat Verbeek,Devils,76,53,25,28
63,Pat Verbeek,Devils,74,59,35,24
63,Pat Verbeek,Devils,73,77,46,31
63,Pat Verbeek,Devils,77,47,26,21
63,Pat Verbeek,Whalers,80,89,44,45
63,Pat Verbeek,Whalers,80,82,43,39
63,Pat Verbeek,Whalers,76,57,22,35
63,Pat Verbeek,Whalers,84,82,39,43
63,Pat Verbeek,Whalers,84,75,37,38
63,Pat Verbeek,Whalers,29,18,7,11
63,Pat Verbeek,Rangers,19,15,10,5
63,Pat Verbeek,Rangers,69,82,41,41
63,Pat Verbeek,Stars,81,53,17,36
63,Pat Verbeek,Stars,82,57,31,26
63,Pat Verbeek,Stars,78,34,17,17
63,Pat Verbeek,Red Wings,68,48,22,26
63,Pat Verbeek,Red Wings,67,30,15,15
63,Pat Verbeek,Stars,64,20,7,13
64,Joe Mullen,Blues,45,59,25,34
64,Joe Mullen,Blues,49,47,17,30
64,Joe Mullen,Blues,80,85,41,44
64,Joe Mullen,Blues,79,92,40,52
64,Joe Mullen,Blues,48,52,28,24
64,Joe Mullen,Flames,29,38,16,22
64,Joe Mullen,Flames,79,87,47,40
64,Joe Mullen,Flames,80,84,40,44
64,Joe Mullen,Flames,79,110,51,59
64,Joe Mullen,Flames,78,69,36,33
64,Joe Mullen,Penguins,47,39,17,22
64,Joe Mullen,Penguins,77,87,42,45
64,Joe Mullen,Penguins,72,70,33,37
64,Joe Mullen,Penguins,84,70,38,32
64,Joe Mullen,Penguins,45,37,16,21
64,Joe Mullen,Bruins,37,15,8,7
64,Joe Mullen,Penguins,54,22,7,15
65,Denis Potvin,Islanders,77,54,17,37
65,Denis Potvin,Islanders,79,76,21,55
65,Denis Potvin,Islanders,78,98,31,67
65,Denis Potvin,Islanders,80,80,25,55
65,Denis Potvin,Islanders,80,94,30,64
65,Denis Potvin,Islanders,73,101,31,70
65,Denis Potvin,Islanders,31,41,8,33
65,Denis Potvin,Islanders,74,76,20,56
65,Denis Potvin,Islanders,60,61,24,37
65,Denis Potvin,Islanders,69,66,12,54
65,Denis Potvin,Islanders,78,85,22,63
65,Denis Potvin,Islanders,77,68,17,51
65,Denis Potvin,Islanders,74,59,21,38
65,Denis Potvin,Islanders,58,42,12,30
65,Denis Potvin,Islanders,72,51,19,32
66,Henri Richard,Canadiens,64,40,19,21
66,Henri Richard,Canadiens,63,54,18,36
66,Henri Richard,Canadiens,67,80,28,52
66,Henri Richard,Canadiens,63,51,21,30
66,Henri Richard,Canadiens,70,73,30,43
66,Henri Richard,Canadiens,70,68,24,44
66,Henri Richard,Canadiens,54,50,21,29
66,Henri Richard,Canadiens,67,73,23,50
66,Henri Richard,Canadiens,66,53,14,39
66,Henri Richard,Canadiens,53,52,23,29
66,Henri Richard,Canadiens,62,61,22,39
66,Henri Richard,Canadiens,65,55,21,34
66,Henri Richard,Canadiens,54,28,9,19
66,Henri Richard,Canadiens,64,52,15,37
66,Henri Richard,Canadiens,62,52,16,36
66,Henri Richard,Canadiens,75,49,12,37
66,Henri Richard,Canadiens,75,44,12,32
66,Henri Richard,Canadiens,71,43,8,35
66,Henri Richard,Canadiens,75,55,19,36
66,Henri Richard,Canadiens,16,13,3,10
67,Bobby Smith,North Stars,80,74,30,44
67,Bobby Smith,North Stars,61,83,27,56
67,Bobby Smith,North Stars,78,93,29,64
67,Bobby Smith,North Stars,80,114,43,71
67,Bobby Smith,North Stars,77,77,24,53
67,Bobby Smith,North Stars,10,9,3,6
67,Bobby Smith,Canadiens,70,63,26,37
67,Bobby Smith,Canadiens,65,56,16,40
67,Bobby Smith,Canadiens,79,86,31,55
67,Bobby Smith,Canadiens,80,75,28,47
67,Bobby Smith,Canadiens,78,93,27,66
67,Bobby Smith,Canadiens,80,83,32,51
67,Bobby Smith,Canadiens,53,26,12,14
67,Bobby Smith,North Stars,73,46,15,31
67,Bobby Smith,North Stars,68,46,9,37
67,Bobby Smith,North Stars,45,12,5,7
68,Doug Weight,Rangers,53,30,8,22
68,Doug Weight,Rangers,65,40,15,25
68,Doug Weight,Oilers,13,8,2,6
68,Doug Weight,Oilers,84,74,24,50
68,Doug Weight,Oilers,48,40,7,33
68,Doug Weight,Oilers,82,104,25,79
68,Doug Weight,Oilers,80,82,21,61
68,Doug Weight,Oilers,79,70,26,44
68,Doug Weight,Oilers,43,37,6,31
68,Doug Weight,Oilers,77,72,21,51
68,Doug Weight,Oilers,82,90,25,65
68,Doug Weight,Blues,61,49,15,34
68,Doug Weight,Blues,70,67,15,52
68,Doug Weight,Blues,75,65,14,51
68,Doug Weight,Blues,47,44,11,33
68,Doug Weight,Hurricanes,23,13,4,9
68,Doug Weight,Blues,82,59,16,43
68,Doug Weight,Blues,29,11,4,7
68,Doug Weight,Ducks,38,14,6,8
68,Doug Weight,Islanders,53,38,10,28
68,Doug Weight,Islanders,36,17,1,16
68,Doug Weight,Islanders,18,9,2,7
69,Alexander Mogilny,Sabres,65,43,15,28
69,Alexander Mogilny,Sabres,62,64,30,34
69,Alexander Mogilny,Sabres,67,84,39,45
69,Alexander Mogilny,Sabres,77,127,76,51
69,Alexander Mogilny,Sabres,66,79,32,47
69,Alexander Mogilny,Sabres,44,47,19,28
69,Alexander Mogilny,Canucks,79,107,55,52
69,Alexander Mogilny,Canucks,76,73,31,42
69,Alexander Mogilny,Canucks,51,45,18,27
69,Alexander Mogilny,Canucks,59,45,14,31
69,Alexander Mogilny,Canucks,47,38,21,17
69,Alexander Mogilny,Devils,12,6,3,3
69,Alexander Mogilny,Devils,75,83,43,40
69,Alexander Mogilny,Maple Leafs,66,57,24,33
69,Alexander Mogilny,Maple Leafs,73,79,33,46
69,Alexander Mogilny,Maple Leafs,37,30,8,22
69,Alexander Mogilny,Devils,34,25,12,13
70,Alex Kovalev,Rangers,65,38,20,18
70,Alex Kovalev,Rangers,76,56,23,33
70,Alex Kovalev,Rangers,48,28,13,15
70,Alex Kovalev,Rangers,81,58,24,34
70,Alex Kovalev,Rangers,45,35,13,22
70,Alex Kovalev,Rangers,73,53,23,30
70,Alex Kovalev,Rangers,14,7,3,4
70,Alex Kovalev,Penguins,63,46,20,26
70,Alex Kovalev,Penguins,82,66,26,40
70,Alex Kovalev,Penguins,79,95,44,51
70,Alex Kovalev,Penguins,67,76,32,44
70,Alex Kovalev,Penguins,54,64,27,37
70,Alex Kovalev,Rangers,24,13,10,3
70,Alex Kovalev,Rangers,66,42,13,29
70,Alex Kovalev,Canadiens,12,3,1,2
70,Alex Kovalev,Canadiens,69,65,23,42
70,Alex Kovalev,Canadiens,73,47,18,29
70,Alex Kovalev,Canadiens,82,84,35,49
70,Alex Kovalev,Canadiens,78,65,26,39
70,Alex Kovalev,Senators,77,49,18,31
70,Alex Kovalev,Senators,54,27,14,13
70,Alex Kovalev,Penguins,20,7,2,5
70,Alex Kovalev,Panthers,14,5,2,3
71,Brian Leetch,Rangers,17,14,2,12
71,Brian Leetch,Rangers,68,71,23,48
71,Brian Leetch,Rangers,72,56,11,45
71,Brian Leetch,Rangers,80,88,16,72
71,Brian Leetch,Rangers,80,102,22,80
71,Brian Leetch,Rangers,36,36,6,30
71,Brian Leetch,Rangers,84,79,23,56
71,Brian Leetch,Rangers,48,41,9,32
71,Brian Leetch,Rangers,82,85,15,70
71,Brian Leetch,Rangers,82,78,20,58
71,Brian Leetch,Rangers,76,50,17,33
71,Brian Leetch,Rangers,82,55,13,42
71,Brian Leetch,Rangers,50,26,7,19
71,Brian Leetch,Rangers,82,79,21,58
71,Brian Leetch,Rangers,82,55,10,45
71,Brian Leetch,Rangers,51,30,12,18
71,Brian Leetch,Rangers,57,36,13,23
71,Brian Leetch,Maple Leafs,15,15,2,13
71,Brian Leetch,Bruins,61,32,5,27
72,Brian Bellows,North Stars,78,65,35,30
72,Brian Bellows,North Stars,78,83,41,42
72,Brian Bellows,North Stars,78,62,26,36
72,Brian Bellows,North Stars,77,79,31,48
72,Brian Bellows,North Stars,65,53,26,27
72,Brian Bellows,North Stars,77,81,40,41
72,Brian Bellows,North Stars,60,50,23,27
72,Brian Bellows,North Stars,80,99,55,44
72,Brian Bellows,North Stars,80,75,35,40
72,Brian Bellows,North Stars,80,75,30,45
72,Brian Bellows,Canadiens,82,88,40,48
72,Brian Bellows,Canadiens,77,71,33,38
72,Brian Bellows,Canadiens,41,16,8,8
72,Brian Bellows,Lightning,79,49,23,26
72,Brian Bellows,Lightning,7,3,1,2
72,Brian Bellows,Ducks,62,28,15,13
72,Brian Bellows,Capitals,11,9,6,3
72,Brian Bellows,Capitals,76,36,17,19
73,Rod Gilbert,Rangers,1,1,0,1
73,Rod Gilbert,Rangers,1,0,0,0
73,Rod Gilbert,Rangers,70,31,11,20
73,Rod Gilbert,Rangers,70,64,24,40
73,Rod Gilbert,Rangers,70,61,25,36
73,Rod Gilbert,Rangers,34,25,10,15
73,Rod Gilbert,Rangers,64,46,28,18
73,Rod Gilbert,Rangers,73,77,29,48
73,Rod Gilbert,Rangers,66,77,28,49
73,Rod Gilbert,Rangers,72,53,16,37
73,Rod Gilbert,Rangers,78,61,30,31
73,Rod Gilbert,Rangers,73,97,43,54
73,Rod Gilbert,Rangers,76,84,25,59
73,Rod Gilbert,Rangers,75,77,36,41
73,Rod Gilbert,Rangers,76,97,36,61
73,Rod Gilbert,Rangers,70,86,36,50
73,Rod Gilbert,Rangers,77,75,27,48
73,Rod Gilbert,Rangers,19,9,2,7
74,Dale Hunter,Nordiques,80,63,19,44
74,Dale Hunter,Nordiques,80,72,22,50
74,Dale Hunter,Nordiques,80,63,17,46
74,Dale Hunter,Nordiques,77,79,24,55
74,Dale Hunter,Nordiques,80,72,20,52
74,Dale Hunter,Nordiques,80,70,28,42
74,Dale Hunter,Nordiques,46,39,10,29
74,Dale Hunter,Capitals,79,59,22,37
74,Dale Hunter,Capitals,80,57,20,37
74,Dale Hunter,Capitals,80,62,23,39
74,Dale Hunter,Capitals,76,46,16,30
74,Dale Hunter,Capitals,80,78,28,50
74,Dale Hunter,Capitals,84,79,20,59
74,Dale Hunter,Capitals,52,38,9,29
74,Dale Hunter,Capitals,45,23,8,15
74,Dale Hunter,Capitals,82,37,13,24
74,Dale Hunter,Capitals,82,46,14,32
74,Dale Hunter,Capitals,82,26,8,18
74,Dale Hunter,Capitals,50,5,0,5
74,Dale Hunter,Avalanche,12,6,2,4
75,Pat LaFontaine,Islanders,15,19,13,6
75,Pat LaFontaine,Islanders,67,54,19,35
75,Pat LaFontaine,Islanders,65,53,30,23
75,Pat LaFontaine,Islanders,80,70,38,32
75,Pat LaFontaine,Islanders,75,92,47,45
75,Pat LaFontaine,Islanders,79,88,45,43
75,Pat LaFontaine,Islanders,74,105,54,51
75,Pat LaFontaine,Islanders,75,85,41,44
75,Pat LaFontaine,Sabres,57,93,46,47
75,Pat LaFontaine,Sabres,84,148,53,95
75,Pat LaFontaine,Sabres,16,18,5,13
75,Pat LaFontaine,Sabres,22,27,12,15
75,Pat LaFontaine,Sabres,76,91,40,51
75,Pat LaFontaine,Sabres,13,8,2,6
75,Pat LaFontaine,Rangers,67,62,23,39
76,Steve Larmer,Blackhawks,4,1,0,1
76,Steve Larmer,Blackhawks,3,0,0,0
76,Steve Larmer,Blackhawks,80,90,43,47
76,Steve Larmer,Blackhawks,80,75,35,40
76,Steve Larmer,Blackhawks,80,86,46,40
76,Steve Larmer,Blackhawks,80,76,31,45
76,Steve Larmer,Blackhawks,80,84,28,56
76,Steve Larmer,Blackhawks,80,89,41,48
76,Steve Larmer,Blackhawks,80,87,43,44
76,Steve Larmer,Blackhawks,80,90,31,59
76,Steve Larmer,Blackhawks,80,101,44,57
76,Steve Larmer,Blackhawks,80,74,29,45
76,Steve Larmer,Blackhawks,84,70,35,35
76,Steve Larmer,Rangers,68,60,21,39
76,Steve Larmer,Rangers,47,29,14,15
77,Lanny McDonald,Maple Leafs,70,30,14,16
77,Lanny McDonald,Maple Leafs,64,44,17,27
77,Lanny McDonald,Maple Leafs,75,93,37,56
77,Lanny McDonald,Maple Leafs,80,90,46,44
77,Lanny McDonald,Maple Leafs,74,87,47,40
77,Lanny McDonald,Maple Leafs,79,85,43,42
77,Lanny McDonald,Maple Leafs,35,30,15,15
77,Lanny McDonald,Rockies,46,45,25,20
77,Lanny McDonald,Rockies,80,81,35,46
77,Lanny McDonald,Rockies,16,15,6,9
77,Lanny McDonald,Flames,55,67,34,33
77,Lanny McDonald,Flames,80,98,66,32
77,Lanny McDonald,Flames,65,66,33,33
77,Lanny McDonald,Flames,43,37,19,18
77,Lanny McDonald,Flames,80,71,28,43
77,Lanny McDonald,Flames,58,26,14,12
77,Lanny McDonald,Flames,60,23,10,13
77,Lanny McDonald,Flames,51,18,11,7
78,Brian Propp,Flyers,80,75,34,41
78,Brian Propp,Flyers,79,66,26,40
78,Brian Propp,Flyers,80,91,44,47
78,Brian Propp,Flyers,80,82,40,42
78,Brian Propp,Flyers,79,92,39,53
78,Brian Propp,Flyers,76,97,43,54
78,Brian Propp,Flyers,72,97,40,57
78,Brian Propp,Flyers,53,67,31,36
78,Brian Propp,Flyers,74,76,27,49
78,Brian Propp,Flyers,77,78,32,46
78,Brian Propp,Flyers,40,28,13,15
78,Brian Propp,Bruins,14,12,3,9
78,Brian Propp,North Stars,79,73,26,47
78,Brian Propp,North Stars,51,35,12,23
78,Brian Propp,North Stars,17,6,3,3
78,Brian Propp,Whalers,65,29,12,17
79,Marian Hossa,Senators,7,1,0,1
79,Marian Hossa,Senators,60,30,15,15
79,Marian Hossa,Senators,78,56,29,27
79,Marian Hossa,Senators,81,75,32,43
79,Marian Hossa,Senators,80,66,31,35
79,Marian Hossa,Senators,80,80,45,35
79,Marian Hossa,Senators,81,82,36,46
79,Marian Hossa,Thrashers,80,92,39,53
79,Marian Hossa,Thrashers,82,100,43,57
79,Marian Hossa,Thrashers,60,56,26,30
79,Marian Hossa,Penguins,12,10,3,7
79,Marian Hossa,Red Wings,74,71,40,31
79,Marian Hossa,Blackhawks,57,51,24,27
79,Marian Hossa,Blackhawks,65,57,25,32
79,Marian Hossa,Blackhawks,81,77,29,48
79,Marian Hossa,Blackhawks,40,31,17,14
79,Marian Hossa,Blackhawks,72,60,30,30
79,Marian Hossa,Blackhawks,14,6,2,4
80,Martin St. Louis,Flames,13,2,1,1
80,Martin St. Louis,Flames,56,18,3,15
80,Martin St. Louis,Lightning,78,40,18,22
80,Martin St. Louis,Lightning,53,35,16,19
80,Martin St. Louis,Lightning,82,70,33,37
80,Martin St. Louis,Lightning,82,94,38,56
80,Martin St. Louis,Lightning,80,61,31,30
80,Martin St. Louis,Lightning,82,102,43,59
80,Martin St. Louis,Lightning,82,83,25,58
80,Martin St. Louis,Lightning,82,80,30,50
80,Martin St. Louis,Lightning,82,94,29,65
80,Martin St. Louis,Lightning,82,99,31,68
80,Martin St. Louis,Lightning,77,74,25,49
80,Martin St. Louis,Lightning,48,60,17,43
80,Martin St. Louis,Lightning,62,61,29,32
80,Martin St. Louis,Rangers,19,8,1,7
80,Martin St. Louis,Rangers,12,10,4,6
81,Patrik Elias,Devils,1,0,0,0
81,Patrik Elias,Devils,17,5,2,3
81,Patrik Elias,Devils,74,37,18,19
81,Patrik Elias,Devils,74,50,17,33
81,Patrik Elias,Devils,72,72,35,37
81,Patrik Elias,Devils,82,96,40,56
81,Patrik Elias,Devils,75,61,29,32
81,Patrik Elias,Devils,81,57,28,29
81,Patrik Elias,Devils,82,81,38,43
81,Patrik Elias,Devils,38,45,16,29
81,Patrik Elias,Devils,75,69,21,48
81,Patrik Elias,Devils,74,55,20,35
81,Patrik Elias,Devils,77,78,31,47
81,Patrik Elias,Devils,58,48,19,29
81,Patrik Elias,Devils,81,62,21,41
81,Patrik Elias,Devils,81,78,26,52
81,Patrik Elias,Devils,48,36,14,22
81,Patrik Elias,Devils,65,53,18,35
81,Patrik Elias,Devils,14,7,1,6
82,Paul Kariya,Ducks,47,39,18,21
82,Paul Kariya,Ducks,82,108,50,58
82,Paul Kariya,Ducks,69,99,44,55
82,Paul Kariya,Ducks,22,31,17,14
82,Paul Kariya,Ducks,82,101,39,62
82,Paul Kariya,Ducks,74,86,42,44
82,Paul Kariya,Ducks,66,67,33,34
82,Paul Kariya,Ducks,82,57,32,25
82,Paul Kariya,Ducks,82,81,25,56
82,Paul Kariya,Avalanche,51,36,11,25
82,Paul Kariya,Predators,82,85,31,54
82,Paul Kariya,Predators,82,76,24,52
82,Paul Kariya,Blues,82,65,16,49
82,Paul Kariya,Blues,11,15,2,13
82,Paul Kariya,Blues,75,43,18,25
83,Rick Middleton,Rangers,47,40,22,18
83,Rick Middleton,Rangers,77,50,24,26
83,Rick Middleton,Bruins,72,42,20,22
83,Rick Middleton,Bruins,79,60,25,35
83,Rick Middleton,Bruins,71,86,38,48
83,Rick Middleton,Bruins,80,92,40,52
83,Rick Middleton,Bruins,80,103,44,59
83,Rick Middleton,Bruins,75,94,51,43
83,Rick Middleton,Bruins,80,96,49,47
83,Rick Middleton,Bruins,80,105,47,58
83,Rick Middleton,Bruins,80,76,30,46
83,Rick Middleton,Bruins,49,44,14,30
83,Rick Middleton,Bruins,76,68,31,37
83,Rick Middleton,Bruins,59,32,13,19
84,David Keon,Maple Leafs,70,45,20,25
84,David Keon,Maple Leafs,64,61,26,35
84,David Keon,Maple Leafs,68,56,28,28
84,David Keon,Maple Leafs,70,60,23,37
84,David Keon,Maple Leafs,65,50,21,29
84,David Keon,Maple Leafs,69,54,24,30
84,David Keon,Maple Leafs,66,52,19,33
84,David Keon,Maple Leafs,67,48,11,37
84,David Keon,Maple Leafs,75,61,27,34
84,David Keon,Maple Leafs,72,62,32,30
84,David Keon,Maple Leafs,76,76,38,38
84,David Keon,Maple Leafs,72,48,18,30
84,David Keon,Maple Leafs,76,73,37,36
84,David Keon,Maple Leafs,74,53,25,28
84,David Keon,Maple Leafs,78,59,16,43
84,David Keon,Whalers,76,62,10,52
84,David Keon,Whalers,80,47,13,34
84,David Keon,Whalers,78,19,8,11
85,Andy Bathgate,Rangers,18,1,0,1
85,Andy Bathgate,Rangers,20,4,2,2
85,Andy Bathgate,Rangers,70,40,20,20
85,Andy Bathgate,Rangers,70,66,19,47
85,Andy Bathgate,Rangers,70,77,27,50
85,Andy Bathgate,Rangers,65,78,30,48
85,Andy Bathgate,Rangers,70,88,40,48
85,Andy Bathgate,Rangers,70,74,26,48
85,Andy Bathgate,Rangers,70,77,29,48
85,Andy Bathgate,Rangers,70,84,28,56
85,Andy Bathgate,Rangers,70,81,35,46
85,Andy Bathgate,Rangers,56,59,16,43
85,Andy Bathgate,Maple Leafs,15,18,3,15
85,Andy Bathgate,Maple Leafs,55,45,16,29
85,Andy Bathgate,Red Wings,70,47,15,32
85,Andy Bathgate,Red Wings,60,31,8,23
85,Andy Bathgate,Penguins,74,59,20,39
85,Andy Bathgate,Penguins,76,44,15,29
86,Maurice Richard,Canadiens,16,11,5,6
86,Maurice Richard,Canadiens,46,54,32,22
86,Maurice Richard,Canadiens,50,73,50,23
86,Maurice Richard,Canadiens,50,48,27,21
86,Maurice Richard,Canadiens,60,71,45,26
86,Maurice Richard,Canadiens,53,53,28,25
86,Maurice Richard,Canadiens,59,38,20,18
86,Maurice Richard,Canadiens,70,65,43,22
86,Maurice Richard,Canadiens,65,66,42,24
86,Maurice Richard,Canadiens,48,44,27,17
86,Maurice Richard,Canadiens,70,61,28,33
86,Maurice Richard,Canadiens,70,67,37,30
86,Maurice Richard,Canadiens,67,74,38,36
86,Maurice Richard,Canadiens,70,71,38,33
86,Maurice Richard,Canadiens,63,62,33,29
86,Maurice Richard,Canadiens,28,34,15,19
86,Maurice Richard,Canadiens,42,38,17,21
86,Maurice Richard,Canadiens,51,35,19,16
87,Kirk Muller,Devils,80,54,17,37
87,Kirk Muller,Devils,77,66,25,41
87,Kirk Muller,Devils,79,76,26,50
87,Kirk Muller,Devils,80,94,37,57
87,Kirk Muller,Devils,80,74,31,43
87,Kirk Muller,Devils,80,86,30,56
87,Kirk Muller,Devils,80,70,19,51
87,Kirk Muller,Canadiens,78,77,36,41
87,Kirk Muller,Canadiens,80,94,37,57
87,Kirk Muller,Canadiens,76,57,23,34
87,Kirk Muller,Canadiens,33,19,8,11
87,Kirk Muller,Islanders,12,8,3,5
87,Kirk Muller,Islanders,15,7,4,3
87,Kirk Muller,Maple Leafs,36,25,9,16
87,Kirk Muller,Maple Leafs,66,37,20,17
87,Kirk Muller,Panthers,10,3,1,2
87,Kirk Muller,Panthers,70,29,8,21
87,Kirk Muller,Panthers,82,15,4,11
87,Kirk Muller,Stars,47,22,7,15
87,Kirk Muller,Stars,55,10,1,9
87,Kirk Muller,Stars,78,30,10,20
87,Kirk Muller,Stars,55,6,1,5
88,Larry Robinson,Canadiens,36,6,2,4
88,Larry Robinson,Canadiens,78,26,6,20
88,Larry Robinson,Canadiens,80,61,14,47
88,Larry Robinson,Canadiens,80,40,10,30
88,Larry Robinson,Canadiens,77,85,19,66
88,Larry Robinson,Canadiens,80,65,13,52
88,Larry Robinson,Canadiens,67,61,16,45
88,Larry Robinson,Canadiens,72,75,14,61
88,Larry Robinson,Canadiens,65,50,12,38
88,Larry Robinson,Canadiens,71,59,12,47
88,Larry Robinson,Canadiens,71,63,14,49
88,Larry Robinson,Canadiens,74,43,9,34
88,Larry Robinson,Canadiens,76,47,14,33
88,Larry Robinson,Canadiens,78,82,19,63
88,Larry Robinson,Canadiens,70,50,13,37
88,Larry Robinson,Canadiens,53,40,6,34
88,Larry Robinson,Canadiens,74,30,4,26
88,Larry Robinson,Kings,64,39,7,32
88,Larry Robinson,Kings,62,23,1,22
88,Larry Robinson,Kings,56,13,3,10
89,Rick Tocchet,Flyers,75,39,14,25
89,Rick Tocchet,Flyers,69,35,14,21
89,Rick Tocchet,Flyers,69,49,21,28
89,Rick Tocchet,Flyers,65,64,31,33
89,Rick Tocchet,Flyers,66,81,45,36
89,Rick Tocchet,Flyers,75,96,37,59
89,Rick Tocchet,Flyers,70,71,40,31
89,Rick Tocchet,Flyers,42,29,13,16
89,Rick Tocchet,Penguins,19,30,14,16
89,Rick Tocchet,Penguins,80,109,48,61
89,Rick Tocchet,Penguins,51,40,14,26
89,Rick Tocchet,Kings,36,35,18,17
89,Rick Tocchet,Kings,44,36,13,23
89,Rick Tocchet,Bruins,27,24,16,8
89,Rick Tocchet,Bruins,40,30,16,14
89,Rick Tocchet,Capitals,13,10,5,5
89,Rick Tocchet,Coyotes,68,45,26,19
89,Rick Tocchet,Coyotes,81,56,26,30
89,Rick Tocchet,Coyotes,64,29,12,17
89,Rick Tocchet,Flyers,16,6,3,3
89,Rick Tocchet,Flyers,60,36,14,22
89,Rick Tocchet,Flyers,14,2,0,2
90,Chris Chelios,Canadiens,12,2,0,2
90,Chris Chelios,Canadiens,74,64,9,55
90,Chris Chelios,Canadiens,41,34,8,26
90,Chris Chelios,Canadiens,71,44,11,33
90,Chris Chelios,Canadiens,71,61,20,41
90,Chris Chelios,Canadiens,80,73,15,58
90,Chris Chelios,Canadiens,53,31,9,22
90,Chris Chelios,Blackhawks,77,64,12,52
90,Chris Chelios,Blackhawks,80,56,9,47
90,Chris Chelios,Blackhawks,84,73,15,58
90,Chris Chelios,Blackhawks,76,60,16,44
90,Chris Chelios,Blackhawks,48,38,5,33
90,Chris Chelios,Blackhawks,81,72,14,58
90,Chris Chelios,Blackhawks,72,48,10,38
90,Chris Chelios,Blackhawks,81,42,3,39
90,Chris Chelios,Blackhawks,65,34,8,26
90,Chris Chelios,Red Wings,10,2,1,1
90,Chris Chelios,Red Wings,81,34,3,31
90,Chris Chelios,Red Wings,24,3,0,3
90,Chris Chelios,Red Wings,79,39,6,33
90,Chris Chelios,Red Wings,66,19,2,17
90,Chris Chelios,Red Wings,69,21,2,19
90,Chris Chelios,Red Wings,81,11,4,7
90,Chris Chelios,Red Wings,71,11,0,11
90,Chris Chelios,Red Wings,69,12,3,9
90,Chris Chelios,Red Wings,28,0,0,0
90,Chris Chelios,Thrashers,7,0,0,0
91,Patrick Marleau,Sharks,74,32,13,19
91,Patrick Marleau,Sharks,81,45,21,24
91,Patrick Marleau,Sharks,81,40,17,23
91,Patrick Marleau,Sharks,81,52,25,27
91,Patrick Marleau,Sharks,79,44,21,23
91,Patrick Marleau,Sharks,82,57,28,29
91,Patrick Marleau,Sharks,80,57,28,29
91,Patrick Marleau,Sharks,82,86,34,52
91,Patrick Marleau,Sharks,77,78,32,46
91,Patrick Marleau,Sharks,78,48,19,29
91,Patrick Marleau,Sharks,76,71,38,33
91,Patrick Marleau,Sharks,82,83,44,39
91,Patrick Marleau,Sharks,82,73,37,36
91,Patrick Marleau,Sharks,82,64,30,34
91,Patrick Marleau,Sharks,48,31,17,14
91,Patrick Marleau,Sharks,82,70,33,37
91,Patrick Marleau,Sharks,14,13,4,9
92,Jason Arnott,Oilers,78,68,33,35
92,Jason Arnott,Oilers,42,37,15,22
92,Jason Arnott,Oilers,64,59,28,31
92,Jason Arnott,Oilers,67,57,19,38
92,Jason Arnott,Oilers,35,18,5,13
92,Jason Arnott,Devils,35,15,5,10
92,Jason Arnott,Devils,74,54,27,27
92,Jason Arnott,Devils,76,56,22,34
92,Jason Arnott,Devils,54,55,21,34
92,Jason Arnott,Devils,63,41,22,19
92,Jason Arnott,Stars,10,4,3,1
92,Jason Arnott,Stars,72,47,23,24
92,Jason Arnott,Stars,73,57,21,36
92,Jason Arnott,Stars,81,76,32,44
92,Jason Arnott,Predators,68,54,27,27
92,Jason Arnott,Predators,79,72,28,44
92,Jason Arnott,Predators,65,57,33,24
92,Jason Arnott,Predators,63,46,19,27
92,Jason Arnott,Devils,62,24,13,11
92,Jason Arnott,Capitals,11,7,4,3
92,Jason Arnott,Blues,72,34,17,17
93,Steve Thomas,Maple Leafs,18,2,1,1
93,Steve Thomas,Maple Leafs,65,57,20,37
93,Steve Thomas,Maple Leafs,78,62,35,27
93,Steve Thomas,Blackhawks,30,26,13,13
93,Steve Thomas,Blackhawks,45,40,21,19
93,Steve Thomas,Blackhawks,76,70,40,30
93,Steve Thomas,Blackhawks,69,54,19,35
93,Steve Thomas,Blackhawks,11,8,2,6
93,Steve Thomas,Islanders,71,70,28,42
93,Steve Thomas,Islanders,79,87,37,50
93,Steve Thomas,Islanders,78,75,42,33
93,Steve Thomas,Islanders,47,26,11,15
93,Steve Thomas,Devils,81,61,26,35
93,Steve Thomas,Devils,57,34,15,19
93,Steve Thomas,Devils,55,24,14,10
93,Steve Thomas,Maple Leafs,78,73,28,45
93,Steve Thomas,Maple Leafs,81,63,26,37
93,Steve Thomas,Maple Leafs,57,34,8,26
93,Steve Thomas,Blackhawks,34,15,11,4
93,Steve Thomas,Blackhawks,69,17,4,13
93,Steve Thomas,Ducks,12,13,10,3
93,Steve Thomas,Red Wings,44,22,10,12
94,Neal Broten,North Stars,3,2,2,0
94,Neal Broten,North Stars,73,98,38,60
94,Neal Broten,North Stars,79,77,32,45
94,Neal Broten,North Stars,76,89,28,61
94,Neal Broten,North Stars,80,56,19,37
94,Neal Broten,North Stars,80,105,29,76
94,Neal Broten,North Stars,46,53,18,35
94,Neal Broten,North Stars,54,39,9,30
94,Neal Broten,North Stars,68,56,18,38
94,Neal Broten,North Stars,80,85,23,62
94,Neal Broten,North Stars,79,69,13,56
94,Neal Broten,North Stars,76,34,8,26
94,Neal Broten,North Stars,82,33,12,21
94,Neal Broten,Stars,79,52,17,35
94,Neal Broten,Stars,17,4,0,4
94,Neal Broten,Devils,30,28,8,20
94,Neal Broten,Devils,55,23,7,16
94,Neal Broten,Devils,3,1,0,1
94,Neal Broten,Kings,19,4,0,4
94,Neal Broten,Stars,20,15,8,7
95,Vincent Lecavalier,Lightning,82,28,13,15
95,Vincent Lecavalier,Lightning,80,67,25,42
95,Vincent Lecavalier,Lightning,68,51,23,28
95,Vincent Lecavalier,Lightning,76,37,20,17
95,Vincent Lecavalier,Lightning,80,78,33,45
95,Vincent Lecavalier,Lightning,81,66,32,34
95,Vincent Lecavalier,Lightning,80,75,35,40
95,Vincent Lecavalier,Lightning,82,108,52,56
95,Vincent Lecavalier,Lightning,81,92,40,52
95,Vincent Lecavalier,Lightning,77,67,29,38
95,Vincent Lecavalier,Lightning,82,70,24,46
95,Vincent Lecavalier,Lightning,65,54,25,29
95,Vincent Lecavalier,Lightning,64,49,22,27
95,Vincent Lecavalier,Lightning,39,32,10,22
95,Vincent Lecavalier,Flyers,69,37,20,17
95,Vincent Lecavalier,Flyers,6,4,2,2
96,Bobby Orr,Bruins,61,41,13,28
96,Bobby Orr,Bruins,46,31,11,20
96,Bobby Orr,Bruins,67,64,21,43
96,Bobby Orr,Bruins,76,120,33,87
96,Bobby Orr,Bruins,78,139,37,102
96,Bobby Orr,Bruins,76,117,37,80
96,Bobby Orr,Bruins,63,101,29,72
96,Bobby Orr,Bruins,74,122,32,90
96,Bobby Orr,Bruins,80,135,46,89
96,Bobby Orr,Bruins,10,18,5,13
96,Bobby Orr,Blackhawks,20,23,4,19
96,Bobby Orr,Blackhawks,6,4,2,2
97,Gary Roberts,Flames,32,15,5,10
97,Gary Roberts,Flames,74,28,13,15
97,Gary Roberts,Flames,71,38,22,16
97,Gary Roberts,Flames,78,72,39,33
97,Gary Roberts,Flames,80,53,22,31
97,Gary Roberts,Flames,76,90,53,37
97,Gary Roberts,Flames,58,79,38,41
97,Gary Roberts,Flames,73,84,41,43
97,Gary Roberts,Flames,8,4,2,2
97,Gary Roberts,Flames,35,42,22,20
97,Gary Roberts,Hurricanes,61,49,20,29
97,Gary Roberts,Hurricanes,77,42,14,28
97,Gary Roberts,Hurricanes,69,53,23,30
97,Gary Roberts,Maple Leafs,82,53,29,24
97,Gary Roberts,Maple Leafs,69,48,21,27
97,Gary Roberts,Maple Leafs,14,8,5,3
97,Gary Roberts,Maple Leafs,72,48,28,20
97,Gary Roberts,Panthers,58,40,14,26
97,Gary Roberts,Panthers,50,29,13,16
97,Gary Roberts,Penguins,19,13,7,6
97,Gary Roberts,Penguins,38,15,3,12
97,Gary Roberts,Lightning,30,7,4,3
98,Scott Stevens,Capitals,77,25,9,16
98,Scott Stevens,Capitals,78,45,13,32
98,Scott Stevens,Capitals,80,65,21,44
98,Scott Stevens,Capitals,73,53,15,38
98,Scott Stevens,Capitals,77,61,10,51
98,Scott Stevens,Capitals,80,72,12,60
98,Scott Stevens,Capitals,80,68,7,61
98,Scott Stevens,Capitals,56,40,11,29
98,Scott Stevens,Blues,78,49,5,44
98,Scott Stevens,Devils,68,59,17,42
98,Scott Stevens,Devils,81,57,12,45
98,Scott Stevens,Devils,83,78,18,60
98,Scott Stevens,Devils,48,22,2,20
98,Scott Stevens,Devils,82,28,5,23
98,Scott Stevens,Devils,79,24,5,19
98,Scott Stevens,Devils,80,26,4,22
98,Scott Stevens,Devils,75,27,5,22
98,Scott Stevens,Devils,78,29,8,21
98,Scott Stevens,Devils,81,31,9,22
98,Scott Stevens,Devils,82,17,1,16
98,Scott Stevens,Devils,81,20,4,16
98,Scott Stevens,Devils,38,12,3,9
99,Tony Amonte,Rangers,79,69,35,34
99,Tony Amonte,Rangers,83,76,33,43
99,Tony Amonte,Rangers,72,38,16,22
99,Tony Amonte,Blackhawks,7,4,1,3
99,Tony Amonte,Blackhawks,48,35,15,20
99,Tony Amonte,Blackhawks,81,63,31,32
99,Tony Amonte,Blackhawks,81,77,41,36
99,Tony Amonte,Blackhawks,82,73,31,42
99,Tony Amonte,Blackhawks,82,75,44,31
99,Tony Amonte,Blackhawks,82,84,43,41
99,Tony Amonte,Blackhawks,82,64,35,29
99,Tony Amonte,Blackhawks,82,66,27,39
99,Tony Amonte,Coyotes,59,36,13,23
99,Tony Amonte,Flyers,13,15,7,8
99,Tony Amonte,Flyers,80,53,20,33
99,Tony Amonte,Flames,80,42,14,28
99,Tony Amonte,Flames,81,30,10,20
100,Ray Ferraro,Whalers,44,28,11,17
100,Ray Ferraro,Whalers,76,77,30,47
100,Ray Ferraro,Whalers,80,59,27,32
100,Ray Ferraro,Whalers,68,50,21,29
100,Ray Ferraro,Whalers,80,76,41,35
100,Ray Ferraro,Whalers,79,54,25,29
100,Ray Ferraro,Whalers,15,7,2,5
100,Ray Ferraro,Islanders,61,35,19,16
100,Ray Ferraro,Islanders,80,80,40,40
100,Ray Ferraro,Islanders,46,27,14,13
100,Ray Ferraro,Islanders,82,53,21,32
100,Ray Ferraro,Islanders,47,43,22,21
100,Ray Ferraro,Rangers,65,54,25,29
100,Ray Ferraro,Kings,11,6,4,2
100,Ray Ferraro,Kings,81,46,25,21
100,Ray Ferraro,Kings,40,15,6,9
100,Ray Ferraro,Kings,65,31,13,18
100,Ray Ferraro,Thrashers,81,44,19,25
100,Ray Ferraro,Thrashers,81,76,29,47
100,Ray Ferraro,Thrashers,61,27,8,19
100,Ray Ferraro,Blues,15,10,6,4
101,Brad Park,Rangers,54,26,3,23
101,Brad Park,Rangers,60,37,11,26
101,Brad Park,Rangers,68,44,7,37
101,Brad Park,Rangers,75,73,24,49
101,Brad Park,Rangers,52,53,10,43
101,Brad Park,Rangers,78,82,25,57
101,Brad Park,Rangers,65,57,13,44
101,Brad Park,Rangers,13,6,2,4
101,Brad Park,Bruins,43,53,16,37
101,Brad Park,Bruins,77,67,12,55
101,Brad Park,Bruins,80,79,22,57
101,Brad Park,Bruins,40,39,7,32
101,Brad Park,Bruins,32,21,5,16
101,Brad Park,Bruins,78,66,14,52
101,Brad Park,Bruins,75,56,14,42
101,Brad Park,Bruins,76,36,10,26
101,Brad Park,Red Wings,80,58,5,53
101,Brad Park,Red Wings,67,43,13,30
102,Peter Bondra,Capitals,54,28,12,16
102,Peter Bondra,Capitals,71,56,28,28
102,Peter Bondra,Capitals,83,85,37,48
102,Peter Bondra,Capitals,69,43,24,19
102,Peter Bondra,Capitals,47,43,34,9
102,Peter Bondra,Capitals,67,80,52,28
102,Peter Bondra,Capitals,77,77,46,31
102,Peter Bondra,Capitals,76,78,52,26
102,Peter Bondra,Capitals,66,55,31,24
102,Peter Bondra,Capitals,62,38,21,17
102,Peter Bondra,Capitals,82,81,45,36
102,Peter Bondra,Capitals,77,70,39,31
102,Peter Bondra,Capitals,76,56,30,26
102,Peter Bondra,Capitals,54,35,21,14
102,Peter Bondra,Senators,23,14,5,9
102,Peter Bondra,Thrashers,60,39,21,18
102,Peter Bondra,Blackhawks,37,14,5,9
103,Robert Goring,Kings,59,36,13,23
103,Robert Goring,Kings,19,7,2,5
103,Robert Goring,Kings,74,50,21,29
103,Robert Goring,Kings,67,59,28,31
103,Robert Goring,Kings,70,61,28,33
103,Robert Goring,Kings,60,60,27,33
103,Robert Goring,Kings,80,73,33,40
103,Robert Goring,Kings,78,85,30,55
103,Robert Goring,Kings,80,73,37,36
103,Robert Goring,Kings,80,87,36,51
103,Robert Goring,Kings,69,68,20,48
103,Robert Goring,Islanders,12,11,6,5
103,Robert Goring,Islanders,78,60,23,37
103,Robert Goring,Islanders,67,32,15,17
103,Robert Goring,Islanders,75,39,19,20
103,Robert Goring,Islanders,71,46,22,24
103,Robert Goring,Islanders,29,7,2,5
103,Robert Goring,Bruins,39,34,13,21
104,Owen Nolan,Nordiques,59,13,3,10
104,Owen Nolan,Nordiques,75,73,42,31
104,Owen Nolan,Nordiques,73,77,36,41
104,Owen Nolan,Nordiques,6,4,2,2
104,Owen Nolan,Nordiques,46,49,30,19
104,Owen Nolan,Avalanche,9,8,4,4
104,Owen Nolan,Sharks,72,61,29,32
104,Owen Nolan,Sharks,72,63,31,32
104,Owen Nolan,Sharks,75,41,14,27
104,Owen Nolan,Sharks,78,45,19,26
104,Owen Nolan,Sharks,78,84,44,40
104,Owen Nolan,Sharks,57,49,24,25
104,Owen Nolan,Sharks,75,66,23,43
104,Owen Nolan,Sharks,61,42,22,20
104,Owen Nolan,Maple Leafs,14,12,7,5
104,Owen Nolan,Maple Leafs,65,48,19,29
104,Owen Nolan,Coyotes,76,40,16,24
104,Owen Nolan,Flames,77,32,16,16
104,Owen Nolan,Wild,59,45,25,20
104,Owen Nolan,Wild,73,33,16,17
105,Peter Forsberg,Nordiques,47,50,15,35
105,Peter Forsberg,Avalanche,82,116,30,86
105,Peter Forsberg,Avalanche,65,86,28,58
105,Peter Forsberg,Avalanche,72,91,25,66
105,Peter Forsberg,Avalanche,78,97,30,67
105,Peter Forsberg,Avalanche,49,51,14,37
105,Peter Forsberg,Avalanche,73,89,27,62
105,Peter Forsberg,Avalanche,75,106,29,77
105,Peter Forsberg,Avalanche,39,55,18,37
105,Peter Forsberg,Flyers,60,75,19,56
105,Peter Forsberg,Flyers,40,40,11,29
105,Peter Forsberg,Predators,17,15,2,13
105,Peter Forsberg,Avalanche,9,14,1,13
105,Peter Forsberg,Avalanche,2,0,0,0
106,Bill Barber,Flyers,69,64,30,34
106,Bill Barber,Flyers,75,69,34,35
106,Bill Barber,Flyers,79,71,34,37
106,Bill Barber,Flyers,80,112,50,62
106,Bill Barber,Flyers,73,55,20,35
106,Bill Barber,Flyers,80,72,41,31
106,Bill Barber,Flyers,79,80,34,46
106,Bill Barber,Flyers,79,72,40,32
106,Bill Barber,Flyers,80,85,43,42
106,Bill Barber,Flyers,80,89,45,44
106,Bill Barber,Flyers,66,60,27,33
106,Bill Barber,Flyers,63,54,22,32
107,Dennis Maruk,Seals,80,62,30,32
107,Dennis Maruk,Barons,80,78,28,50
107,Dennis Maruk,Barons,76,71,36,35
107,Dennis Maruk,North Stars,2,0,0,0
107,Dennis Maruk,Capitals,76,90,31,59
107,Dennis Maruk,Capitals,27,27,10,17
107,Dennis Maruk,Capitals,80,97,50,47
107,Dennis Maruk,Capitals,80,136,60,76
107,Dennis Maruk,Capitals,80,81,31,50
107,Dennis Maruk,North Stars,71,60,17,43
107,Dennis Maruk,North Stars,71,60,19,41
107,Dennis Maruk,North Stars,70,58,21,37
107,Dennis Maruk,North Stars,67,46,16,30
107,Dennis Maruk,North Stars,22,11,7,4
107,Dennis Maruk,North Stars,6,1,0,1
108,Brad Richards,Lightning,82,62,21,41
108,Brad Richards,Lightning,82,62,20,42
108,Brad Richards,Lightning,80,74,17,57
108,Brad Richards,Lightning,82,79,26,53
108,Brad Richards,Lightning,82,91,23,68
108,Brad Richards,Lightning,82,70,25,45
108,Brad Richards,Lightning,62,51,18,33
108,Brad Richards,Stars,12,11,2,9
108,Brad Richards,Stars,56,48,16,32
108,Brad Richards,Stars,80,91,24,67
108,Brad Richards,Stars,72,77,28,49
108,Brad Richards,Rangers,82,66,25,41
108,Brad Richards,Rangers,46,34,11,23
108,Brad Richards,Rangers,82,51,20,31
108,Brad Richards,Blackhawks,14,7,2,5
109,Shane Doan,Jets (1979),74,17,7,10
109,Shane Doan,Coyotes,63,12,4,8
109,Shane Doan,Coyotes,33,11,5,6
109,Shane Doan,Coyotes,79,22,6,16
109,Shane Doan,Coyotes,81,51,26,25
109,Shane Doan,Coyotes,76,63,26,37
109,Shane Doan,Coyotes,81,49,20,29
109,Shane Doan,Coyotes,82,58,21,37
109,Shane Doan,Coyotes,79,68,27,41
109,Shane Doan,Coyotes,82,66,30,36
109,Shane Doan,Coyotes,73,55,27,28
109,Shane Doan,Coyotes,80,78,28,50
109,Shane Doan,Coyotes,82,73,31,42
109,Shane Doan,Coyotes,82,55,18,37
109,Shane Doan,Coyotes,72,60,20,40
109,Shane Doan,Coyotes,79,50,22,28
109,Shane Doan,Coyotes,48,27,13,14
109,Shane Doan,Coyotes,69,47,23,24
109,Shane Doan,Coyotes,13,9,4,5
110,Markus Naslund,Penguins,71,11,4,7
110,Markus Naslund,Penguins,14,4,2,2
110,Markus Naslund,Penguins,66,52,19,33
110,Markus Naslund,Canucks,10,3,3,0
110,Markus Naslund,Canucks,78,41,21,20
110,Markus Naslund,Canucks,76,34,14,20
110,Markus Naslund,Canucks,80,66,36,30
110,Markus Naslund,Canucks,82,65,27,38
110,Markus Naslund,Canucks,72,75,41,34
110,Markus Naslund,Canucks,81,90,40,50
110,Markus Naslund,Canucks,82,104,48,56
110,Markus Naslund,Canucks,78,84,35,49
110,Markus Naslund,Canucks,81,79,32,47
110,Markus Naslund,Canucks,82,60,24,36
110,Markus Naslund,Canucks,82,55,25,30
110,Markus Naslund,Rangers,82,46,24,22
111,Cliff Ronning,Blues,42,25,11,14
111,Cliff Ronning,Blues,26,13,5,8
111,Cliff Ronning,Blues,64,55,24,31
111,Cliff Ronning,Blues,48,32,14,18
111,Cliff Ronning,Canucks,11,12,6,6
111,Cliff Ronning,Canucks,80,71,24,47
111,Cliff Ronning,Canucks,79,85,29,56
111,Cliff Ronning,Canucks,76,68,25,43
111,Cliff Ronning,Canucks,41,25,6,19
111,Cliff Ronning,Canucks,79,67,22,45
111,Cliff Ronning,Coyotes,69,51,19,32
111,Cliff Ronning,Coyotes,80,55,11,44
111,Cliff Ronning,Coyotes,7,7,2,5
111,Cliff Ronning,Predators,72,53,18,35
111,Cliff Ronning,Predators,82,62,26,36
111,Cliff Ronning,Predators,80,62,19,43
111,Cliff Ronning,Predators,67,49,18,31
111,Cliff Ronning,Kings,14,5,1,4
111,Cliff Ronning,Wild,80,48,17,31
111,Cliff Ronning,Islanders,40,24,9,15
112,Trevor Linden,Canucks,80,59,30,29
112,Trevor Linden,Canucks,73,51,21,30
112,Trevor Linden,Canucks,80,70,33,37
112,Trevor Linden,Canucks,80,75,31,44
112,Trevor Linden,Canucks,84,72,33,39
112,Trevor Linden,Canucks,84,61,32,29
112,Trevor Linden,Canucks,48,40,18,22
112,Trevor Linden,Canucks,82,80,33,47
112,Trevor Linden,Canucks,49,40,9,31
112,Trevor Linden,Canucks,42,21,7,14
112,Trevor Linden,Islanders,25,17,10,7
112,Trevor Linden,Islanders,82,47,18,29
112,Trevor Linden,Canadiens,50,30,13,17
112,Trevor Linden,Canadiens,57,33,12,21
112,Trevor Linden,Capitals,12,4,3,1
112,Trevor Linden,Capitals,16,3,1,2
112,Trevor Linden,Canucks,64,34,12,22
112,Trevor Linden,Canucks,71,41,19,22
112,Trevor Linden,Canucks,82,36,14,22
112,Trevor Linden,Canucks,82,16,7,9
112,Trevor Linden,Canucks,80,25,12,13
112,Trevor Linden,Canucks,59,12,7,5
113,Ivan Boldirev,Bruins,2,0,0,0
113,Ivan Boldirev,Bruins,11,2,0,2
113,Ivan Boldirev,Seals,57,39,16,23
113,Ivan Boldirev,Seals,56,34,11,23
113,Ivan Boldirev,Seals,78,56,25,31
113,Ivan Boldirev,Blackhawks,80,67,24,43
113,Ivan Boldirev,Blackhawks,78,62,28,34
113,Ivan Boldirev,Blackhawks,80,62,24,38
113,Ivan Boldirev,Blackhawks,80,80,35,45
113,Ivan Boldirev,Blackhawks,66,64,29,35
113,Ivan Boldirev,Flames,13,14,6,8
113,Ivan Boldirev,Flames,52,40,16,24
113,Ivan Boldirev,Canucks,27,27,16,11
113,Ivan Boldirev,Canucks,72,59,26,33
113,Ivan Boldirev,Canucks,78,73,33,40
113,Ivan Boldirev,Canucks,39,25,5,20
113,Ivan Boldirev,Red Wings,33,30,13,17
113,Ivan Boldirev,Red Wings,75,83,35,48
113,Ivan Boldirev,Red Wings,75,49,19,30
114,Eric Lindros,Flyers,61,75,41,34
114,Eric Lindros,Flyers,65,97,44,53
114,Eric Lindros,Flyers,46,70,29,41
114,Eric Lindros,Flyers,73,115,47,68
114,Eric Lindros,Flyers,52,79,32,47
114,Eric Lindros,Flyers,63,71,30,41
114,Eric Lindros,Flyers,71,93,40,53
114,Eric Lindros,Flyers,55,59,27,32
114,Eric Lindros,Rangers,72,73,37,36
114,Eric Lindros,Rangers,81,53,19,34
114,Eric Lindros,Rangers,39,32,10,22
114,Eric Lindros,Maple Leafs,33,22,11,11
114,Eric Lindros,Stars,49,26,5,21
115,Yvan Cournoyer,Canadiens,5,4,4,0
115,Yvan Cournoyer,Canadiens,55,17,7,10
115,Yvan Cournoyer,Canadiens,65,29,18,11
115,Yvan Cournoyer,Canadiens,69,40,25,15
115,Yvan Cournoyer,Canadiens,64,60,28,32
115,Yvan Cournoyer,Canadiens,76,87,43,44
115,Yvan Cournoyer,Canadiens,72,63,27,36
115,Yvan Cournoyer,Canadiens,65,73,37,36
115,Yvan Cournoyer,Canadiens,73,83,47,36
115,Yvan Cournoyer,Canadiens,67,79,40,39
115,Yvan Cournoyer,Canadiens,67,73,40,33
115,Yvan Cournoyer,Canadiens,76,74,29,45
115,Yvan Cournoyer,Canadiens,71,68,32,36
115,Yvan Cournoyer,Canadiens,60,53,25,28
115,Yvan Cournoyer,Canadiens,68,53,24,29
115,Yvan Cournoyer,Canadiens,15,7,2,5
116,Dean Prentice,Rangers,55,9,6,3
116,Dean Prentice,Rangers,52,17,4,13
116,Dean Prentice,Rangers,70,31,16,15
116,Dean Prentice,Rangers,70,42,24,18
116,Dean Prentice,Rangers,68,42,19,23
116,Dean Prentice,Rangers,38,22,13,9
116,Dean Prentice,Rangers,70,50,17,33
116,Dean Prentice,Rangers,70,66,32,34
116,Dean Prentice,Rangers,56,45,20,25
116,Dean Prentice,Rangers,68,60,22,38
116,Dean Prentice,Rangers,49,38,13,25
116,Dean Prentice,Bruins,19,15,6,9
116,Dean Prentice,Bruins,70,39,23,16
116,Dean Prentice,Bruins,31,23,14,9
116,Dean Prentice,Bruins,50,29,7,22
116,Dean Prentice,Red Wings,19,15,6,9
116,Dean Prentice,Red Wings,68,45,23,22
116,Dean Prentice,Red Wings,69,55,17,38
116,Dean Prentice,Red Wings,74,34,14,20
116,Dean Prentice,Penguins,75,51,26,25
116,Dean Prentice,Penguins,69,38,21,17
116,Dean Prentice,North Stars,71,47,20,27
116,Dean Prentice,North Stars,73,42,26,16
116,Dean Prentice,North Stars,24,5,2,3
117,Henrik Sedin,Canucks,82,29,9,20
117,Henrik Sedin,Canucks,82,36,16,20
117,Henrik Sedin,Canucks,78,39,8,31
117,Henrik Sedin,Canucks,76,42,11,31
117,Henrik Sedin,Canucks,82,75,18,57
117,Henrik Sedin,Canucks,82,81,10,71
117,Henrik Sedin,Canucks,82,76,15,61
117,Henrik Sedin,Canucks,82,82,22,60
117,Henrik Sedin,Canucks,82,112,29,83
117,Henrik Sedin,Canucks,82,94,19,75
117,Henrik Sedin,Canucks,82,81,14,67
117,Henrik Sedin,Canucks,48,45,11,34
117,Henrik Sedin,Canucks,70,50,11,39
117,Henrik Sedin,Canucks,14,15,5,10
118,Bill Guerin,Devils,5,1,0,1
118,Bill Guerin,Devils,65,34,14,20
118,Bill Guerin,Devils,81,44,25,19
118,Bill Guerin,Devils,48,25,12,13
118,Bill Guerin,Devils,80,53,23,30
118,Bill Guerin,Devils,82,47,29,18
118,Bill Guerin,Devils,19,10,5,5
118,Bill Guerin,Oilers,40,29,13,16
118,Bill Guerin,Oilers,80,64,30,34
118,Bill Guerin,Oilers,70,46,24,22
118,Bill Guerin,Oilers,21,22,12,10
118,Bill Guerin,Bruins,64,63,28,35
118,Bill Guerin,Bruins,78,66,41,25
118,Bill Guerin,Stars,64,50,25,25
118,Bill Guerin,Stars,82,69,34,35
118,Bill Guerin,Stars,70,40,13,27
118,Bill Guerin,Blues,61,47,28,19
118,Bill Guerin,Sharks,16,9,8,1
118,Bill Guerin,Islanders,81,44,23,21
118,Bill Guerin,Islanders,61,36,16,20
118,Bill Guerin,Penguins,17,12,5,7
118,Bill Guerin,Penguins,78,45,21,24
119,Tomas Sandstrom,Rangers,74,58,29,29
119,Tomas Sandstrom,Rangers,73,54,25,29
119,Tomas Sandstrom,Rangers,64,74,40,34
119,Tomas Sandstrom,Rangers,69,68,28,40
119,Tomas Sandstrom,Rangers,79,88,32,56
119,Tomas Sandstrom,Rangers,48,38,19,19
119,Tomas Sandstrom,Kings,28,33,13,20
119,Tomas Sandstrom,Kings,68,89,45,44
119,Tomas Sandstrom,Kings,49,39,17,22
119,Tomas Sandstrom,Kings,39,52,25,27
119,Tomas Sandstrom,Kings,51,41,17,24
119,Tomas Sandstrom,Penguins,27,17,6,11
119,Tomas Sandstrom,Penguins,47,44,21,23
119,Tomas Sandstrom,Penguins,58,70,35,35
119,Tomas Sandstrom,Penguins,40,24,9,15
119,Tomas Sandstrom,Red Wings,34,18,9,9
119,Tomas Sandstrom,Ducks,77,17,9,8
119,Tomas Sandstrom,Ducks,58,32,15,17
120,Vyacheslav Kozlov,Red Wings,7,2,0,2
120,Vyacheslav Kozlov,Red Wings,17,5,4,1
120,Vyacheslav Kozlov,Red Wings,77,73,34,39
120,Vyacheslav Kozlov,Red Wings,46,33,13,20
120,Vyacheslav Kozlov,Red Wings,82,73,36,37
120,Vyacheslav Kozlov,Red Wings,75,45,23,22
120,Vyacheslav Kozlov,Red Wings,80,52,25,27
120,Vyacheslav Kozlov,Red Wings,79,58,29,29
120,Vyacheslav Kozlov,Red Wings,72,36,18,18
120,Vyacheslav Kozlov,Red Wings,72,38,20,18
120,Vyacheslav Kozlov,Sabres,38,22,9,13
120,Vyacheslav Kozlov,Thrashers,79,70,21,49
120,Vyacheslav Kozlov,Thrashers,76,52,20,32
120,Vyacheslav Kozlov,Thrashers,82,71,25,46
120,Vyacheslav Kozlov,Thrashers,81,80,28,52
120,Vyacheslav Kozlov,Thrashers,82,41,17,24
120,Vyacheslav Kozlov,Thrashers,82,76,26,50
120,Vyacheslav Kozlov,Thrashers,55,26,8,18
121,Ted Lindsay,Red Wings,45,23,17,6
121,Ted Lindsay,Red Wings,47,17,7,10
121,Ted Lindsay,Red Wings,59,42,27,15
121,Ted Lindsay,Red Wings,60,52,33,19
121,Ted Lindsay,Red Wings,50,54,26,28
121,Ted Lindsay,Red Wings,69,78,23,55
121,Ted Lindsay,Red Wings,67,59,24,35
121,Ted Lindsay,Red Wings,70,69,30,39
121,Ted Lindsay,Red Wings,70,71,32,39
121,Ted Lindsay,Red Wings,70,62,26,36
121,Ted Lindsay,Red Wings,49,38,19,19
121,Ted Lindsay,Red Wings,67,50,27,23
121,Ted Lindsay,Red Wings,70,85,30,55
121,Ted Lindsay,Blackhawks,68,39,15,24
121,Ted Lindsay,Blackhawks,70,58,22,36
121,Ted Lindsay,Blackhawks,68,26,7,19
121,Ted Lindsay,Red Wings,69,28,14,14
122,Gary Suter,Flames,80,68,18,50
122,Gary Suter,Flames,68,48,9,39
122,Gary Suter,Flames,75,91,21,70
122,Gary Suter,Flames,63,62,13,49
122,Gary Suter,Flames,76,76,16,60
122,Gary Suter,Flames,79,70,12,58
122,Gary Suter,Flames,70,55,12,43
122,Gary Suter,Flames,81,81,23,58
122,Gary Suter,Flames,25,13,4,9
122,Gary Suter,Blackhawks,16,5,2,3
122,Gary Suter,Blackhawks,48,37,10,27
122,Gary Suter,Blackhawks,82,67,20,47
122,Gary Suter,Blackhawks,82,28,7,21
122,Gary Suter,Blackhawks,73,42,14,28
122,Gary Suter,Sharks,1,0,0,0
122,Gary Suter,Sharks,76,34,6,28
122,Gary Suter,Sharks,68,34,10,24
122,Gary Suter,Sharks,82,33,6,27
123,Thomas Lysiak,Flames,77,64,19,45
123,Thomas Lysiak,Flames,77,77,25,52
123,Thomas Lysiak,Flames,80,82,31,51
123,Thomas Lysiak,Flames,79,81,30,51
123,Thomas Lysiak,Flames,80,69,27,42
123,Thomas Lysiak,Flames,52,58,23,35
123,Thomas Lysiak,Blackhawks,14,10,0,10
123,Thomas Lysiak,Blackhawks,77,69,26,43
123,Thomas Lysiak,Blackhawks,72,76,21,55
123,Thomas Lysiak,Blackhawks,71,82,32,50
123,Thomas Lysiak,Blackhawks,61,61,23,38
123,Thomas Lysiak,Blackhawks,54,47,17,30
123,Thomas Lysiak,Blackhawks,74,46,16,30
123,Thomas Lysiak,Blackhawks,51,21,2,19
124,John MacLean,Devils,23,1,1,0
124,John MacLean,Devils,61,33,13,20
124,John MacLean,Devils,74,57,21,36
124,John MacLean,Devils,80,67,31,36
124,John MacLean,Devils,76,39,23,16
124,John MacLean,Devils,74,87,42,45
124,John MacLean,Devils,80,79,41,38
124,John MacLean,Devils,78,78,45,33
124,John MacLean,Devils,80,48,24,24
124,John MacLean,Devils,80,70,37,33
124,John MacLean,Devils,46,29,17,12
124,John MacLean,Devils,76,48,20,28
124,John MacLean,Devils,80,54,29,25
124,John MacLean,Devils,26,11,3,8
124,John MacLean,Sharks,51,32,13,19
124,John MacLean,Rangers,82,55,28,27
124,John MacLean,Rangers,77,42,18,24
124,John MacLean,Rangers,2,0,0,0
124,John MacLean,Stars,28,6,4,2
124,John MacLean,Stars,20,6,3,3
125,Ryan Smyth,Oilers,3,0,0,0
125,Ryan Smyth,Oilers,48,11,2,9
125,Ryan Smyth,Oilers,82,61,39,22
125,Ryan Smyth,Oilers,65,33,20,13
125,Ryan Smyth,Oilers,71,31,13,18
125,Ryan Smyth,Oilers,82,54,28,26
125,Ryan Smyth,Oilers,82,70,31,39
125,Ryan Smyth,Oilers,61,50,15,35
125,Ryan Smyth,Oilers,66,61,27,34
125,Ryan Smyth,Oilers,82,59,23,36
125,Ryan Smyth,Oilers,75,66,36,30
125,Ryan Smyth,Oilers,53,53,31,22
125,Ryan Smyth,Islanders,18,15,5,10
125,Ryan Smyth,Avalanche,55,37,14,23
125,Ryan Smyth,Avalanche,77,59,26,33
125,Ryan Smyth,Kings,67,53,22,31
125,Ryan Smyth,Kings,82,47,23,24
125,Ryan Smyth,Oilers,82,46,19,27
125,Ryan Smyth,Oilers,47,13,2,11
125,Ryan Smyth,Oilers,72,23,10,13
126,Scott Mellanby,Flyers,2,0,0,0
126,Scott Mellanby,Flyers,71,32,11,21
126,Scott Mellanby,Flyers,75,51,25,26
126,Scott Mellanby,Flyers,76,50,21,29
126,Scott Mellanby,Flyers,57,23,6,17
126,Scott Mellanby,Flyers,74,41,20,21
126,Scott Mellanby,Oilers,80,50,23,27
126,Scott Mellanby,Oilers,69,32,15,17
126,Scott Mellanby,Panthers,80,60,30,30
126,Scott Mellanby,Panthers,48,25,13,12
126,Scott Mellanby,Panthers,79,70,32,38
126,Scott Mellanby,Panthers,82,56,27,29
126,Scott Mellanby,Panthers,79,39,15,24
126,Scott Mellanby,Panthers,67,45,18,27
126,Scott Mellanby,Panthers,77,46,18,28
126,Scott Mellanby,Panthers,40,13,4,9
126,Scott Mellanby,Blues,23,8,7,1
126,Scott Mellanby,Blues,64,41,15,26
126,Scott Mellanby,Blues,80,57,26,31
126,Scott Mellanby,Blues,68,31,14,17
126,Scott Mellanby,Thrashers,71,34,12,22
126,Scott Mellanby,Thrashers,69,36,12,24
127,John Tonelli,Islanders,73,56,17,39
127,John Tonelli,Islanders,77,44,14,30
127,John Tonelli,Islanders,70,52,20,32
127,John Tonelli,Islanders,80,93,35,58
127,John Tonelli,Islanders,76,71,31,40
127,John Tonelli,Islanders,73,67,27,40
127,John Tonelli,Islanders,80,100,42,58
127,John Tonelli,Islanders,65,61,20,41
127,John Tonelli,Flames,9,7,3,4
127,John Tonelli,Flames,78,51,20,31
127,John Tonelli,Flames,74,58,17,41
127,John Tonelli,Kings,77,64,31,33
127,John Tonelli,Kings,73,68,31,37
127,John Tonelli,Kings,71,30,14,16
127,John Tonelli,Blackhawks,33,8,1,7
127,John Tonelli,Nordiques,19,6,2,4
128,Jacques Lemaire,Canadiens,69,42,22,20
128,Jacques Lemaire,Canadiens,75,63,29,34
128,Jacques Lemaire,Canadiens,69,60,32,28
128,Jacques Lemaire,Canadiens,78,56,28,28
128,Jacques Lemaire,Canadiens,77,81,32,49
128,Jacques Lemaire,Canadiens,77,95,44,51
128,Jacques Lemaire,Canadiens,66,67,29,38
128,Jacques Lemaire,Canadiens,80,92,36,56
128,Jacques Lemaire,Canadiens,61,52,20,32
128,Jacques Lemaire,Canadiens,75,75,34,41
128,Jacques Lemaire,Canadiens,76,97,36,61
128,Jacques Lemaire,Canadiens,50,55,24,31
129,Saku Koivu,Canadiens,82,45,20,25
129,Saku Koivu,Canadiens,50,56,17,39
129,Saku Koivu,Canadiens,69,57,14,43
129,Saku Koivu,Canadiens,65,44,14,30
129,Saku Koivu,Canadiens,24,21,3,18
129,Saku Koivu,Canadiens,54,47,17,30
129,Saku Koivu,Canadiens,3,2,0,2
129,Saku Koivu,Canadiens,82,71,21,50
129,Saku Koivu,Canadiens,68,55,14,41
129,Saku Koivu,Canadiens,72,62,17,45
129,Saku Koivu,Canadiens,81,75,22,53
129,Saku Koivu,Canadiens,77,56,16,40
129,Saku Koivu,Canadiens,65,50,16,34
129,Saku Koivu,Ducks,71,52,19,33
129,Saku Koivu,Ducks,75,45,15,30
129,Saku Koivu,Ducks,74,38,11,27
129,Saku Koivu,Ducks,47,27,8,19
129,Saku Koivu,Ducks,65,29,11,18
130,Brent Sutter,Islanders,3,4,2,2
130,Brent Sutter,Islanders,43,43,21,22
130,Brent Sutter,Islanders,80,40,21,19
130,Brent Sutter,Islanders,69,49,34,15
130,Brent Sutter,Islanders,72,102,42,60
130,Brent Sutter,Islanders,61,55,24,31
130,Brent Sutter,Islanders,69,63,27,36
130,Brent Sutter,Islanders,70,60,29,31
130,Brent Sutter,Islanders,77,63,29,34
130,Brent Sutter,Islanders,67,68,33,35
130,Brent Sutter,Islanders,75,53,21,32
130,Brent Sutter,Islanders,8,10,4,6
130,Brent Sutter,Blackhawks,61,50,18,32
130,Brent Sutter,Blackhawks,65,54,20,34
130,Brent Sutter,Blackhawks,73,38,9,29
130,Brent Sutter,Blackhawks,47,15,7,8
130,Brent Sutter,Blackhawks,80,40,13,27
130,Brent Sutter,Blackhawks,39,14,7,7
130,Brent Sutter,Blackhawks,52,8,2,6
131,Alex Ovechkin,Capitals,81,106,52,54
131,Alex Ovechkin,Capitals,82,92,46,46
131,Alex Ovechkin,Capitals,82,112,65,47
131,Alex Ovechkin,Capitals,79,110,56,54
131,Alex Ovechkin,Capitals,72,109,50,59
131,Alex Ovechkin,Capitals,79,85,32,53
131,Alex Ovechkin,Capitals,78,65,38,27
131,Alex Ovechkin,Capitals,48,56,32,24
131,Alex Ovechkin,Capitals,78,79,51,28
131,Alex Ovechkin,Capitals,13,13,6,7
132,John Ogrodnick,Red Wings,41,32,8,24
132,John Ogrodnick,Red Wings,80,70,35,35
132,John Ogrodnick,Red Wings,80,54,28,26
132,John Ogrodnick,Red Wings,80,85,41,44
132,John Ogrodnick,Red Wings,64,78,42,36
132,John Ogrodnick,Red Wings,79,105,55,50
132,John Ogrodnick,Red Wings,76,70,38,32
132,John Ogrodnick,Red Wings,39,40,12,28
132,John Ogrodnick,Nordiques,32,27,11,16
132,John Ogrodnick,Rangers,64,54,22,32
132,John Ogrodnick,Rangers,60,42,13,29
132,John Ogrodnick,Rangers,80,74,43,31
132,John Ogrodnick,Rangers,79,54,31,23
132,John Ogrodnick,Rangers,55,30,17,13
132,John Ogrodnick,Red Wings,19,12,6,6
133,Douglas Wilson,Blackhawks,77,34,14,20
133,Douglas Wilson,Blackhawks,56,26,5,21
133,Douglas Wilson,Blackhawks,73,61,12,49
133,Douglas Wilson,Blackhawks,76,51,12,39
133,Douglas Wilson,Blackhawks,76,85,39,46
133,Douglas Wilson,Blackhawks,74,69,18,51
133,Douglas Wilson,Blackhawks,66,58,13,45
133,Douglas Wilson,Blackhawks,78,76,22,54
133,Douglas Wilson,Blackhawks,79,64,17,47
133,Douglas Wilson,Blackhawks,69,48,16,32
133,Douglas Wilson,Blackhawks,27,32,8,24
133,Douglas Wilson,Blackhawks,66,62,15,47
133,Douglas Wilson,Blackhawks,70,73,23,50
133,Douglas Wilson,Blackhawks,51,40,11,29
133,Douglas Wilson,Sharks,44,28,9,19
133,Douglas Wilson,Sharks,42,20,3,17
134,Red Kelly,Red Wings,60,20,6,14
134,Red Kelly,Red Wings,59,16,5,11
134,Red Kelly,Red Wings,70,40,15,25
134,Red Kelly,Red Wings,70,54,17,37
134,Red Kelly,Red Wings,67,47,16,31
134,Red Kelly,Red Wings,70,46,19,27
134,Red Kelly,Red Wings,62,49,16,33
134,Red Kelly,Red Wings,70,45,15,30
134,Red Kelly,Red Wings,70,50,16,34
134,Red Kelly,Red Wings,70,35,10,25
134,Red Kelly,Red Wings,61,31,13,18
134,Red Kelly,Red Wings,67,21,8,13
134,Red Kelly,Red Wings,50,18,6,12
134,Red Kelly,Maple Leafs,18,11,6,5
134,Red Kelly,Maple Leafs,64,70,20,50
134,Red Kelly,Maple Leafs,58,49,22,27
134,Red Kelly,Maple Leafs,66,60,20,40
134,Red Kelly,Maple Leafs,70,45,11,34
134,Red Kelly,Maple Leafs,70,46,18,28
134,Red Kelly,Maple Leafs,63,32,8,24
134,Red Kelly,Maple Leafs,61,38,14,24
135,Pierre Larouche,Penguins,79,68,31,37
135,Pierre Larouche,Penguins,76,111,53,58
135,Pierre Larouche,Penguins,65,63,29,34
135,Pierre Larouche,Penguins,20,11,6,5
135,Pierre Larouche,Canadiens,44,49,17,32
135,Pierre Larouche,Canadiens,36,22,9,13
135,Pierre Larouche,Canadiens,73,91,50,41
135,Pierre Larouche,Canadiens,61,53,25,28
135,Pierre Larouche,Canadiens,22,21,9,12
135,Pierre Larouche,Whalers,45,50,25,25
135,Pierre Larouche,Whalers,38,40,18,22
135,Pierre Larouche,Rangers,77,81,48,33
135,Pierre Larouche,Rangers,65,60,24,36
135,Pierre Larouche,Rangers,28,27,20,7
135,Pierre Larouche,Rangers,73,63,28,35
135,Pierre Larouche,Rangers,10,12,3,9
136,Bernie Geoffrion,Canadiens,18,14,8,6
136,Bernie Geoffrion,Canadiens,67,54,30,24
136,Bernie Geoffrion,Canadiens,65,39,22,17
136,Bernie Geoffrion,Canadiens,54,54,29,25
136,Bernie Geoffrion,Canadiens,70,75,38,37
136,Bernie Geoffrion,Canadiens,59,62,29,33
136,Bernie Geoffrion,Canadiens,41,40,19,21
136,Bernie Geoffrion,Canadiens,42,50,27,23
136,Bernie Geoffrion,Canadiens,59,66,22,44
136,Bernie Geoffrion,Canadiens,59,71,30,41
136,Bernie Geoffrion,Canadiens,64,95,50,45
136,Bernie Geoffrion,Canadiens,62,59,23,36
136,Bernie Geoffrion,Canadiens,51,41,23,18
136,Bernie Geoffrion,Canadiens,55,39,21,18
136,Bernie Geoffrion,Rangers,58,42,17,25
136,Bernie Geoffrion,Rangers,59,21,5,16
137,Stephane Richer,Canadiens,1,0,0,0
137,Stephane Richer,Canadiens,65,37,21,16
137,Stephane Richer,Canadiens,57,39,20,19
137,Stephane Richer,Canadiens,72,78,50,28
137,Stephane Richer,Canadiens,68,60,25,35
137,Stephane Richer,Canadiens,75,91,51,40
137,Stephane Richer,Canadiens,75,61,31,30
137,Stephane Richer,Devils,74,64,29,35
137,Stephane Richer,Devils,78,73,38,35
137,Stephane Richer,Devils,80,72,36,36
137,Stephane Richer,Devils,45,39,23,16
137,Stephane Richer,Devils,73,32,20,12
137,Stephane Richer,Canadiens,63,46,22,24
137,Stephane Richer,Canadiens,14,9,5,4
137,Stephane Richer,Lightning,26,20,9,11
137,Stephane Richer,Lightning,64,33,12,21
137,Stephane Richer,Lightning,20,12,7,5
137,Stephane Richer,Blues,36,25,8,17
137,Stephane Richer,Penguins,58,25,13,12
137,Stephane Richer,Devils,10,3,1,2
138,John Leclair,Canadiens,10,7,2,5
138,John Leclair,Canadiens,59,19,8,11
138,John Leclair,Canadiens,72,44,19,25
138,John Leclair,Canadiens,74,43,19,24
138,John Leclair,Canadiens,9,5,1,4
138,John Leclair,Flyers,37,49,25,24
138,John Leclair,Flyers,82,97,51,46
138,John Leclair,Flyers,82,97,50,47
138,John Leclair,Flyers,82,87,51,36
138,John Leclair,Flyers,76,90,43,47
138,John Leclair,Flyers,82,77,40,37
138,John Leclair,Flyers,16,12,7,5
138,John Leclair,Flyers,82,51,25,26
138,John Leclair,Flyers,35,28,18,10
138,John Leclair,Flyers,75,55,23,32
138,John Leclair,Penguins,73,51,22,29
138,John Leclair,Penguins,21,7,2,5
139,Daniel Sedin,Canucks,75,34,20,14
139,Daniel Sedin,Canucks,79,32,9,23
139,Daniel Sedin,Canucks,79,31,14,17
139,Daniel Sedin,Canucks,82,54,18,36
139,Daniel Sedin,Canucks,82,71,22,49
139,Daniel Sedin,Canucks,81,84,36,48
139,Daniel Sedin,Canucks,82,74,29,45
139,Daniel Sedin,Canucks,82,82,31,51
139,Daniel Sedin,Canucks,63,85,29,56
139,Daniel Sedin,Canucks,82,104,41,63
139,Daniel Sedin,Canucks,72,67,30,37
139,Daniel Sedin,Canucks,47,40,12,28
139,Daniel Sedin,Canucks,73,47,16,31
139,Daniel Sedin,Canucks,14,14,3,11
140,Stephen Shutt,Canadiens,50,16,8,8
140,Stephen Shutt,Canadiens,70,35,15,20
140,Stephen Shutt,Canadiens,77,65,30,35
140,Stephen Shutt,Canadiens,80,79,45,34
140,Stephen Shutt,Canadiens,80,105,60,45
140,Stephen Shutt,Canadiens,80,86,49,37
140,Stephen Shutt,Canadiens,72,77,37,40
140,Stephen Shutt,Canadiens,77,89,47,42
140,Stephen Shutt,Canadiens,77,73,35,38
140,Stephen Shutt,Canadiens,57,55,31,24
140,Stephen Shutt,Canadiens,78,57,35,22
140,Stephen Shutt,Canadiens,63,37,14,23
140,Stephen Shutt,Canadiens,10,2,2,0
140,Stephen Shutt,Kings,59,41,16,25
141,Thomas Steen,Jets (1979),73,44,15,29
141,Thomas Steen,Jets (1979),75,59,26,33
141,Thomas Steen,Jets (1979),78,65,20,45
141,Thomas Steen,Jets (1979),79,84,30,54
141,Thomas Steen,Jets (1979),78,64,17,47
141,Thomas Steen,Jets (1979),75,50,17,33
141,Thomas Steen,Jets (1979),76,54,16,38
141,Thomas Steen,Jets (1979),80,88,27,61
141,Thomas Steen,Jets (1979),53,66,18,48
141,Thomas Steen,Jets (1979),58,67,19,48
141,Thomas Steen,Jets (1979),38,38,13,25
141,Thomas Steen,Jets (1979),80,72,22,50
141,Thomas Steen,Jets (1979),76,51,19,32
141,Thomas Steen,Jets (1979),31,15,5,10
142,Ilya Kovalchuk,Thrashers,65,51,29,22
142,Ilya Kovalchuk,Thrashers,81,67,38,29
142,Ilya Kovalchuk,Thrashers,81,87,41,46
142,Ilya Kovalchuk,Thrashers,78,98,52,46
142,Ilya Kovalchuk,Thrashers,82,76,42,34
142,Ilya Kovalchuk,Thrashers,79,87,52,35
142,Ilya Kovalchuk,Thrashers,79,91,43,48
142,Ilya Kovalchuk,Thrashers,49,58,31,27
142,Ilya Kovalchuk,Devils,27,27,10,17
142,Ilya Kovalchuk,Devils,81,60,31,29
142,Ilya Kovalchuk,Devils,77,83,37,46
142,Ilya Kovalchuk,Devils,37,31,11,20
143,Wilf Paiement,Scouts,78,39,26,13
143,Wilf Paiement,Scouts,57,43,21,22
143,Wilf Paiement,Rockies,78,81,41,40
143,Wilf Paiement,Rockies,80,87,31,56
143,Wilf Paiement,Rockies,65,60,24,36
143,Wilf Paiement,Rockies,34,26,10,16
143,Wilf Paiement,Maple Leafs,41,48,20,28
143,Wilf Paiement,Maple Leafs,77,97,40,57
143,Wilf Paiement,Maple Leafs,69,58,18,40
143,Wilf Paiement,Nordiques,8,13,7,6
143,Wilf Paiement,Nordiques,80,64,26,38
143,Wilf Paiement,Nordiques,80,76,39,37
143,Wilf Paiement,Nordiques,68,51,23,28
143,Wilf Paiement,Nordiques,44,19,7,12
143,Wilf Paiement,Rangers,8,7,1,6
143,Wilf Paiement,Sabres,56,37,20,17
143,Wilf Paiement,Penguins,23,8,2,6
144,Pavel Datsyuk,Red Wings,70,35,11,24
144,Pavel Datsyuk,Red Wings,64,51,12,39
144,Pavel Datsyuk,Red Wings,75,68,30,38
144,Pavel Datsyuk,Red Wings,75,87,28,59
144,Pavel Datsyuk,Red Wings,79,87,27,60
144,Pavel Datsyuk,Red Wings,82,97,31,66
144,Pavel Datsyuk,Red Wings,81,97,32,65
144,Pavel Datsyuk,Red Wings,80,70,27,43
144,Pavel Datsyuk,Red Wings,56,59,23,36
144,Pavel Datsyuk,Red Wings,70,67,19,48
144,Pavel Datsyuk,Red Wings,47,49,15,34
144,Pavel Datsyuk,Red Wings,45,37,17,20
144,Pavel Datsyuk,Red Wings,8,10,5,5
145,Peter Mcnab,Sabres,22,9,3,6
145,Peter Mcnab,Sabres,53,43,22,21
145,Peter Mcnab,Sabres,79,56,24,32
145,Peter Mcnab,Bruins,80,86,38,48
145,Peter Mcnab,Bruins,79,80,41,39
145,Peter Mcnab,Bruins,76,80,35,45
145,Peter Mcnab,Bruins,74,78,40,38
145,Peter Mcnab,Bruins,80,83,37,46
145,Peter Mcnab,Bruins,80,76,36,40
145,Peter Mcnab,Bruins,74,74,22,52
145,Peter Mcnab,Bruins,52,30,14,16
145,Peter Mcnab,Canucks,13,7,1,6
145,Peter Mcnab,Canucks,75,48,23,25
145,Peter Mcnab,Devils,71,43,19,24
145,Peter Mcnab,Devils,46,20,8,12
146,Pit Martin,Red Wings,1,1,0,1
146,Pit Martin,Red Wings,50,21,9,12
146,Pit Martin,Red Wings,58,17,8,9
146,Pit Martin,Red Wings,10,2,1,1
146,Pit Martin,Bruins,41,27,16,11
146,Pit Martin,Bruins,70,42,20,22
146,Pit Martin,Blackhawks,63,35,16,19
146,Pit Martin,Blackhawks,76,61,23,38
146,Pit Martin,Blackhawks,73,63,30,33
146,Pit Martin,Blackhawks,62,55,22,33
146,Pit Martin,Blackhawks,78,75,24,51
146,Pit Martin,Blackhawks,78,90,29,61
146,Pit Martin,Blackhawks,78,77,30,47
146,Pit Martin,Blackhawks,70,45,19,26
146,Pit Martin,Blackhawks,80,71,32,39
146,Pit Martin,Blackhawks,75,53,17,36
146,Pit Martin,Blackhawks,7,2,1,1
146,Pit Martin,Canucks,67,46,15,31
146,Pit Martin,Canucks,64,26,12,14
147,Ken Linseman,Flyers,30,25,5,20
147,Ken Linseman,Flyers,80,79,22,57
147,Ken Linseman,Flyers,51,47,17,30
147,Ken Linseman,Flyers,79,92,24,68
147,Ken Linseman,Oilers,72,75,33,42
147,Ken Linseman,Oilers,72,67,18,49
147,Ken Linseman,Bruins,74,74,25,49
147,Ken Linseman,Bruins,64,81,23,58
147,Ken Linseman,Bruins,64,49,15,34
147,Ken Linseman,Bruins,77,74,29,45
147,Ken Linseman,Bruins,78,72,27,45
147,Ken Linseman,Bruins,32,22,6,16
147,Ken Linseman,Flyers,29,14,5,9
147,Ken Linseman,Oilers,56,36,7,29
147,Ken Linseman,Maple Leafs,2,0,0,0
148,Milan Hejduk,Avalanche,82,48,14,34
148,Milan Hejduk,Avalanche,82,72,36,36
148,Milan Hejduk,Avalanche,80,79,41,38
148,Milan Hejduk,Avalanche,62,44,21,23
148,Milan Hejduk,Avalanche,82,98,50,48
148,Milan Hejduk,Avalanche,82,75,35,40
148,Milan Hejduk,Avalanche,74,58,24,34
148,Milan Hejduk,Avalanche,80,70,35,35
148,Milan Hejduk,Avalanche,77,54,29,25
148,Milan Hejduk,Avalanche,82,59,27,32
148,Milan Hejduk,Avalanche,56,44,23,21
148,Milan Hejduk,Avalanche,71,56,22,34
148,Milan Hejduk,Avalanche,81,37,14,23
148,Milan Hejduk,Avalanche,29,11,4,7
149,Garry Unger,Maple Leafs,15,2,1,1
149,Garry Unger,Red Wings,13,15,5,10
149,Garry Unger,Red Wings,76,44,24,20
149,Garry Unger,Red Wings,76,66,42,24
149,Garry Unger,Red Wings,51,27,13,14
149,Garry Unger,Blues,28,29,15,14
149,Garry Unger,Blues,78,70,36,34
149,Garry Unger,Blues,78,80,41,39
149,Garry Unger,Blues,78,68,33,35
149,Garry Unger,Blues,80,80,36,44
149,Garry Unger,Blues,80,83,39,44
149,Garry Unger,Blues,80,57,30,27
149,Garry Unger,Blues,80,52,32,20
149,Garry Unger,Blues,80,56,30,26
149,Garry Unger,Flames,79,33,17,16
149,Garry Unger,Kings,58,20,10,10
149,Garry Unger,Oilers,13,0,0,0
149,Garry Unger,Oilers,46,20,7,13
149,Garry Unger,Oilers,16,2,2,0
150,Ken Hodge,Blackhawks,1,0,0,0
150,Ken Hodge,Blackhawks,63,23,6,17
150,Ken Hodge,Blackhawks,69,35,10,25
150,Ken Hodge,Bruins,74,56,25,31
150,Ken Hodge,Bruins,75,90,45,45
150,Ken Hodge,Bruins,72,54,25,29
150,Ken Hodge,Bruins,78,105,43,62
150,Ken Hodge,Bruins,60,56,16,40
150,Ken Hodge,Bruins,73,81,37,44
150,Ken Hodge,Bruins,76,105,50,55
150,Ken Hodge,Bruins,72,66,23,43
150,Ken Hodge,Bruins,72,61,25,36
150,Ken Hodge,Rangers,78,62,21,41
150,Ken Hodge,Rangers,18,6,2,4
151,Geoff Courtnall,Bruins,4,0,0,0
151,Geoff Courtnall,Bruins,64,28,12,16
151,Geoff Courtnall,Bruins,64,37,21,16
151,Geoff Courtnall,Bruins,65,36,13,23
151,Geoff Courtnall,Bruins,62,58,32,26
151,Geoff Courtnall,Oilers,12,8,4,4
151,Geoff Courtnall,Capitals,79,80,42,38
151,Geoff Courtnall,Capitals,80,74,35,39
151,Geoff Courtnall,Blues,66,57,27,30
151,Geoff Courtnall,Canucks,11,8,6,2
151,Geoff Courtnall,Canucks,70,57,23,34
151,Geoff Courtnall,Canucks,84,77,31,46
151,Geoff Courtnall,Canucks,82,70,26,44
151,Geoff Courtnall,Canucks,45,34,16,18
151,Geoff Courtnall,Blues,69,40,24,16
151,Geoff Courtnall,Blues,82,57,17,40
151,Geoff Courtnall,Blues,79,62,31,31
151,Geoff Courtnall,Blues,24,12,5,7
151,Geoff Courtnall,Blues,6,4,2,2
152,Sergei Gonchar,Capitals,31,7,2,5
152,Sergei Gonchar,Capitals,78,41,15,26
152,Sergei Gonchar,Capitals,57,30,13,17
152,Sergei Gonchar,Capitals,72,21,5,16
152,Sergei Gonchar,Capitals,53,31,21,10
152,Sergei Gonchar,Capitals,73,54,18,36
152,Sergei Gonchar,Capitals,76,57,19,38
152,Sergei Gonchar,Capitals,76,59,26,33
152,Sergei Gonchar,Capitals,82,67,18,49
152,Sergei Gonchar,Capitals,56,49,7,42
152,Sergei Gonchar,Bruins,15,9,4,5
152,Sergei Gonchar,Penguins,75,58,12,46
152,Sergei Gonchar,Penguins,82,67,13,54
152,Sergei Gonchar,Penguins,78,65,12,53
152,Sergei Gonchar,Penguins,25,19,6,13
152,Sergei Gonchar,Penguins,62,50,11,39
152,Sergei Gonchar,Senators,67,27,7,20
152,Sergei Gonchar,Senators,74,37,5,32
152,Sergei Gonchar,Senators,45,27,3,24
152,Sergei Gonchar,Stars,76,22,2,20
152,Sergei Gonchar,Stars,2,0,0,0
153,Eddie Olczyk,Blackhawks,70,50,20,30
153,Eddie Olczyk,Blackhawks,79,79,29,50
153,Eddie Olczyk,Blackhawks,79,51,16,35
153,Eddie Olczyk,Maple Leafs,80,75,42,33
153,Eddie Olczyk,Maple Leafs,80,90,38,52
153,Eddie Olczyk,Maple Leafs,79,88,32,56
153,Eddie Olczyk,Maple Leafs,18,14,4,10
153,Eddie Olczyk,Jets (1979),61,57,26,31
153,Eddie Olczyk,Jets (1979),64,65,32,33
153,Eddie Olczyk,Jets (1979),25,20,8,12
153,Eddie Olczyk,Rangers,46,29,13,16
153,Eddie Olczyk,Rangers,37,8,3,5
153,Eddie Olczyk,Rangers,20,3,2,1
153,Eddie Olczyk,Jets (1979),13,10,2,8
153,Eddie Olczyk,Jets (1979),51,49,27,22
153,Eddie Olczyk,Kings,67,44,21,23
153,Eddie Olczyk,Penguins,12,11,4,7
153,Eddie Olczyk,Penguins,56,22,11,11
153,Eddie Olczyk,Blackhawks,61,25,10,15
153,Eddie Olczyk,Blackhawks,33,4,2,2
154,Wayne Cashman,Bruins,1,0,0,0
154,Wayne Cashman,Bruins,12,4,0,4
154,Wayne Cashman,Bruins,51,31,8,23
154,Wayne Cashman,Bruins,70,35,9,26
154,Wayne Cashman,Bruins,77,79,21,58
154,Wayne Cashman,Bruins,74,52,23,29
154,Wayne Cashman,Bruins,76,68,29,39
154,Wayne Cashman,Bruins,78,89,30,59
154,Wayne Cashman,Bruins,42,33,11,22
154,Wayne Cashman,Bruins,80,71,28,43
154,Wayne Cashman,Bruins,65,52,15,37
154,Wayne Cashman,Bruins,76,62,24,38
154,Wayne Cashman,Bruins,75,67,27,40
154,Wayne Cashman,Bruins,44,32,11,21
154,Wayne Cashman,Bruins,77,60,25,35
154,Wayne Cashman,Bruins,64,43,12,31
154,Wayne Cashman,Bruins,65,15,4,11
155,Dany Heatley,Thrashers,82,67,26,41
155,Dany Heatley,Thrashers,77,89,41,48
155,Dany Heatley,Thrashers,31,25,13,12
155,Dany Heatley,Senators,82,103,50,53
155,Dany Heatley,Senators,82,105,50,55
155,Dany Heatley,Senators,71,82,41,41
155,Dany Heatley,Senators,82,72,39,33
155,Dany Heatley,Sharks,82,82,39,43
155,Dany Heatley,Sharks,80,64,26,38
155,Dany Heatley,Wild,82,53,24,29
155,Dany Heatley,Wild,36,21,11,10
155,Dany Heatley,Wild,76,28,12,16
155,Dany Heatley,Ducks,3,0,0,0
156,Richard Vaive,Canucks,47,21,13,8
156,Richard Vaive,Maple Leafs,22,16,9,7
156,Richard Vaive,Maple Leafs,75,62,33,29
156,Richard Vaive,Maple Leafs,77,89,54,35
156,Richard Vaive,Maple Leafs,78,79,51,28
156,Richard Vaive,Maple Leafs,76,93,52,41
156,Richard Vaive,Maple Leafs,72,68,35,33
156,Richard Vaive,Maple Leafs,61,64,33,31
156,Richard Vaive,Maple Leafs,73,66,32,34
156,Richard Vaive,Blackhawks,76,69,43,26
156,Richard Vaive,Blackhawks,30,25,12,13
156,Richard Vaive,Sabres,28,32,19,13
156,Richard Vaive,Sabres,70,48,29,19
156,Richard Vaive,Sabres,71,52,25,27
156,Richard Vaive,Sabres,20,4,1,3
157,Sidney Crosby,Penguins,81,102,39,63
157,Sidney Crosby,Penguins,79,120,36,84
157,Sidney Crosby,Penguins,53,72,24,48
157,Sidney Crosby,Penguins,77,103,33,70
157,Sidney Crosby,Penguins,81,109,51,58
157,Sidney Crosby,Penguins,41,66,32,34
157,Sidney Crosby,Penguins,22,37,8,29
157,Sidney Crosby,Penguins,36,56,15,41
157,Sidney Crosby,Penguins,80,104,36,68
157,Sidney Crosby,Penguins,12,19,7,12
158,Borje Salming,Maple Leafs,76,39,5,34
158,Borje Salming,Maple Leafs,60,37,12,25
158,Borje Salming,Maple Leafs,78,57,16,41
158,Borje Salming,Maple Leafs,76,78,12,66
158,Borje Salming,Maple Leafs,80,76,16,60
158,Borje Salming,Maple Leafs,78,73,17,56
158,Borje Salming,Maple Leafs,74,71,19,52
158,Borje Salming,Maple Leafs,72,66,5,61
158,Borje Salming,Maple Leafs,69,56,12,44
158,Borje Salming,Maple Leafs,69,45,7,38
158,Borje Salming,Maple Leafs,68,43,5,38
158,Borje Salming,Maple Leafs,73,39,6,33
158,Borje Salming,Maple Leafs,41,22,7,15
158,Borje Salming,Maple Leafs,56,20,4,16
158,Borje Salming,Maple Leafs,66,26,2,24
158,Borje Salming,Maple Leafs,63,20,3,17
158,Borje Salming,Red Wings,49,19,2,17
159,Claude Lemieux,Canadiens,8,2,1,1
159,Claude Lemieux,Canadiens,1,1,0,1
159,Claude Lemieux,Canadiens,10,3,1,2
159,Claude Lemieux,Canadiens,76,53,27,26
159,Claude Lemieux,Canadiens,78,61,31,30
159,Claude Lemieux,Canadiens,69,51,29,22
159,Claude Lemieux,Canadiens,39,18,8,10
159,Claude Lemieux,Devils,78,47,30,17
159,Claude Lemieux,Devils,74,68,41,27
159,Claude Lemieux,Devils,77,81,30,51
159,Claude Lemieux,Devils,79,44,18,26
159,Claude Lemieux,Devils,45,19,6,13
159,Claude Lemieux,Avalanche,79,71,39,32
159,Claude Lemieux,Avalanche,45,28,11,17
159,Claude Lemieux,Avalanche,78,53,26,27
159,Claude Lemieux,Avalanche,82,51,27,24
159,Claude Lemieux,Avalanche,13,9,3,6
159,Claude Lemieux,Devils,70,38,17,21
159,Claude Lemieux,Coyotes,46,26,10,16
159,Claude Lemieux,Coyotes,82,41,16,25
159,Claude Lemieux,Coyotes,36,14,6,8
159,Claude Lemieux,Stars,32,6,2,4
159,Claude Lemieux,Sharks,18,1,0,1
160,Alexei Yashin,Senators,83,79,30,49
160,Alexei Yashin,Senators,47,44,21,23
160,Alexei Yashin,Senators,46,39,15,24
160,Alexei Yashin,Senators,82,75,35,40
160,Alexei Yashin,Senators,82,72,33,39
160,Alexei Yashin,Senators,82,94,44,50
160,Alexei Yashin,Senators,82,88,40,48
160,Alexei Yashin,Islanders,78,75,32,43
160,Alexei Yashin,Islanders,81,65,26,39
160,Alexei Yashin,Islanders,47,34,15,19
160,Alexei Yashin,Islanders,82,66,28,38
160,Alexei Yashin,Islanders,58,50,18,32
161,Alex Tanguay,Avalanche,76,51,17,34
161,Alex Tanguay,Avalanche,82,77,27,50
161,Alex Tanguay,Avalanche,70,48,13,35
161,Alex Tanguay,Avalanche,82,67,26,41
161,Alex Tanguay,Avalanche,69,79,25,54
161,Alex Tanguay,Avalanche,71,78,29,49
161,Alex Tanguay,Flames,81,81,22,59
161,Alex Tanguay,Flames,78,58,18,40
161,Alex Tanguay,Canadiens,50,41,16,25
161,Alex Tanguay,Lightning,80,37,10,27
161,Alex Tanguay,Flames,79,69,22,47
161,Alex Tanguay,Flames,64,49,13,36
161,Alex Tanguay,Flames,40,27,11,16
161,Alex Tanguay,Avalanche,16,11,4,7
161,Alex Tanguay,Avalanche,15,8,5,3
162,Pavel Bure,Canucks,65,60,34,26
162,Pavel Bure,Canucks,83,110,60,50
162,Pavel Bure,Canucks,76,107,60,47
162,Pavel Bure,Canucks,44,43,20,23
162,Pavel Bure,Canucks,15,13,6,7
162,Pavel Bure,Canucks,63,55,23,32
162,Pavel Bure,Canucks,82,90,51,39
162,Pavel Bure,Panthers,11,16,13,3
162,Pavel Bure,Panthers,74,94,58,36
162,Pavel Bure,Panthers,82,92,59,33
162,Pavel Bure,Panthers,56,49,22,27
162,Pavel Bure,Rangers,12,20,12,8
162,Pavel Bure,Rangers,39,30,19,11
163,Rob Blake,Kings,4,0,0,0
163,Rob Blake,Kings,75,46,12,34
163,Rob Blake,Kings,57,20,7,13
163,Rob Blake,Kings,76,59,16,43
163,Rob Blake,Kings,84,68,20,48
163,Rob Blake,Kings,24,11,4,7
163,Rob Blake,Kings,6,3,1,2
163,Rob Blake,Kings,62,31,8,23
163,Rob Blake,Kings,81,50,23,27
163,Rob Blake,Kings,62,35,12,23
163,Rob Blake,Kings,77,57,18,39
163,Rob Blake,Kings,54,49,17,32
163,Rob Blake,Avalanche,13,10,2,8
163,Rob Blake,Avalanche,75,56,16,40
163,Rob Blake,Avalanche,79,45,17,28
163,Rob Blake,Avalanche,74,46,13,33
163,Rob Blake,Avalanche,81,51,14,37
163,Rob Blake,Kings,72,34,14,20
163,Rob Blake,Kings,71,31,9,22
163,Rob Blake,Sharks,73,45,10,35
163,Rob Blake,Sharks,70,30,7,23
164,Joseph Pronovost,Penguins,76,41,16,25
164,Joseph Pronovost,Penguins,72,41,20,21
164,Joseph Pronovost,Penguins,78,45,21,24
164,Joseph Pronovost,Penguins,68,53,30,23
164,Joseph Pronovost,Penguins,66,43,21,22
164,Joseph Pronovost,Penguins,77,72,40,32
164,Joseph Pronovost,Penguins,78,75,43,32
164,Joseph Pronovost,Penguins,80,104,52,52
164,Joseph Pronovost,Penguins,79,64,33,31
164,Joseph Pronovost,Penguins,79,65,40,25
164,Joseph Pronovost,Flames,75,67,28,39
164,Joseph Pronovost,Flames,80,43,24,19
164,Joseph Pronovost,Capitals,80,58,22,36
164,Joseph Pronovost,Capitals,10,3,1,2
165,Dave Christian,Jets (1979),15,18,8,10
165,Dave Christian,Jets (1979),80,71,28,43
165,Dave Christian,Jets (1979),80,76,25,51
165,Dave Christian,Jets (1979),55,44,18,26
165,Dave Christian,Capitals,80,81,29,52
165,Dave Christian,Capitals,80,69,26,43
165,Dave Christian,Capitals,80,83,41,42
165,Dave Christian,Capitals,76,50,23,27
165,Dave Christian,Capitals,80,58,37,21
165,Dave Christian,Capitals,80,65,34,31
165,Dave Christian,Capitals,28,11,3,8
165,Dave Christian,Bruins,50,29,12,17
165,Dave Christian,Bruins,78,53,32,21
165,Dave Christian,Blues,78,44,20,24
165,Dave Christian,Blackhawks,60,18,4,14
165,Dave Christian,Blackhawks,9,3,0,3
166,Peter Mahovlich,Red Wings,3,1,0,1
166,Peter Mahovlich,Red Wings,34,4,1,3
166,Peter Mahovlich,Red Wings,15,10,6,4
166,Peter Mahovlich,Red Wings,30,4,2,2
166,Peter Mahovlich,Canadiens,36,17,9,8
166,Peter Mahovlich,Canadiens,78,61,35,26
166,Peter Mahovlich,Canadiens,75,67,35,32
166,Peter Mahovlich,Canadiens,61,59,21,38
166,Peter Mahovlich,Canadiens,78,73,36,37
166,Peter Mahovlich,Canadiens,80,117,35,82
166,Peter Mahovlich,Canadiens,80,105,34,71
166,Peter Mahovlich,Canadiens,76,62,15,47
166,Peter Mahovlich,Canadiens,17,8,3,5
166,Peter Mahovlich,Penguins,57,61,25,36
166,Peter Mahovlich,Penguins,60,53,14,39
166,Peter Mahovlich,Red Wings,80,66,16,50
166,Peter Mahovlich,Red Wings,24,5,1,4
167,Sergei Zubov,Rangers,49,31,8,23
167,Sergei Zubov,Rangers,78,89,12,77
167,Sergei Zubov,Rangers,38,36,10,26
167,Sergei Zubov,Penguins,64,66,11,55
167,Sergei Zubov,Stars,78,43,13,30
167,Sergei Zubov,Stars,73,57,10,47
167,Sergei Zubov,Stars,81,51,10,41
167,Sergei Zubov,Stars,77,42,9,33
167,Sergei Zubov,Stars,79,51,10,41
167,Sergei Zubov,Stars,80,44,12,32
167,Sergei Zubov,Stars,82,55,11,44
167,Sergei Zubov,Stars,77,42,7,35
167,Sergei Zubov,Stars,78,71,13,58
167,Sergei Zubov,Stars,78,54,12,42
167,Sergei Zubov,Stars,46,35,4,31
167,Sergei Zubov,Stars,10,4,0,4
168,Todd Bertuzzi,Islanders,76,39,18,21
168,Todd Bertuzzi,Islanders,64,23,10,13
168,Todd Bertuzzi,Islanders,52,18,7,11
168,Todd Bertuzzi,Canucks,22,15,6,9
168,Todd Bertuzzi,Canucks,32,16,8,8
168,Todd Bertuzzi,Canucks,80,50,25,25
168,Todd Bertuzzi,Canucks,79,55,25,30
168,Todd Bertuzzi,Canucks,72,85,36,49
168,Todd Bertuzzi,Canucks,82,97,46,51
168,Todd Bertuzzi,Canucks,69,60,17,43
168,Todd Bertuzzi,Canucks,82,71,25,46
168,Todd Bertuzzi,Panthers,7,7,1,6
168,Todd Bertuzzi,Red Wings,8,4,2,2
168,Todd Bertuzzi,Ducks,68,40,14,26
168,Todd Bertuzzi,Flames,66,44,15,29
168,Todd Bertuzzi,Red Wings,82,44,18,26
168,Todd Bertuzzi,Red Wings,81,45,16,29
168,Todd Bertuzzi,Red Wings,71,38,14,24
168,Todd Bertuzzi,Red Wings,7,3,2,1
168,Todd Bertuzzi,Red Wings,59,16,9,7
169,Pavol Demitra,Senators,12,2,1,1
169,Pavol Demitra,Senators,16,7,4,3
169,Pavol Demitra,Senators,31,17,7,10
169,Pavol Demitra,Blues,8,3,3,0
169,Pavol Demitra,Blues,61,52,22,30
169,Pavol Demitra,Blues,82,89,37,52
169,Pavol Demitra,Blues,71,75,28,47
169,Pavol Demitra,Blues,44,45,20,25
169,Pavol Demitra,Blues,82,78,35,43
169,Pavol Demitra,Blues,78,93,36,57
169,Pavol Demitra,Blues,68,58,23,35
169,Pavol Demitra,Kings,58,62,25,37
169,Pavol Demitra,Wild,71,64,25,39
169,Pavol Demitra,Wild,68,54,15,39
169,Pavol Demitra,Canucks,69,53,20,33
169,Pavol Demitra,Canucks,28,16,3,13
170,Rick Kehoe,Maple Leafs,38,16,8,8
170,Rick Kehoe,Maple Leafs,77,75,33,42
170,Rick Kehoe,Maple Leafs,69,40,18,22
170,Rick Kehoe,Penguins,76,63,32,31
170,Rick Kehoe,Penguins,71,76,29,47
170,Rick Kehoe,Penguins,80,57,30,27
170,Rick Kehoe,Penguins,70,50,29,21
170,Rick Kehoe,Penguins,57,45,27,18
170,Rick Kehoe,Penguins,79,60,30,30
170,Rick Kehoe,Penguins,80,88,55,33
170,Rick Kehoe,Penguins,71,85,33,52
170,Rick Kehoe,Penguins,75,65,29,36
170,Rick Kehoe,Penguins,57,45,18,27
170,Rick Kehoe,Penguins,6,2,0,2
171,Vinny Prospal,Flyers,18,15,5,10
171,Vinny Prospal,Flyers,41,18,5,13
171,Vinny Prospal,Senators,15,7,1,6
171,Vinny Prospal,Senators,79,36,10,26
171,Vinny Prospal,Senators,79,55,22,33
171,Vinny Prospal,Senators,40,13,1,12
171,Vinny Prospal,Panthers,34,16,4,12
171,Vinny Prospal,Lightning,81,55,18,37
171,Vinny Prospal,Lightning,80,79,22,57
171,Vinny Prospal,Ducks,82,54,19,35
171,Vinny Prospal,Lightning,81,80,25,55
171,Vinny Prospal,Lightning,82,55,14,41
171,Vinny Prospal,Lightning,62,57,29,28
171,Vinny Prospal,Flyers,18,14,4,10
171,Vinny Prospal,Lightning,82,45,19,26
171,Vinny Prospal,Rangers,75,58,20,38
171,Vinny Prospal,Rangers,29,23,9,14
171,Vinny Prospal,Blue Jackets,82,55,16,39
171,Vinny Prospal,Blue Jackets,48,30,12,18
172,Brian Rolston,Devils,40,18,7,11
172,Brian Rolston,Devils,58,24,13,11
172,Brian Rolston,Devils,81,45,18,27
172,Brian Rolston,Devils,76,30,16,14
172,Brian Rolston,Devils,82,57,24,33
172,Brian Rolston,Devils,11,4,3,1
172,Brian Rolston,Avalanche,50,18,8,10
172,Brian Rolston,Bruins,16,9,5,4
172,Brian Rolston,Bruins,77,58,19,39
172,Brian Rolston,Bruins,82,62,31,31
172,Brian Rolston,Bruins,81,59,27,32
172,Brian Rolston,Bruins,82,48,19,29
172,Brian Rolston,Wild,82,79,34,45
172,Brian Rolston,Wild,78,64,31,33
172,Brian Rolston,Wild,81,59,31,28
172,Brian Rolston,Devils,64,32,15,17
172,Brian Rolston,Devils,80,37,20,17
172,Brian Rolston,Devils,65,34,14,20
172,Brian Rolston,Islanders,49,9,4,5
172,Brian Rolston,Bruins,21,15,3,12
173,Kevin Dineen,Whalers,57,41,25,16
173,Kevin Dineen,Whalers,57,68,33,35
173,Kevin Dineen,Whalers,78,79,40,39
173,Kevin Dineen,Whalers,74,50,25,25
173,Kevin Dineen,Whalers,79,89,45,44
173,Kevin Dineen,Whalers,67,66,25,41
173,Kevin Dineen,Whalers,61,47,17,30
173,Kevin Dineen,Whalers,16,6,4,2
173,Kevin Dineen,Flyers,64,56,26,30
173,Kevin Dineen,Flyers,83,63,35,28
173,Kevin Dineen,Flyers,71,42,19,23
173,Kevin Dineen,Flyers,40,13,8,5
173,Kevin Dineen,Flyers,26,2,0,2
173,Kevin Dineen,Whalers,20,9,2,7
173,Kevin Dineen,Whalers,78,48,19,29
173,Kevin Dineen,Hurricanes,54,23,7,16
173,Kevin Dineen,Hurricanes,67,18,8,10
173,Kevin Dineen,Senators,67,12,4,8
173,Kevin Dineen,Blue Jackets,66,15,8,7
173,Kevin Dineen,Blue Jackets,59,13,5,8
173,Kevin Dineen,Blue Jackets,4,0,0,0
174,Richard Macleish,Flyers,26,6,2,4
174,Richard Macleish,Flyers,17,3,1,2
174,Richard Macleish,Flyers,78,100,50,50
174,Richard Macleish,Flyers,78,77,32,45
174,Richard Macleish,Flyers,80,79,38,41
174,Richard Macleish,Flyers,51,45,22,23
174,Richard Macleish,Flyers,79,97,49,48
174,Richard Macleish,Flyers,76,70,31,39
174,Richard Macleish,Flyers,71,58,26,32
174,Richard Macleish,Flyers,78,66,31,35
174,Richard Macleish,Flyers,78,74,38,36
174,Richard Macleish,Whalers,34,22,6,16
174,Richard Macleish,Penguins,40,25,13,12
174,Richard Macleish,Penguins,6,5,0,5
174,Richard Macleish,Flyers,29,22,8,14
174,Richard Macleish,Red Wings,25,10,2,8
175,Murray Craven,Red Wings,31,11,4,7
175,Murray Craven,Red Wings,15,4,0,4
175,Murray Craven,Flyers,80,61,26,35
175,Murray Craven,Flyers,78,54,21,33
175,Murray Craven,Flyers,77,49,19,30
175,Murray Craven,Flyers,72,76,30,46
175,Murray Craven,Flyers,51,37,9,28
175,Murray Craven,Flyers,76,75,25,50
175,Murray Craven,Flyers,77,66,19,47
175,Murray Craven,Flyers,12,6,3,3
175,Murray Craven,Whalers,61,54,24,30
175,Murray Craven,Whalers,67,67,25,42
175,Murray Craven,Canucks,10,10,0,10
175,Murray Craven,Canucks,78,55,15,40
175,Murray Craven,Blackhawks,16,7,4,3
175,Murray Craven,Blackhawks,66,47,18,29
175,Murray Craven,Blackhawks,75,35,8,27
175,Murray Craven,Sharks,67,29,12,17
175,Murray Craven,Sharks,43,14,4,10
175,Murray Craven,Sharks,19,2,0,2
176,Mike Ridley,Rangers,80,65,22,43
176,Mike Ridley,Rangers,38,36,16,20
176,Mike Ridley,Capitals,40,34,15,19
176,Mike Ridley,Capitals,70,59,28,31
176,Mike Ridley,Capitals,80,89,41,48
176,Mike Ridley,Capitals,74,73,30,43
176,Mike Ridley,Capitals,79,71,23,48
176,Mike Ridley,Capitals,80,69,29,40
176,Mike Ridley,Capitals,84,82,26,56
176,Mike Ridley,Capitals,81,70,26,44
176,Mike Ridley,Maple Leafs,48,37,10,27
176,Mike Ridley,Canucks,37,21,6,15
176,Mike Ridley,Canucks,75,52,20,32
177,Scott Young,Whalers,7,0,0,0
177,Scott Young,Whalers,76,59,19,40
177,Scott Young,Whalers,80,64,24,40
177,Scott Young,Whalers,34,15,6,9
177,Scott Young,Penguins,43,27,11,16
177,Scott Young,Nordiques,82,60,30,30
177,Scott Young,Nordiques,76,51,26,25
177,Scott Young,Nordiques,48,39,18,21
177,Scott Young,Avalanche,81,60,21,39
177,Scott Young,Avalanche,72,37,18,19
177,Scott Young,Ducks,73,33,13,20
177,Scott Young,Blues,75,52,24,28
177,Scott Young,Blues,75,39,24,15
177,Scott Young,Blues,81,73,40,33
177,Scott Young,Blues,67,41,19,22
177,Scott Young,Stars,79,42,23,19
177,Scott Young,Stars,53,16,8,8
177,Scott Young,Blues,79,49,18,31
178,Steve Duchesne,Kings,75,38,13,25
178,Steve Duchesne,Kings,71,55,16,39
178,Steve Duchesne,Kings,79,75,25,50
178,Steve Duchesne,Kings,79,62,20,42
178,Steve Duchesne,Kings,78,62,21,41
178,Steve Duchesne,Flyers,78,56,18,38
178,Steve Duchesne,Nordiques,82,82,20,62
178,Steve Duchesne,Blues,36,31,12,19
178,Steve Duchesne,Blues,47,38,12,26
178,Steve Duchesne,Senators,62,36,12,24
178,Steve Duchesne,Senators,78,47,19,28
178,Steve Duchesne,Blues,80,56,14,42
178,Steve Duchesne,Kings,60,23,4,19
178,Steve Duchesne,Flyers,11,7,2,5
178,Steve Duchesne,Red Wings,79,41,10,31
178,Steve Duchesne,Red Wings,54,25,6,19
178,Steve Duchesne,Red Wings,64,18,3,15
179,Craig Janney,Bruins,15,16,7,9
179,Craig Janney,Bruins,62,62,16,46
179,Craig Janney,Bruins,55,62,24,38
179,Craig Janney,Bruins,77,92,26,66
179,Craig Janney,Bruins,53,51,12,39
179,Craig Janney,Blues,25,36,6,30
179,Craig Janney,Blues,84,106,24,82
179,Craig Janney,Blues,69,84,16,68
179,Craig Janney,Blues,8,7,2,5
179,Craig Janney,Sharks,27,20,5,15
179,Craig Janney,Sharks,71,62,13,49
179,Craig Janney,Jets (1979),13,20,7,13
179,Craig Janney,Coyotes,77,53,15,38
179,Craig Janney,Coyotes,68,53,10,43
179,Craig Janney,Lightning,38,22,4,18
179,Craig Janney,Islanders,18,5,1,4
180,Bobby Holik,Whalers,78,43,21,22
180,Bobby Holik,Whalers,76,45,21,24
180,Bobby Holik,Devils,61,39,20,19
180,Bobby Holik,Devils,70,33,13,20
180,Bobby Holik,Devils,48,20,10,10
180,Bobby Holik,Devils,63,30,13,17
180,Bobby Holik,Devils,82,62,23,39
180,Bobby Holik,Devils,82,65,29,36
180,Bobby Holik,Devils,78,64,27,37
180,Bobby Holik,Devils,79,46,23,23
180,Bobby Holik,Devils,80,50,15,35
180,Bobby Holik,Devils,81,54,25,29
180,Bobby Holik,Rangers,64,35,16,19
180,Bobby Holik,Rangers,82,56,25,31
180,Bobby Holik,Thrashers,64,33,15,18
180,Bobby Holik,Thrashers,82,29,11,18
180,Bobby Holik,Thrashers,82,34,15,19
180,Bobby Holik,Devils,62,9,4,5
181,Steve Sullivan,Devils,16,9,5,4
181,Steve Sullivan,Devils,33,22,8,14
181,Steve Sullivan,Maple Leafs,21,16,5,11
181,Steve Sullivan,Maple Leafs,63,28,10,18
181,Steve Sullivan,Maple Leafs,63,40,20,20
181,Steve Sullivan,Maple Leafs,7,1,0,1
181,Steve Sullivan,Blackhawks,73,64,22,42
181,Steve Sullivan,Blackhawks,81,75,34,41
181,Steve Sullivan,Blackhawks,78,60,21,39
181,Steve Sullivan,Blackhawks,82,61,26,35
181,Steve Sullivan,Blackhawks,56,43,15,28
181,Steve Sullivan,Predators,24,30,9,21
181,Steve Sullivan,Predators,69,68,31,37
181,Steve Sullivan,Predators,57,60,22,38
181,Steve Sullivan,Predators,41,32,11,21
181,Steve Sullivan,Predators,82,51,17,34
181,Steve Sullivan,Predators,44,22,10,12
181,Steve Sullivan,Penguins,79,48,17,31
181,Steve Sullivan,Coyotes,33,12,5,7
181,Steve Sullivan,Devils,9,5,2,3
182,Russ Courtnall,Maple Leafs,14,12,3,9
182,Russ Courtnall,Maple Leafs,69,22,12,10
182,Russ Courtnall,Maple Leafs,73,60,22,38
182,Russ Courtnall,Maple Leafs,79,73,29,44
182,Russ Courtnall,Maple Leafs,65,49,23,26
182,Russ Courtnall,Maple Leafs,9,2,1,1
182,Russ Courtnall,Canadiens,64,39,22,17
182,Russ Courtnall,Canadiens,80,59,27,32
182,Russ Courtnall,Canadiens,79,76,26,50
182,Russ Courtnall,Canadiens,27,21,7,14
182,Russ Courtnall,North Stars,84,79,36,43
182,Russ Courtnall,Stars,84,80,23,57
182,Russ Courtnall,Stars,32,17,7,10
182,Russ Courtnall,Canucks,13,18,4,14
182,Russ Courtnall,Canucks,81,65,26,39
182,Russ Courtnall,Canucks,47,28,9,19
182,Russ Courtnall,Rangers,14,7,2,5
182,Russ Courtnall,Kings,58,18,12,6
182,Russ Courtnall,Kings,57,19,6,13
183,Greg Adams,Devils,36,21,12,9
183,Greg Adams,Devils,78,77,35,42
183,Greg Adams,Devils,72,47,20,27
183,Greg Adams,Canucks,80,76,36,40
183,Greg Adams,Canucks,61,33,19,14
183,Greg Adams,Canucks,65,50,30,20
183,Greg Adams,Canucks,55,45,21,24
183,Greg Adams,Canucks,76,57,30,27
183,Greg Adams,Canucks,53,56,25,31
183,Greg Adams,Canucks,68,37,13,24
183,Greg Adams,Canucks,31,15,5,10
183,Greg Adams,Stars,12,6,3,3
183,Greg Adams,Stars,66,43,22,21
183,Greg Adams,Stars,50,36,21,15
183,Greg Adams,Stars,49,32,14,18
183,Greg Adams,Coyotes,75,43,19,24
183,Greg Adams,Coyotes,69,46,19,27
183,Greg Adams,Panthers,60,23,11,12
184,Mathieu Schneider,Canadiens,4,0,0,0
184,Mathieu Schneider,Canadiens,44,21,7,14
184,Mathieu Schneider,Canadiens,69,30,10,20
184,Mathieu Schneider,Canadiens,78,32,8,24
184,Mathieu Schneider,Canadiens,60,44,13,31
184,Mathieu Schneider,Canadiens,75,52,20,32
184,Mathieu Schneider,Canadiens,30,20,5,15
184,Mathieu Schneider,Islanders,13,9,3,6
184,Mathieu Schneider,Islanders,65,47,11,36
184,Mathieu Schneider,Maple Leafs,13,7,2,5
184,Mathieu Schneider,Maple Leafs,26,12,5,7
184,Mathieu Schneider,Maple Leafs,76,37,11,26
184,Mathieu Schneider,Rangers,75,34,10,24
184,Mathieu Schneider,Rangers,80,30,10,20
184,Mathieu Schneider,Kings,73,51,16,35
184,Mathieu Schneider,Kings,55,30,7,23
184,Mathieu Schneider,Kings,65,43,14,29
184,Mathieu Schneider,Red Wings,13,7,2,5
184,Mathieu Schneider,Red Wings,78,46,14,32
184,Mathieu Schneider,Red Wings,72,59,21,38
184,Mathieu Schneider,Red Wings,68,52,11,41
184,Mathieu Schneider,Ducks,65,39,12,27
184,Mathieu Schneider,Thrashers,44,15,4,11
184,Mathieu Schneider,Canadiens,23,17,5,12
184,Mathieu Schneider,Canucks,17,5,2,3
184,Mathieu Schneider,Coyotes,8,4,0,4
185,Mark Howe,Whalers,74,80,24,56
185,Mark Howe,Whalers,63,65,19,46
185,Mark Howe,Whalers,76,53,8,45
185,Mark Howe,Flyers,76,67,20,47
185,Mark Howe,Flyers,71,53,19,34
185,Mark Howe,Flyers,73,57,18,39
185,Mark Howe,Flyers,77,82,24,58
185,Mark Howe,Flyers,69,58,15,43
185,Mark Howe,Flyers,75,62,19,43
185,Mark Howe,Flyers,52,38,9,29
185,Mark Howe,Flyers,40,28,7,21
185,Mark Howe,Flyers,19,10,0,10
185,Mark Howe,Flyers,42,25,7,18
185,Mark Howe,Red Wings,60,34,3,31
185,Mark Howe,Red Wings,44,24,4,20
185,Mark Howe,Red Wings,18,6,1,5
186,Olli Jokinen,Kings,8,0,0,0
186,Olli Jokinen,Kings,66,21,9,12
186,Olli Jokinen,Islanders,82,21,11,10
186,Olli Jokinen,Panthers,78,16,6,10
186,Olli Jokinen,Panthers,80,29,9,20
186,Olli Jokinen,Panthers,81,65,36,29
186,Olli Jokinen,Panthers,82,58,26,32
186,Olli Jokinen,Panthers,82,89,38,51
186,Olli Jokinen,Panthers,82,91,39,52
186,Olli Jokinen,Panthers,82,71,34,37
186,Olli Jokinen,Coyotes,57,42,21,21
186,Olli Jokinen,Flames,19,15,8,7
186,Olli Jokinen,Flames,56,35,11,24
186,Olli Jokinen,Rangers,26,15,4,11
186,Olli Jokinen,Flames,79,54,17,37
186,Olli Jokinen,Flames,82,61,23,38
186,Olli Jokinen,Jets,45,14,7,7
186,Olli Jokinen,Jets,82,43,18,25
186,Olli Jokinen,Predators,13,0,0,0
187,Scott Niedermayer,Devils,4,1,0,1
187,Scott Niedermayer,Devils,80,40,11,29
187,Scott Niedermayer,Devils,81,46,10,36
187,Scott Niedermayer,Devils,48,19,4,15
187,Scott Niedermayer,Devils,79,33,8,25
187,Scott Niedermayer,Devils,81,35,5,30
187,Scott Niedermayer,Devils,81,57,14,43
187,Scott Niedermayer,Devils,72,46,11,35
187,Scott Niedermayer,Devils,71,38,7,31
187,Scott Niedermayer,Devils,57,35,6,29
187,Scott Niedermayer,Devils,76,33,11,22
187,Scott Niedermayer,Devils,81,39,11,28
187,Scott Niedermayer,Devils,81,54,14,40
187,Scott Niedermayer,Ducks,82,63,13,50
187,Scott Niedermayer,Ducks,79,69,15,54
187,Scott Niedermayer,Ducks,48,25,8,17
187,Scott Niedermayer,Ducks,82,59,14,45
187,Scott Niedermayer,Ducks,80,48,10,38
188,Henrik Zetterberg,Red Wings,79,44,22,22
188,Henrik Zetterberg,Red Wings,61,43,15,28
188,Henrik Zetterberg,Red Wings,77,85,39,46
188,Henrik Zetterberg,Red Wings,63,68,33,35
188,Henrik Zetterberg,Red Wings,75,92,43,49
188,Henrik Zetterberg,Red Wings,77,73,31,42
188,Henrik Zetterberg,Red Wings,74,70,23,47
188,Henrik Zetterberg,Red Wings,80,80,24,56
188,Henrik Zetterberg,Red Wings,82,69,22,47
188,Henrik Zetterberg,Red Wings,46,48,11,37
188,Henrik Zetterberg,Red Wings,45,48,16,32
188,Henrik Zetterberg,Red Wings,14,16,4,12
189,Miroslav Satan,Oilers,62,35,18,17
189,Miroslav Satan,Oilers,64,28,17,11
189,Miroslav Satan,Sabres,12,10,8,2
189,Miroslav Satan,Sabres,79,46,22,24
189,Miroslav Satan,Sabres,81,66,40,26
189,Miroslav Satan,Sabres,81,67,33,34
189,Miroslav Satan,Sabres,82,62,29,33
189,Miroslav Satan,Sabres,82,73,37,36
189,Miroslav Satan,Sabres,79,75,26,49
189,Miroslav Satan,Sabres,82,57,29,28
189,Miroslav Satan,Islanders,82,66,35,31
189,Miroslav Satan,Islanders,81,59,27,32
189,Miroslav Satan,Islanders,80,41,16,25
189,Miroslav Satan,Penguins,65,36,17,19
189,Miroslav Satan,Bruins,38,14,9,5
190,Andrew Brunette,Capitals,11,6,3,3
190,Andrew Brunette,Capitals,23,11,4,7
190,Andrew Brunette,Capitals,28,23,11,12
190,Andrew Brunette,Predators,77,31,11,20
190,Andrew Brunette,Thrashers,81,50,23,27
190,Andrew Brunette,Thrashers,77,59,15,44
190,Andrew Brunette,Wild,81,69,21,48
190,Andrew Brunette,Wild,82,46,18,28
190,Andrew Brunette,Wild,82,49,15,34
190,Andrew Brunette,Avalanche,82,63,24,39
190,Andrew Brunette,Avalanche,82,83,27,56
190,Andrew Brunette,Avalanche,82,59,19,40
190,Andrew Brunette,Wild,80,50,22,28
190,Andrew Brunette,Wild,82,61,25,36
190,Andrew Brunette,Wild,82,46,18,28
190,Andrew Brunette,Blackhawks,78,27,12,15
191,Andrew Cassels,Canadiens,6,2,2,0
191,Andrew Cassels,Canadiens,54,25,6,19
191,Andrew Cassels,Whalers,67,41,11,30
191,Andrew Cassels,Whalers,84,85,21,64
191,Andrew Cassels,Whalers,79,58,16,42
191,Andrew Cassels,Whalers,46,37,7,30
191,Andrew Cassels,Whalers,81,63,20,43
191,Andrew Cassels,Whalers,81,66,22,44
191,Andrew Cassels,Flames,81,44,17,27
191,Andrew Cassels,Flames,70,37,12,25
191,Andrew Cassels,Canucks,79,62,17,45
191,Andrew Cassels,Canucks,66,56,12,44
191,Andrew Cassels,Canucks,53,50,11,39
191,Andrew Cassels,Blue Jackets,79,68,20,48
191,Andrew Cassels,Blue Jackets,58,26,6,20
191,Andrew Cassels,Capitals,31,12,4,8
192,Bobby Carpenter,Capitals,80,67,32,35
192,Bobby Carpenter,Capitals,80,69,32,37
192,Bobby Carpenter,Capitals,80,68,28,40
192,Bobby Carpenter,Capitals,80,95,53,42
192,Bobby Carpenter,Capitals,80,56,27,29
192,Bobby Carpenter,Capitals,22,12,5,7
192,Bobby Carpenter,Rangers,28,10,2,8
192,Bobby Carpenter,Kings,10,5,2,3
192,Bobby Carpenter,Kings,71,52,19,33
192,Bobby Carpenter,Kings,39,26,11,15
192,Bobby Carpenter,Bruins,18,14,5,9
192,Bobby Carpenter,Bruins,80,56,25,31
192,Bobby Carpenter,Bruins,29,16,8,8
192,Bobby Carpenter,Bruins,60,48,25,23
192,Bobby Carpenter,Capitals,68,28,11,17
192,Bobby Carpenter,Devils,76,33,10,23
192,Bobby Carpenter,Devils,41,16,5,11
192,Bobby Carpenter,Devils,52,10,5,5
192,Bobby Carpenter,Devils,62,19,4,15
192,Bobby Carpenter,Devils,66,18,9,9
192,Bobby Carpenter,Devils,56,10,2,8
193,Murray Oliver,Red Wings,1,1,0,1
193,Murray Oliver,Red Wings,54,39,20,19
193,Murray Oliver,Red Wings,49,23,11,12
193,Murray Oliver,Bruins,21,16,6,10
193,Murray Oliver,Bruins,70,46,17,29
193,Murray Oliver,Bruins,65,62,22,40
193,Murray Oliver,Bruins,70,68,24,44
193,Murray Oliver,Bruins,65,43,20,23
193,Murray Oliver,Bruins,70,60,18,42
193,Murray Oliver,Bruins,65,35,9,26
193,Murray Oliver,Maple Leafs,74,37,16,21
193,Murray Oliver,Maple Leafs,76,50,14,36
193,Murray Oliver,Maple Leafs,76,47,14,33
193,Murray Oliver,North Stars,61,32,9,23
193,Murray Oliver,North Stars,77,56,27,29
193,Murray Oliver,North Stars,75,42,11,31
193,Murray Oliver,North Stars,78,37,17,20
193,Murray Oliver,North Stars,80,34,19,15
194,Michael Foligno,Red Wings,80,71,36,35
194,Michael Foligno,Red Wings,80,63,28,35
194,Michael Foligno,Red Wings,26,26,13,13
194,Michael Foligno,Sabres,56,51,20,31
194,Michael Foligno,Sabres,66,47,22,25
194,Michael Foligno,Sabres,70,63,32,31
194,Michael Foligno,Sabres,77,56,27,29
194,Michael Foligno,Sabres,79,80,41,39
194,Michael Foligno,Sabres,75,59,30,29
194,Michael Foligno,Sabres,74,57,29,28
194,Michael Foligno,Sabres,75,49,27,22
194,Michael Foligno,Sabres,61,40,15,25
194,Michael Foligno,Sabres,31,9,4,5
194,Michael Foligno,Maple Leafs,37,15,8,7
194,Michael Foligno,Maple Leafs,33,14,6,8
194,Michael Foligno,Maple Leafs,55,18,13,5
194,Michael Foligno,Maple Leafs,4,0,0,0
194,Michael Foligno,Panthers,39,9,4,5
195,Cory Stillman,Flames,10,2,0,2
195,Cory Stillman,Flames,74,35,16,19
195,Cory Stillman,Flames,58,26,6,20
195,Cory Stillman,Flames,72,49,27,22
195,Cory Stillman,Flames,76,57,27,30
195,Cory Stillman,Flames,37,21,12,9
195,Cory Stillman,Flames,66,45,21,24
195,Cory Stillman,Blues,12,7,3,4
195,Cory Stillman,Blues,80,45,23,22
195,Cory Stillman,Blues,79,67,24,43
195,Cory Stillman,Lightning,81,80,25,55
195,Cory Stillman,Hurricanes,72,76,21,55
195,Cory Stillman,Hurricanes,43,27,5,22
195,Cory Stillman,Hurricanes,55,46,21,25
195,Cory Stillman,Senators,24,19,3,16
195,Cory Stillman,Panthers,63,49,17,32
195,Cory Stillman,Panthers,58,37,15,22
195,Cory Stillman,Panthers,44,23,7,16
195,Cory Stillman,Hurricanes,21,16,5,11
196,Kevin Stevens,Penguins,16,7,5,2
196,Kevin Stevens,Penguins,24,15,12,3
196,Kevin Stevens,Penguins,76,70,29,41
196,Kevin Stevens,Penguins,80,86,40,46
196,Kevin Stevens,Penguins,80,123,54,69
196,Kevin Stevens,Penguins,72,111,55,56
196,Kevin Stevens,Penguins,83,88,41,47
196,Kevin Stevens,Penguins,27,27,15,12
196,Kevin Stevens,Bruins,41,23,10,13
196,Kevin Stevens,Kings,20,13,3,10
196,Kevin Stevens,Kings,69,34,14,20
196,Kevin Stevens,Rangers,80,41,14,27
196,Kevin Stevens,Rangers,81,43,23,20
196,Kevin Stevens,Rangers,38,8,3,5
196,Kevin Stevens,Flyers,23,9,2,7
196,Kevin Stevens,Penguins,32,23,8,15
196,Kevin Stevens,Penguins,32,5,1,4
197,Bob Nevin,Maple Leafs,4,0,0,0
197,Bob Nevin,Maple Leafs,2,0,0,0
197,Bob Nevin,Maple Leafs,68,58,21,37
197,Bob Nevin,Maple Leafs,69,45,15,30
197,Bob Nevin,Maple Leafs,58,33,12,21
197,Bob Nevin,Maple Leafs,49,19,7,12
197,Bob Nevin,Rangers,14,9,5,4
197,Bob Nevin,Rangers,64,30,16,14
197,Bob Nevin,Rangers,69,62,29,33
197,Bob Nevin,Rangers,67,44,20,24
197,Bob Nevin,Rangers,74,58,28,30
197,Bob Nevin,Rangers,71,56,31,25
197,Bob Nevin,Rangers,68,37,18,19
197,Bob Nevin,Rangers,78,46,21,25
197,Bob Nevin,North Stars,72,34,15,19
197,Bob Nevin,North Stars,66,18,5,13
197,Bob Nevin,Kings,78,50,20,30
197,Bob Nevin,Kings,80,72,31,41
197,Bob Nevin,Kings,77,55,13,42
198,David Babych,Jets (1979),69,44,6,38
198,David Babych,Jets (1979),79,68,19,49
198,David Babych,Jets (1979),79,74,13,61
198,David Babych,Jets (1979),66,57,18,39
198,David Babych,Jets (1979),78,62,13,49
198,David Babych,Jets (1979),19,16,4,12
198,David Babych,Whalers,62,53,10,43
198,David Babych,Whalers,66,41,8,33
198,David Babych,Whalers,71,50,14,36
198,David Babych,Whalers,70,47,6,41
198,David Babych,Whalers,72,43,6,37
198,David Babych,Whalers,8,6,0,6
198,David Babych,Canucks,75,29,5,24
198,David Babych,Canucks,43,19,3,16
198,David Babych,Canucks,73,32,4,28
198,David Babych,Canucks,40,14,3,11
198,David Babych,Canucks,53,24,3,21
198,David Babych,Canucks,78,27,5,22
198,David Babych,Canucks,47,9,0,9
198,David Babych,Flyers,6,0,0,0
198,David Babych,Flyers,33,6,2,4
198,David Babych,Kings,8,2,0,2
199,Petr Sykora,Devils,63,42,18,24
199,Petr Sykora,Devils,19,3,1,2
199,Petr Sykora,Devils,58,36,16,20
199,Petr Sykora,Devils,80,72,29,43
199,Petr Sykora,Devils,79,68,25,43
199,Petr Sykora,Devils,73,81,35,46
199,Petr Sykora,Devils,73,48,21,27
199,Petr Sykora,Ducks,82,59,34,25
199,Petr Sykora,Ducks,81,52,23,29
199,Petr Sykora,Ducks,34,20,7,13
199,Petr Sykora,Rangers,40,31,16,15
199,Petr Sykora,Oilers,82,53,22,31
199,Petr Sykora,Penguins,81,63,28,35
199,Petr Sykora,Penguins,76,46,25,21
199,Petr Sykora,Wild,14,3,2,1
199,Petr Sykora,Devils,82,44,21,23
200,Dave Gagner,Rangers,38,12,6,6
200,Dave Gagner,Rangers,32,10,4,6
200,Dave Gagner,Rangers,10,5,1,4
200,Dave Gagner,North Stars,51,19,8,11
200,Dave Gagner,North Stars,75,78,35,43
200,Dave Gagner,North Stars,79,78,40,38
200,Dave Gagner,North Stars,73,82,40,42
200,Dave Gagner,North Stars,78,71,31,40
200,Dave Gagner,North Stars,84,76,33,43
200,Dave Gagner,Stars,76,61,32,29
200,Dave Gagner,Stars,48,42,14,28
200,Dave Gagner,Stars,45,27,14,13
200,Dave Gagner,Maple Leafs,28,22,7,15
200,Dave Gagner,Flames,82,60,27,33
200,Dave Gagner,Panthers,78,48,20,28
200,Dave Gagner,Panthers,36,14,4,10
200,Dave Gagner,Canucks,33,14,2,12
201,Alexei Zhamnov,Jets (1979),68,72,25,47
201,Alexei Zhamnov,Jets (1979),61,71,26,45
201,Alexei Zhamnov,Jets (1979),48,65,30,35
201,Alexei Zhamnov,Jets (1979),58,59,22,37
201,Alexei Zhamnov,Blackhawks,74,62,20,42
201,Alexei Zhamnov,Blackhawks,70,49,21,28
201,Alexei Zhamnov,Blackhawks,76,61,20,41
201,Alexei Zhamnov,Blackhawks,71,60,23,37
201,Alexei Zhamnov,Blackhawks,63,49,13,36
201,Alexei Zhamnov,Blackhawks,77,67,22,45
201,Alexei Zhamnov,Blackhawks,74,58,15,43
201,Alexei Zhamnov,Blackhawks,23,18,6,12
201,Alexei Zhamnov,Flyers,20,18,5,13
201,Alexei Zhamnov,Bruins,24,10,1,9
202,Petr Nedved,Canucks,61,16,10,6
202,Petr Nedved,Canucks,77,37,15,22
202,Petr Nedved,Canucks,84,71,38,33
202,Petr Nedved,Blues,19,20,6,14
202,Petr Nedved,Rangers,46,23,11,12
202,Petr Nedved,Penguins,80,99,45,54
202,Petr Nedved,Penguins,74,71,33,38
202,Petr Nedved,Rangers,56,47,20,27
202,Petr Nedved,Rangers,76,68,24,44
202,Petr Nedved,Rangers,79,78,32,46
202,Petr Nedved,Rangers,78,46,21,25
202,Petr Nedved,Rangers,78,58,27,31
202,Petr Nedved,Rangers,65,31,14,17
202,Petr Nedved,Oilers,16,15,5,10
202,Petr Nedved,Coyotes,25,11,2,9
202,Petr Nedved,Flyers,28,14,5,9
202,Petr Nedved,Flyers,21,7,1,6
202,Petr Nedved,Oilers,19,5,1,4
203,Martin Straka,Penguins,42,16,3,13
203,Martin Straka,Penguins,84,64,30,34
203,Martin Straka,Penguins,31,16,4,12
203,Martin Straka,Senators,6,2,1,1
203,Martin Straka,Senators,43,25,9,16
203,Martin Straka,Islanders,22,12,2,10
203,Martin Straka,Panthers,12,6,2,4
203,Martin Straka,Panthers,55,29,7,22
203,Martin Straka,Penguins,75,42,19,23
203,Martin Straka,Penguins,80,83,35,48
203,Martin Straka,Penguins,71,59,20,39
203,Martin Straka,Penguins,82,95,27,68
203,Martin Straka,Penguins,13,9,5,4
203,Martin Straka,Penguins,60,46,18,28
203,Martin Straka,Penguins,22,12,4,8
203,Martin Straka,Kings,32,14,6,8
203,Martin Straka,Rangers,82,76,22,54
203,Martin Straka,Rangers,77,70,29,41
203,Martin Straka,Rangers,65,41,14,27
204,Ziggy Palffy,Islanders,5,0,0,0
204,Ziggy Palffy,Islanders,33,17,10,7
204,Ziggy Palffy,Islanders,81,87,43,44
204,Ziggy Palffy,Islanders,80,90,48,42
204,Ziggy Palffy,Islanders,82,87,45,42
204,Ziggy Palffy,Islanders,50,50,22,28
204,Ziggy Palffy,Kings,64,66,27,39
204,Ziggy Palffy,Kings,73,89,38,51
204,Ziggy Palffy,Kings,63,59,32,27
204,Ziggy Palffy,Kings,76,85,37,48
204,Ziggy Palffy,Kings,35,41,16,25
204,Ziggy Palffy,Penguins,42,42,11,31
205,George Armstrong,Maple Leafs,2,0,0,0
205,George Armstrong,Maple Leafs,20,6,3,3
205,George Armstrong,Maple Leafs,52,25,14,11
205,George Armstrong,Maple Leafs,63,32,17,15
205,George Armstrong,Maple Leafs,66,28,10,18
205,George Armstrong,Maple Leafs,67,48,16,32
205,George Armstrong,Maple Leafs,54,44,18,26
205,George Armstrong,Maple Leafs,59,42,17,25
205,George Armstrong,Maple Leafs,59,36,20,16
205,George Armstrong,Maple Leafs,70,51,23,28
205,George Armstrong,Maple Leafs,47,33,14,19
205,George Armstrong,Maple Leafs,70,53,21,32
205,George Armstrong,Maple Leafs,70,43,19,24
205,George Armstrong,Maple Leafs,66,37,20,17
205,George Armstrong,Maple Leafs,59,37,15,22
205,George Armstrong,Maple Leafs,70,51,16,35
205,George Armstrong,Maple Leafs,70,33,9,24
205,George Armstrong,Maple Leafs,62,34,13,21
205,George Armstrong,Maple Leafs,53,27,11,16
205,George Armstrong,Maple Leafs,49,28,13,15
205,George Armstrong,Maple Leafs,59,25,7,18
206,Scott Gomez,Devils,82,70,19,51
206,Scott Gomez,Devils,76,63,14,49
206,Scott Gomez,Devils,76,48,10,38
206,Scott Gomez,Devils,80,55,13,42
206,Scott Gomez,Devils,80,70,14,56
206,Scott Gomez,Devils,82,84,33,51
206,Scott Gomez,Devils,72,60,13,47
206,Scott Gomez,Rangers,81,70,16,54
206,Scott Gomez,Rangers,77,58,16,42
206,Scott Gomez,Canadiens,78,59,12,47
206,Scott Gomez,Canadiens,80,38,7,31
206,Scott Gomez,Canadiens,38,11,2,9
206,Scott Gomez,Sharks,39,15,2,13
206,Scott Gomez,Panthers,46,12,2,10
207,Vic Hadfield,Rangers,44,4,3,1
207,Vic Hadfield,Rangers,36,11,5,6
207,Vic Hadfield,Rangers,69,25,14,11
207,Vic Hadfield,Rangers,70,38,18,20
207,Vic Hadfield,Rangers,67,35,16,19
207,Vic Hadfield,Rangers,69,33,13,20
207,Vic Hadfield,Rangers,59,39,20,19
207,Vic Hadfield,Rangers,73,66,26,40
207,Vic Hadfield,Rangers,71,54,20,34
207,Vic Hadfield,Rangers,63,44,22,22
207,Vic Hadfield,Rangers,78,106,50,56
207,Vic Hadfield,Rangers,63,62,28,34
207,Vic Hadfield,Rangers,77,55,27,28
207,Vic Hadfield,Penguins,78,73,31,42
207,Vic Hadfield,Penguins,76,65,30,35
207,Vic Hadfield,Penguins,9,2,0,2
208,Charles Simmer,Seals,35,21,8,13
208,Charles Simmer,Seals,21,2,1,1
208,Charles Simmer,Barons,24,2,2,0
208,Charles Simmer,Kings,3,0,0,0
208,Charles Simmer,Kings,38,48,21,27
208,Charles Simmer,Kings,64,101,56,45
208,Charles Simmer,Kings,65,105,56,49
208,Charles Simmer,Kings,50,39,15,24
208,Charles Simmer,Kings,80,80,29,51
208,Charles Simmer,Kings,79,92,44,48
208,Charles Simmer,Kings,5,1,1,0
208,Charles Simmer,Bruins,63,63,33,30
208,Charles Simmer,Bruins,55,60,36,24
208,Charles Simmer,Bruins,80,69,29,40
208,Charles Simmer,Penguins,50,28,11,17
209,Doug Mohns,Bruins,70,27,13,14
209,Doug Mohns,Bruins,70,32,14,18
209,Doug Mohns,Bruins,64,18,10,8
209,Doug Mohns,Bruins,68,40,6,34
209,Doug Mohns,Bruins,54,21,5,16
209,Doug Mohns,Bruins,47,30,6,24
209,Doug Mohns,Bruins,65,45,20,25
209,Doug Mohns,Bruins,65,33,12,21
209,Doug Mohns,Bruins,69,45,16,29
209,Doug Mohns,Bruins,68,30,7,23
209,Doug Mohns,Bruins,70,26,9,17
209,Doug Mohns,Blackhawks,49,33,13,20
209,Doug Mohns,Blackhawks,70,49,22,27
209,Doug Mohns,Blackhawks,61,60,25,35
209,Doug Mohns,Blackhawks,65,53,24,29
209,Doug Mohns,Blackhawks,65,41,22,19
209,Doug Mohns,Blackhawks,66,33,6,27
209,Doug Mohns,Blackhawks,39,10,4,6
209,Doug Mohns,North Stars,17,7,2,5
209,Doug Mohns,North Stars,78,36,6,30
209,Doug Mohns,North Stars,67,17,4,13
209,Doug Mohns,Flames,28,3,0,3
209,Doug Mohns,Capitals,75,21,2,19
210,Marc Savard,Rangers,28,6,1,5
210,Marc Savard,Rangers,70,45,9,36
210,Marc Savard,Flames,78,53,22,31
210,Marc Savard,Flames,77,65,23,42
210,Marc Savard,Flames,56,33,14,19
210,Marc Savard,Flames,10,3,1,2
210,Marc Savard,Thrashers,57,47,16,31
210,Marc Savard,Thrashers,45,52,19,33
210,Marc Savard,Thrashers,82,97,28,69
210,Marc Savard,Bruins,82,96,22,74
210,Marc Savard,Bruins,74,78,15,63
210,Marc Savard,Bruins,82,88,25,63
210,Marc Savard,Bruins,41,33,10,23
210,Marc Savard,Bruins,25,10,2,8
211,Marian Gaborik,Wild,71,36,18,18
211,Marian Gaborik,Wild,78,67,30,37
211,Marian Gaborik,Wild,81,65,30,35
211,Marian Gaborik,Wild,65,40,18,22
211,Marian Gaborik,Wild,65,66,38,28
211,Marian Gaborik,Wild,48,57,30,27
211,Marian Gaborik,Wild,77,83,42,41
211,Marian Gaborik,Wild,17,23,13,10
211,Marian Gaborik,Rangers,76,86,42,44
211,Marian Gaborik,Rangers,62,48,22,26
211,Marian Gaborik,Rangers,82,76,41,35
211,Marian Gaborik,Rangers,35,19,9,10
211,Marian Gaborik,Blue Jackets,12,8,3,5
211,Marian Gaborik,Blue Jackets,22,14,6,8
211,Marian Gaborik,Kings,19,16,5,11
211,Marian Gaborik,Kings,6,1,0,1
212,Robert Lang,Kings,11,5,0,5
212,Robert Lang,Kings,32,19,9,10
212,Robert Lang,Kings,36,12,4,8
212,Robert Lang,Kings,68,22,6,16
212,Robert Lang,Bruins,3,0,0,0
212,Robert Lang,Penguins,51,22,9,13
212,Robert Lang,Penguins,72,44,21,23
212,Robert Lang,Penguins,78,65,23,42
212,Robert Lang,Penguins,82,80,32,48
212,Robert Lang,Penguins,62,50,18,32
212,Robert Lang,Capitals,82,69,22,47
212,Robert Lang,Capitals,63,74,29,45
212,Robert Lang,Red Wings,6,5,1,4
212,Robert Lang,Red Wings,72,62,20,42
212,Robert Lang,Red Wings,81,52,19,33
212,Robert Lang,Blackhawks,76,54,21,33
212,Robert Lang,Canadiens,50,39,18,21
212,Robert Lang,Coyotes,64,29,9,20
213,Bobby Rousseau,Canadiens,15,3,1,2
213,Bobby Rousseau,Canadiens,70,45,21,24
213,Bobby Rousseau,Canadiens,62,37,19,18
213,Bobby Rousseau,Canadiens,70,56,25,31
213,Bobby Rousseau,Canadiens,66,47,12,35
213,Bobby Rousseau,Canadiens,70,78,30,48
213,Bobby Rousseau,Canadiens,68,63,19,44
213,Bobby Rousseau,Canadiens,74,65,19,46
213,Bobby Rousseau,Canadiens,76,70,30,40
213,Bobby Rousseau,Canadiens,72,58,24,34
213,Bobby Rousseau,North Stars,63,24,4,20
213,Bobby Rousseau,Rangers,78,57,21,36
213,Bobby Rousseau,Rangers,78,45,8,37
213,Bobby Rousseau,Rangers,72,51,10,41
213,Bobby Rousseau,Rangers,8,4,2,2
214,Rene Robert,Maple Leafs,5,0,0,0
214,Rene Robert,Penguins,49,18,7,11
214,Rene Robert,Sabres,12,9,6,3
214,Rene Robert,Sabres,75,83,40,43
214,Rene Robert,Sabres,76,65,21,44
214,Rene Robert,Sabres,74,100,40,60
214,Rene Robert,Sabres,72,87,35,52
214,Rene Robert,Sabres,80,73,33,40
214,Rene Robert,Sabres,67,73,25,48
214,Rene Robert,Sabres,68,62,22,40
214,Rene Robert,Rockies,69,63,28,35
214,Rene Robert,Rockies,28,19,8,11
214,Rene Robert,Maple Leafs,14,13,6,7
214,Rene Robert,Maple Leafs,55,37,13,24
215,Richard Martin,Sabres,73,74,44,30
215,Richard Martin,Sabres,75,73,37,36
215,Richard Martin,Sabres,78,86,52,34
215,Richard Martin,Sabres,68,95,52,43
215,Richard Martin,Sabres,80,86,49,37
215,Richard Martin,Sabres,66,65,36,29
215,Richard Martin,Sabres,65,63,28,35
215,Richard Martin,Sabres,73,53,32,21
215,Richard Martin,Sabres,80,79,45,34
215,Richard Martin,Sabres,23,21,7,14
215,Richard Martin,Kings,1,2,1,1
215,Richard Martin,Kings,3,4,1,3
216,Mel Bridgman,Flyers,80,50,23,27
216,Mel Bridgman,Flyers,70,57,19,38
216,Mel Bridgman,Flyers,76,48,16,32
216,Mel Bridgman,Flyers,76,59,24,35
216,Mel Bridgman,Flyers,74,47,16,31
216,Mel Bridgman,Flyers,77,51,14,37
216,Mel Bridgman,Flyers,9,12,7,5
216,Mel Bridgman,Flames,63,75,26,49
216,Mel Bridgman,Flames,79,50,19,31
216,Mel Bridgman,Devils,79,61,23,38
216,Mel Bridgman,Devils,80,61,22,39
216,Mel Bridgman,Devils,78,63,23,40
216,Mel Bridgman,Devils,51,39,8,31
216,Mel Bridgman,Red Wings,13,4,2,2
216,Mel Bridgman,Red Wings,57,17,6,11
216,Mel Bridgman,Canucks,15,7,4,3
217,Geoff Sanderson,Whalers,2,1,1,0
217,Geoff Sanderson,Whalers,64,31,13,18
217,Geoff Sanderson,Whalers,82,89,46,43
217,Geoff Sanderson,Whalers,82,67,41,26
217,Geoff Sanderson,Whalers,46,32,18,14
217,Geoff Sanderson,Whalers,81,65,34,31
217,Geoff Sanderson,Whalers,82,67,36,31
217,Geoff Sanderson,Hurricanes,40,17,7,10
217,Geoff Sanderson,Canucks,9,3,0,3
217,Geoff Sanderson,Sabres,26,9,4,5
217,Geoff Sanderson,Sabres,75,30,12,18
217,Geoff Sanderson,Sabres,67,26,13,13
217,Geoff Sanderson,Blue Jackets,68,56,30,26
217,Geoff Sanderson,Blue Jackets,42,16,11,5
217,Geoff Sanderson,Blue Jackets,82,67,34,33
217,Geoff Sanderson,Blue Jackets,67,29,13,16
217,Geoff Sanderson,Canucks,13,7,3,4
217,Geoff Sanderson,Blue Jackets,2,0,0,0
217,Geoff Sanderson,Coyotes,75,46,25,21
217,Geoff Sanderson,Flyers,58,29,11,18
217,Geoff Sanderson,Oilers,41,13,3,10
218,Jason Spezza,Senators,33,21,7,14
218,Jason Spezza,Senators,78,55,22,33
218,Jason Spezza,Senators,68,90,19,71
218,Jason Spezza,Senators,67,87,34,53
218,Jason Spezza,Senators,76,92,34,58
218,Jason Spezza,Senators,82,73,32,41
218,Jason Spezza,Senators,60,57,23,34
218,Jason Spezza,Senators,62,57,21,36
218,Jason Spezza,Senators,80,84,34,50
218,Jason Spezza,Senators,5,5,2,3
218,Jason Spezza,Senators,75,66,23,43
218,Jason Spezza,Stars,13,12,2,10
219,Chris Pronger,Whalers,81,30,5,25
219,Chris Pronger,Whalers,43,14,5,9
219,Chris Pronger,Blues,78,25,7,18
219,Chris Pronger,Blues,79,35,11,24
219,Chris Pronger,Blues,81,36,9,27
219,Chris Pronger,Blues,67,46,13,33
219,Chris Pronger,Blues,79,62,14,48
219,Chris Pronger,Blues,51,47,8,39
219,Chris Pronger,Blues,78,47,7,40
219,Chris Pronger,Blues,5,4,1,3
219,Chris Pronger,Blues,80,54,14,40
219,Chris Pronger,Oilers,80,56,12,44
219,Chris Pronger,Ducks,66,59,13,46
219,Chris Pronger,Ducks,72,43,12,31
219,Chris Pronger,Ducks,82,48,11,37
219,Chris Pronger,Flyers,82,55,10,45
219,Chris Pronger,Flyers,50,25,4,21
219,Chris Pronger,Flyers,13,12,1,11
220,Clark Gillies,Islanders,80,47,25,22
220,Clark Gillies,Islanders,80,61,34,27
220,Clark Gillies,Islanders,70,55,33,22
220,Clark Gillies,Islanders,80,85,35,50
220,Clark Gillies,Islanders,75,91,35,56
220,Clark Gillies,Islanders,73,54,19,35
220,Clark Gillies,Islanders,80,78,33,45
220,Clark Gillies,Islanders,79,77,38,39
220,Clark Gillies,Islanders,70,41,21,20
220,Clark Gillies,Islanders,76,28,12,16
220,Clark Gillies,Islanders,54,32,15,17
220,Clark Gillies,Islanders,55,14,4,10
220,Clark Gillies,Sabres,61,27,10,17
220,Clark Gillies,Sabres,25,7,5,2
221,Cam Neely,Canucks,56,31,16,15
221,Cam Neely,Canucks,72,39,21,18
221,Cam Neely,Canucks,73,34,14,20
221,Cam Neely,Bruins,75,72,36,36
221,Cam Neely,Bruins,69,69,42,27
221,Cam Neely,Bruins,74,75,37,38
221,Cam Neely,Bruins,76,92,55,37
221,Cam Neely,Bruins,69,91,51,40
221,Cam Neely,Bruins,9,12,9,3
221,Cam Neely,Bruins,13,18,11,7
221,Cam Neely,Bruins,49,74,50,24
221,Cam Neely,Bruins,42,41,27,14
221,Cam Neely,Bruins,49,46,26,20
222,Eric Staal,Hurricanes,81,31,11,20
222,Eric Staal,Hurricanes,82,100,45,55
222,Eric Staal,Hurricanes,82,70,30,40
222,Eric Staal,Hurricanes,82,82,38,44
222,Eric Staal,Hurricanes,82,75,40,35
222,Eric Staal,Hurricanes,70,70,29,41
222,Eric Staal,Hurricanes,81,76,33,43
222,Eric Staal,Hurricanes,82,70,24,46
222,Eric Staal,Hurricanes,48,53,18,35
222,Eric Staal,Hurricanes,79,61,21,40
222,Eric Staal,Hurricanes,7,6,2,4
223,Shayne Corson,Canadiens,3,0,0,0
223,Shayne Corson,Canadiens,55,23,12,11
223,Shayne Corson,Canadiens,71,39,12,27
223,Shayne Corson,Canadiens,80,50,26,24
223,Shayne Corson,Canadiens,76,75,31,44
223,Shayne Corson,Canadiens,71,47,23,24
223,Shayne Corson,Canadiens,64,53,17,36
223,Shayne Corson,Oilers,80,47,16,31
223,Shayne Corson,Oilers,64,54,25,29
223,Shayne Corson,Oilers,48,36,12,24
223,Shayne Corson,Blues,77,46,18,28
223,Shayne Corson,Blues,11,3,2,1
223,Shayne Corson,Canadiens,47,21,6,15
223,Shayne Corson,Canadiens,62,55,21,34
223,Shayne Corson,Canadiens,63,32,12,20
223,Shayne Corson,Canadiens,70,28,8,20
223,Shayne Corson,Maple Leafs,77,26,8,18
223,Shayne Corson,Maple Leafs,74,33,12,21
223,Shayne Corson,Maple Leafs,46,15,7,8
223,Shayne Corson,Stars,17,10,5,5
224,Daniel Briere,Coyotes,5,1,1,0
224,Daniel Briere,Coyotes,64,22,8,14
224,Daniel Briere,Coyotes,13,2,1,1
224,Daniel Briere,Coyotes,30,15,11,4
224,Daniel Briere,Coyotes,78,60,32,28
224,Daniel Briere,Coyotes,68,46,17,29
224,Daniel Briere,Sabres,14,12,7,5
224,Daniel Briere,Sabres,82,65,28,37
224,Daniel Briere,Sabres,48,58,25,33
224,Daniel Briere,Sabres,81,95,32,63
224,Daniel Briere,Flyers,79,72,31,41
224,Daniel Briere,Flyers,29,25,11,14
224,Daniel Briere,Flyers,75,53,26,27
224,Daniel Briere,Flyers,77,68,34,34
224,Daniel Briere,Flyers,70,49,16,33
224,Daniel Briere,Flyers,34,16,6,10
224,Daniel Briere,Canadiens,69,25,13,12
224,Daniel Briere,Avalanche,10,3,2,1
225,Kent Nilsson,Flames,80,93,40,53
225,Kent Nilsson,Flames,80,131,49,82
225,Kent Nilsson,Flames,41,55,26,29
225,Kent Nilsson,Flames,80,104,46,58
225,Kent Nilsson,Flames,67,80,31,49
225,Kent Nilsson,Flames,77,99,37,62
225,Kent Nilsson,North Stars,61,60,16,44
225,Kent Nilsson,North Stars,44,46,13,33
225,Kent Nilsson,Oilers,17,17,5,12
225,Kent Nilsson,Oilers,6,1,1,0
226,Daniel Gare,Sabres,78,62,31,31
226,Daniel Gare,Sabres,79,73,50,23
226,Daniel Gare,Sabres,35,26,11,15
226,Daniel Gare,Sabres,69,77,39,38
226,Daniel Gare,Sabres,71,67,27,40
226,Daniel Gare,Sabres,76,89,56,33
226,Daniel Gare,Sabres,73,85,46,39
226,Daniel Gare,Sabres,22,21,7,14
226,Daniel Gare,Red Wings,36,22,13,9
226,Daniel Gare,Red Wings,79,61,26,35
226,Daniel Gare,Red Wings,63,26,13,13
226,Daniel Gare,Red Wings,71,56,27,29
226,Daniel Gare,Red Wings,57,16,7,9
226,Daniel Gare,Oilers,18,4,1,3
227,Dan Quinn,Flames,54,52,19,33
227,Dan Quinn,Flames,74,58,20,38
227,Dan Quinn,Flames,78,72,30,42
227,Dan Quinn,Flames,16,9,3,6
227,Dan Quinn,Penguins,64,71,28,43
227,Dan Quinn,Penguins,70,79,40,39
227,Dan Quinn,Penguins,79,94,34,60
227,Dan Quinn,Penguins,41,29,9,20
227,Dan Quinn,Canucks,37,34,16,18
227,Dan Quinn,Canucks,64,49,18,31
227,Dan Quinn,Blues,14,11,4,7
227,Dan Quinn,Flyers,67,37,11,26
227,Dan Quinn,North Stars,11,4,0,4
227,Dan Quinn,Senators,13,7,7,0
227,Dan Quinn,Kings,44,31,14,17
227,Dan Quinn,Senators,28,24,6,18
227,Dan Quinn,Flyers,35,21,7,14
227,Dan Quinn,Penguins,16,3,0,3
228,Reed Larson,Red Wings,14,1,0,1
228,Reed Larson,Red Wings,75,60,19,41
228,Reed Larson,Red Wings,79,67,18,49
228,Reed Larson,Red Wings,80,66,22,44
228,Reed Larson,Red Wings,78,58,27,31
228,Reed Larson,Red Wings,80,60,21,39
228,Reed Larson,Red Wings,80,74,22,52
228,Reed Larson,Red Wings,78,62,23,39
228,Reed Larson,Red Wings,77,62,17,45
228,Reed Larson,Red Wings,67,60,19,41
228,Reed Larson,Bruins,13,7,3,4
228,Reed Larson,Bruins,66,36,12,24
228,Reed Larson,Bruins,62,34,10,24
228,Reed Larson,Oilers,10,9,2,7
228,Reed Larson,Islanders,33,20,7,13
228,Reed Larson,North Stars,11,9,0,9
228,Reed Larson,Sabres,1,0,0,0
229,Donald Lever,Canucks,78,38,12,26
229,Donald Lever,Canucks,78,48,23,25
229,Donald Lever,Canucks,80,68,38,30
229,Donald Lever,Canucks,80,65,25,40
229,Donald Lever,Canucks,80,57,27,30
229,Donald Lever,Canucks,75,49,17,32
229,Donald Lever,Canucks,71,44,23,21
229,Donald Lever,Canucks,51,38,21,17
229,Donald Lever,Flames,28,30,14,16
229,Donald Lever,Flames,62,57,26,31
229,Donald Lever,Flames,23,19,8,11
229,Donald Lever,Rockies,59,50,22,28
229,Donald Lever,Devils,79,53,23,30
229,Donald Lever,Devils,70,33,14,19
229,Donald Lever,Devils,67,18,10,8
229,Donald Lever,Sabres,29,8,7,1
229,Donald Lever,Sabres,10,5,3,2
230,Michael Nylander,Whalers,59,33,11,22
230,Michael Nylander,Whalers,58,44,11,33
230,Michael Nylander,Flames,15,11,2,9
230,Michael Nylander,Flames,6,1,0,1
230,Michael Nylander,Flames,73,55,17,38
230,Michael Nylander,Flames,65,36,13,23
230,Michael Nylander,Flames,9,5,2,3
230,Michael Nylander,Lightning,24,9,2,7
230,Michael Nylander,Lightning,11,3,1,2
230,Michael Nylander,Blackhawks,66,51,23,28
230,Michael Nylander,Blackhawks,82,64,25,39
230,Michael Nylander,Blackhawks,82,61,15,46
230,Michael Nylander,Blackhawks,9,4,0,4
230,Michael Nylander,Capitals,71,56,17,39
230,Michael Nylander,Capitals,3,2,0,2
230,Michael Nylander,Bruins,15,12,1,11
230,Michael Nylander,Rangers,81,79,23,56
230,Michael Nylander,Rangers,79,83,26,57
230,Michael Nylander,Capitals,40,37,11,26
230,Michael Nylander,Capitals,72,33,9,24
231,Walt Tkaczuk,Rangers,2,0,0,0
231,Walt Tkaczuk,Rangers,71,36,12,24
231,Walt Tkaczuk,Rangers,76,77,27,50
231,Walt Tkaczuk,Rangers,77,75,26,49
231,Walt Tkaczuk,Rangers,76,66,24,42
231,Walt Tkaczuk,Rangers,76,66,27,39
231,Walt Tkaczuk,Rangers,71,63,21,42
231,Walt Tkaczuk,Rangers,62,36,11,25
231,Walt Tkaczuk,Rangers,78,36,8,28
231,Walt Tkaczuk,Rangers,80,50,12,38
231,Walt Tkaczuk,Rangers,80,66,26,40
231,Walt Tkaczuk,Rangers,77,42,15,27
231,Walt Tkaczuk,Rangers,76,37,12,25
231,Walt Tkaczuk,Rangers,43,28,6,22
232,Kevin Hatcher,Capitals,2,1,1,0
232,Kevin Hatcher,Capitals,79,19,9,10
232,Kevin Hatcher,Capitals,78,24,8,16
232,Kevin Hatcher,Capitals,71,41,14,27
232,Kevin Hatcher,Capitals,62,40,13,27
232,Kevin Hatcher,Capitals,80,54,13,41
232,Kevin Hatcher,Capitals,79,74,24,50
232,Kevin Hatcher,Capitals,79,54,17,37
232,Kevin Hatcher,Capitals,83,79,34,45
232,Kevin Hatcher,Capitals,72,40,16,24
232,Kevin Hatcher,Stars,47,29,10,19
232,Kevin Hatcher,Stars,74,41,15,26
232,Kevin Hatcher,Penguins,80,54,15,39
232,Kevin Hatcher,Penguins,74,48,19,29
232,Kevin Hatcher,Penguins,66,38,11,27
232,Kevin Hatcher,Rangers,74,23,4,19
232,Kevin Hatcher,Hurricanes,57,18,4,14
233,Jozef Stumpel,Bruins,4,1,1,0
233,Jozef Stumpel,Bruins,13,4,1,3
233,Jozef Stumpel,Bruins,59,23,8,15
233,Jozef Stumpel,Bruins,44,18,5,13
233,Jozef Stumpel,Bruins,76,54,18,36
233,Jozef Stumpel,Bruins,78,76,21,55
233,Jozef Stumpel,Kings,77,79,21,58
233,Jozef Stumpel,Kings,64,34,13,21
233,Jozef Stumpel,Kings,57,58,17,41
233,Jozef Stumpel,Kings,63,55,16,39
233,Jozef Stumpel,Kings,9,4,1,3
233,Jozef Stumpel,Bruins,72,54,7,47
233,Jozef Stumpel,Bruins,78,51,14,37
233,Jozef Stumpel,Kings,64,37,8,29
233,Jozef Stumpel,Panthers,74,52,15,37
233,Jozef Stumpel,Panthers,73,57,23,34
233,Jozef Stumpel,Panthers,52,20,7,13
234,Tim Kerr,Flyers,68,45,22,23
234,Tim Kerr,Flyers,61,51,21,30
234,Tim Kerr,Flyers,24,19,11,8
234,Tim Kerr,Flyers,79,93,54,39
234,Tim Kerr,Flyers,74,98,54,44
234,Tim Kerr,Flyers,76,84,58,26
234,Tim Kerr,Flyers,75,95,58,37
234,Tim Kerr,Flyers,8,5,3,2
234,Tim Kerr,Flyers,69,88,48,40
234,Tim Kerr,Flyers,40,48,24,24
234,Tim Kerr,Flyers,27,24,10,14
234,Tim Kerr,Rangers,32,18,7,11
234,Tim Kerr,Whalers,22,6,0,6
235,Michael Bullard,Penguins,15,3,1,2
235,Michael Bullard,Penguins,75,63,36,27
235,Michael Bullard,Penguins,57,44,22,22
235,Michael Bullard,Penguins,76,92,51,41
235,Michael Bullard,Penguins,68,63,32,31
235,Michael Bullard,Penguins,77,83,41,42
235,Michael Bullard,Penguins,14,12,2,10
235,Michael Bullard,Flames,57,54,28,26
235,Michael Bullard,Flames,79,103,48,55
235,Michael Bullard,Blues,20,16,4,12
235,Michael Bullard,Flyers,54,49,23,26
235,Michael Bullard,Flyers,70,64,27,37
235,Michael Bullard,Maple Leafs,65,28,14,14
236,Phil Goyette,Canadiens,14,7,3,4
236,Phil Goyette,Canadiens,70,46,9,37
236,Phil Goyette,Canadiens,63,28,10,18
236,Phil Goyette,Canadiens,65,43,21,22
236,Phil Goyette,Canadiens,62,11,7,4
236,Phil Goyette,Canadiens,69,34,7,27
236,Phil Goyette,Canadiens,32,13,5,8
236,Phil Goyette,Rangers,67,65,24,41
236,Phil Goyette,Rangers,52,46,12,34
236,Phil Goyette,Rangers,60,42,11,31
236,Phil Goyette,Rangers,70,61,12,49
236,Phil Goyette,Rangers,73,65,25,40
236,Phil Goyette,Rangers,67,45,13,32
236,Phil Goyette,Blues,72,78,29,49
236,Phil Goyette,Sabres,60,61,15,46
236,Phil Goyette,Sabres,37,24,3,21
236,Phil Goyette,Rangers,8,5,1,4
237,Paul MacLean,Blues,1,0,0,0
237,Paul MacLean,Jets (1979),74,61,36,25
237,Paul MacLean,Jets (1979),80,76,32,44
237,Paul MacLean,Jets (1979),76,71,40,31
237,Paul MacLean,Jets (1979),79,101,41,60
237,Paul MacLean,Jets (1979),69,56,27,29
237,Paul MacLean,Jets (1979),72,74,32,42
237,Paul MacLean,Jets (1979),77,79,40,39
237,Paul MacLean,Red Wings,76,71,36,35
237,Paul MacLean,Blues,78,67,34,33
237,Paul MacLean,Blues,37,17,6,11
238,Stanley Smyl,Canucks,62,38,14,24
238,Stanley Smyl,Canucks,77,78,31,47
238,Stanley Smyl,Canucks,80,63,25,38
238,Stanley Smyl,Canucks,80,78,34,44
238,Stanley Smyl,Canucks,74,88,38,50
238,Stanley Smyl,Canucks,80,67,24,43
238,Stanley Smyl,Canucks,80,64,27,37
238,Stanley Smyl,Canucks,73,62,27,35
238,Stanley Smyl,Canucks,66,43,20,23
238,Stanley Smyl,Canucks,57,37,12,25
238,Stanley Smyl,Canucks,75,25,7,18
238,Stanley Smyl,Canucks,47,16,1,15
238,Stanley Smyl,Canucks,45,14,2,12
239,Daymond Langkow,Lightning,4,1,0,1
239,Daymond Langkow,Lightning,79,28,15,13
239,Daymond Langkow,Lightning,68,22,8,14
239,Daymond Langkow,Lightning,22,10,4,6
239,Daymond Langkow,Flyers,56,23,10,13
239,Daymond Langkow,Flyers,82,50,18,32
239,Daymond Langkow,Flyers,71,54,13,41
239,Daymond Langkow,Coyotes,80,62,27,35
239,Daymond Langkow,Coyotes,82,52,20,32
239,Daymond Langkow,Coyotes,81,52,21,31
239,Daymond Langkow,Flames,82,59,25,34
239,Daymond Langkow,Flames,81,77,33,44
239,Daymond Langkow,Flames,80,65,30,35
239,Daymond Langkow,Flames,73,49,21,28
239,Daymond Langkow,Flames,72,37,14,23
239,Daymond Langkow,Flames,4,1,0,1
239,Daymond Langkow,Coyotes,73,30,11,19
240,Craig Ramsay,Sabres,57,16,6,10
240,Craig Ramsay,Sabres,76,28,11,17
240,Craig Ramsay,Sabres,78,46,20,26
240,Craig Ramsay,Sabres,80,64,26,38
240,Craig Ramsay,Sabres,80,71,22,49
240,Craig Ramsay,Sabres,80,61,20,41
240,Craig Ramsay,Sabres,80,71,28,43
240,Craig Ramsay,Sabres,80,57,26,31
240,Craig Ramsay,Sabres,80,60,21,39
240,Craig Ramsay,Sabres,80,59,24,35
240,Craig Ramsay,Sabres,80,51,16,35
240,Craig Ramsay,Sabres,64,29,11,18
240,Craig Ramsay,Sabres,76,26,9,17
240,Craig Ramsay,Sabres,79,33,12,21
241,Reginald Leach,Bruins,23,6,2,4
241,Reginald Leach,Bruins,56,20,7,13
241,Reginald Leach,Seals,17,13,6,7
241,Reginald Leach,Seals,76,35,23,12
241,Reginald Leach,Seals,78,46,22,24
241,Reginald Leach,Flyers,80,78,45,33
241,Reginald Leach,Flyers,80,91,61,30
241,Reginald Leach,Flyers,77,46,32,14
241,Reginald Leach,Flyers,72,52,24,28
241,Reginald Leach,Flyers,76,54,34,20
241,Reginald Leach,Flyers,76,76,50,26
241,Reginald Leach,Flyers,79,70,34,36
241,Reginald Leach,Flyers,66,47,26,21
241,Reginald Leach,Red Wings,78,32,15,17
242,Mike Ribeiro,Canadiens,19,2,1,1
242,Mike Ribeiro,Canadiens,2,0,0,0
242,Mike Ribeiro,Canadiens,43,18,8,10
242,Mike Ribeiro,Canadiens,52,17,5,12
242,Mike Ribeiro,Canadiens,81,65,20,45
242,Mike Ribeiro,Canadiens,79,51,16,35
242,Mike Ribeiro,Stars,81,59,18,41
242,Mike Ribeiro,Stars,76,83,27,56
242,Mike Ribeiro,Stars,82,78,22,56
242,Mike Ribeiro,Stars,66,53,19,34
242,Mike Ribeiro,Stars,82,71,19,52
242,Mike Ribeiro,Stars,74,63,18,45
242,Mike Ribeiro,Capitals,48,49,13,36
242,Mike Ribeiro,Coyotes,80,47,16,31
242,Mike Ribeiro,Predators,13,10,3,7
243,Guy Carbonneau,Canadiens,2,1,0,1
243,Guy Carbonneau,Canadiens,77,47,18,29
243,Guy Carbonneau,Canadiens,78,54,24,30
243,Guy Carbonneau,Canadiens,79,57,23,34
243,Guy Carbonneau,Canadiens,80,56,20,36
243,Guy Carbonneau,Canadiens,79,45,18,27
243,Guy Carbonneau,Canadiens,80,38,17,21
243,Guy Carbonneau,Canadiens,79,56,26,30
243,Guy Carbonneau,Canadiens,68,55,19,36
243,Guy Carbonneau,Canadiens,78,44,20,24
243,Guy Carbonneau,Canadiens,72,39,18,21
243,Guy Carbonneau,Canadiens,61,17,4,13
243,Guy Carbonneau,Canadiens,79,38,14,24
243,Guy Carbonneau,Blues,42,16,5,11
243,Guy Carbonneau,Stars,71,23,8,15
243,Guy Carbonneau,Stars,73,21,5,16
243,Guy Carbonneau,Stars,77,24,7,17
243,Guy Carbonneau,Stars,74,16,4,12
243,Guy Carbonneau,Stars,69,16,10,6
244,Jamie Langenbrunner,Stars,2,0,0,0
244,Jamie Langenbrunner,Stars,12,4,2,2
244,Jamie Langenbrunner,Stars,76,39,13,26
244,Jamie Langenbrunner,Stars,81,52,23,29
244,Jamie Langenbrunner,Stars,75,45,12,33
244,Jamie Langenbrunner,Stars,65,39,18,21
244,Jamie Langenbrunner,Stars,53,30,12,18
244,Jamie Langenbrunner,Stars,68,26,10,16
244,Jamie Langenbrunner,Devils,14,6,3,3
244,Jamie Langenbrunner,Devils,78,55,22,33
244,Jamie Langenbrunner,Devils,53,26,10,16
244,Jamie Langenbrunner,Devils,80,53,19,34
244,Jamie Langenbrunner,Devils,82,60,23,37
244,Jamie Langenbrunner,Devils,64,41,13,28
244,Jamie Langenbrunner,Devils,81,69,29,40
244,Jamie Langenbrunner,Devils,81,61,19,42
244,Jamie Langenbrunner,Devils,31,14,4,10
244,Jamie Langenbrunner,Stars,39,18,5,13
244,Jamie Langenbrunner,Blues,70,24,6,18
244,Jamie Langenbrunner,Blues,4,1,0,1
245,Martin Gelinas,Oilers,6,3,1,2
245,Martin Gelinas,Oilers,46,25,17,8
245,Martin Gelinas,Oilers,73,40,20,20
245,Martin Gelinas,Oilers,68,29,11,18
245,Martin Gelinas,Oilers,65,23,11,12
245,Martin Gelinas,Nordiques,31,12,6,6
245,Martin Gelinas,Canucks,33,16,8,8
245,Martin Gelinas,Canucks,46,23,13,10
245,Martin Gelinas,Canucks,81,56,30,26
245,Martin Gelinas,Canucks,74,68,35,33
245,Martin Gelinas,Canucks,24,8,4,4
245,Martin Gelinas,Hurricanes,40,26,12,14
245,Martin Gelinas,Hurricanes,76,28,13,15
245,Martin Gelinas,Hurricanes,81,30,14,16
245,Martin Gelinas,Hurricanes,79,52,23,29
245,Martin Gelinas,Hurricanes,72,29,13,16
245,Martin Gelinas,Flames,81,52,21,31
245,Martin Gelinas,Flames,76,35,17,18
245,Martin Gelinas,Panthers,82,41,17,24
245,Martin Gelinas,Panthers,82,44,14,30
245,Martin Gelinas,Predators,57,20,9,11
246,Red Berenson,Canadiens,4,3,1,2
246,Red Berenson,Canadiens,37,8,2,6
246,Red Berenson,Canadiens,69,16,7,9
246,Red Berenson,Canadiens,3,3,1,2
246,Red Berenson,Canadiens,23,7,3,4
246,Red Berenson,Rangers,30,5,0,5
246,Red Berenson,Rangers,19,3,2,1
246,Red Berenson,Blues,55,51,22,29
246,Red Berenson,Blues,76,82,35,47
246,Red Berenson,Blues,67,72,33,39
246,Red Berenson,Blues,45,42,16,26
246,Red Berenson,Red Wings,24,17,5,12
246,Red Berenson,Red Wings,78,69,28,41
246,Red Berenson,Red Wings,78,43,13,30
246,Red Berenson,Red Wings,76,66,24,42
246,Red Berenson,Red Wings,27,6,3,3
246,Red Berenson,Blues,44,31,12,19
246,Red Berenson,Blues,72,47,20,27
246,Red Berenson,Blues,80,49,21,28
246,Red Berenson,Blues,80,38,13,25
247,Kelly Kisio,Red Wings,15,7,4,3
247,Kelly Kisio,Red Wings,70,60,23,37
247,Kelly Kisio,Red Wings,75,61,20,41
247,Kelly Kisio,Red Wings,76,69,21,48
247,Kelly Kisio,Rangers,70,64,24,40
247,Kelly Kisio,Rangers,77,78,23,55
247,Kelly Kisio,Rangers,70,62,26,36
247,Kelly Kisio,Rangers,68,66,22,44
247,Kelly Kisio,Rangers,51,35,15,20
247,Kelly Kisio,Sharks,48,37,11,26
247,Kelly Kisio,Sharks,78,78,26,52
247,Kelly Kisio,Flames,51,30,7,23
247,Kelly Kisio,Flames,12,11,7,4
248,Ray Sheppard,Sabres,74,65,38,27
248,Ray Sheppard,Sabres,67,43,22,21
248,Ray Sheppard,Sabres,18,6,4,2
248,Ray Sheppard,Rangers,59,47,24,23
248,Ray Sheppard,Red Wings,74,62,36,26
248,Ray Sheppard,Red Wings,70,66,32,34
248,Ray Sheppard,Red Wings,82,93,52,41
248,Ray Sheppard,Red Wings,43,40,30,10
248,Ray Sheppard,Red Wings,5,4,2,2
248,Ray Sheppard,Sharks,51,46,27,19
248,Ray Sheppard,Panthers,14,10,8,2
248,Ray Sheppard,Panthers,68,60,29,31
248,Ray Sheppard,Panthers,61,31,14,17
248,Ray Sheppard,Hurricanes,10,6,4,2
248,Ray Sheppard,Hurricanes,74,58,25,33
248,Ray Sheppard,Panthers,47,20,10,10
249,Ulf Dahlen,Rangers,70,52,29,23
249,Ulf Dahlen,Rangers,56,43,24,19
249,Ulf Dahlen,Rangers,63,36,18,18
249,Ulf Dahlen,North Stars,13,6,2,4
249,Ulf Dahlen,North Stars,66,39,21,18
249,Ulf Dahlen,North Stars,79,66,36,30
249,Ulf Dahlen,North Stars,83,74,35,39
249,Ulf Dahlen,Stars,65,57,19,38
249,Ulf Dahlen,Sharks,13,12,6,6
249,Ulf Dahlen,Sharks,46,34,11,23
249,Ulf Dahlen,Sharks,59,28,16,12
249,Ulf Dahlen,Sharks,43,19,8,11
249,Ulf Dahlen,Blackhawks,30,14,6,8
249,Ulf Dahlen,Capitals,75,38,15,23
249,Ulf Dahlen,Capitals,73,48,15,33
249,Ulf Dahlen,Capitals,69,52,23,29
249,Ulf Dahlen,Stars,63,37,17,20
250,Dennis Hull,Blackhawks,55,14,10,4
250,Dennis Hull,Blackhawks,25,6,1,5
250,Dennis Hull,Blackhawks,70,42,25,17
250,Dennis Hull,Blackhawks,74,33,18,15
250,Dennis Hull,Blackhawks,72,64,30,34
250,Dennis Hull,Blackhawks,76,52,17,35
250,Dennis Hull,Blackhawks,78,66,40,26
250,Dennis Hull,Blackhawks,78,69,30,39
250,Dennis Hull,Blackhawks,78,90,39,51
250,Dennis Hull,Blackhawks,74,68,29,39
250,Dennis Hull,Blackhawks,69,37,16,21
250,Dennis Hull,Blackhawks,80,66,27,39
250,Dennis Hull,Blackhawks,75,33,16,17
250,Dennis Hull,Red Wings,55,14,5,9
251,Barry Pederson,Bruins,9,5,1,4
251,Barry Pederson,Bruins,80,92,44,48
251,Barry Pederson,Bruins,77,107,46,61
251,Barry Pederson,Bruins,80,116,39,77
251,Barry Pederson,Bruins,22,12,4,8
251,Barry Pederson,Bruins,79,76,29,47
251,Barry Pederson,Canucks,79,76,24,52
251,Barry Pederson,Canucks,76,71,19,52
251,Barry Pederson,Canucks,62,41,15,26
251,Barry Pederson,Canucks,16,9,2,7
251,Barry Pederson,Penguins,38,22,4,18
251,Barry Pederson,Penguins,46,14,6,8
251,Barry Pederson,Whalers,5,4,2,2
251,Barry Pederson,Bruins,32,9,3,6
252,Glen Murray,Bruins,5,4,3,1
252,Glen Murray,Bruins,27,7,3,4
252,Glen Murray,Bruins,81,31,18,13
252,Glen Murray,Bruins,35,7,5,2
252,Glen Murray,Penguins,69,29,14,15
252,Glen Murray,Penguins,66,22,11,11
252,Glen Murray,Kings,11,8,5,3
252,Glen Murray,Kings,81,60,29,31
252,Glen Murray,Kings,61,31,16,15
252,Glen Murray,Kings,78,62,29,33
252,Glen Murray,Kings,64,39,18,21
252,Glen Murray,Kings,9,11,6,5
252,Glen Murray,Bruins,73,60,35,25
252,Glen Murray,Bruins,82,92,44,48
252,Glen Murray,Bruins,81,60,32,28
252,Glen Murray,Bruins,64,53,24,29
252,Glen Murray,Bruins,59,45,28,17
252,Glen Murray,Bruins,63,30,17,13
253,Bryan Smolinski,Bruins,9,4,1,3
253,Bryan Smolinski,Bruins,83,51,31,20
253,Bryan Smolinski,Bruins,44,31,18,13
253,Bryan Smolinski,Penguins,81,64,24,40
253,Bryan Smolinski,Islanders,64,56,28,28
253,Bryan Smolinski,Islanders,81,43,13,30
253,Bryan Smolinski,Islanders,82,40,16,24
253,Bryan Smolinski,Kings,79,56,20,36
253,Bryan Smolinski,Kings,78,59,27,32
253,Bryan Smolinski,Kings,80,38,13,25
253,Bryan Smolinski,Kings,58,38,18,20
253,Bryan Smolinski,Senators,10,8,3,5
253,Bryan Smolinski,Senators,80,46,19,27
253,Bryan Smolinski,Senators,81,48,17,31
253,Bryan Smolinski,Blackhawks,62,37,14,23
253,Bryan Smolinski,Canucks,20,7,4,3
253,Bryan Smolinski,Canadiens,64,25,8,17
254,Evgeni Malkin,Penguins,78,85,33,52
254,Evgeni Malkin,Penguins,82,106,47,59
254,Evgeni Malkin,Penguins,82,113,35,78
254,Evgeni Malkin,Penguins,67,77,28,49
254,Evgeni Malkin,Penguins,43,37,15,22
254,Evgeni Malkin,Penguins,75,109,50,59
254,Evgeni Malkin,Penguins,31,33,9,24
254,Evgeni Malkin,Penguins,60,72,23,49
254,Evgeni Malkin,Penguins,12,16,5,11
255,Randy Carlyle,Maple Leafs,45,5,0,5
255,Randy Carlyle,Maple Leafs,49,13,2,11
255,Randy Carlyle,Penguins,70,47,13,34
255,Randy Carlyle,Penguins,67,36,8,28
255,Randy Carlyle,Penguins,76,83,16,67
255,Randy Carlyle,Penguins,73,75,11,64
255,Randy Carlyle,Penguins,61,56,15,41
255,Randy Carlyle,Penguins,50,26,3,23
255,Randy Carlyle,Jets (1979),5,3,0,3
255,Randy Carlyle,Jets (1979),71,51,13,38
255,Randy Carlyle,Jets (1979),68,49,16,33
255,Randy Carlyle,Jets (1979),71,42,16,26
255,Randy Carlyle,Jets (1979),78,59,15,44
255,Randy Carlyle,Jets (1979),78,44,6,38
255,Randy Carlyle,Jets (1979),53,18,3,15
255,Randy Carlyle,Jets (1979),52,28,9,19
255,Randy Carlyle,Jets (1979),66,10,1,9
255,Randy Carlyle,Jets (1979),22,2,1,1
256,Ryan Walter,Capitals,69,56,28,28
256,Ryan Walter,Capitals,80,66,24,42
256,Ryan Walter,Capitals,80,68,24,44
256,Ryan Walter,Capitals,78,87,38,49
256,Ryan Walter,Canadiens,80,75,29,46
256,Ryan Walter,Canadiens,73,49,20,29
256,Ryan Walter,Canadiens,72,38,19,19
256,Ryan Walter,Canadiens,69,49,15,34
256,Ryan Walter,Canadiens,76,46,23,23
256,Ryan Walter,Canadiens,61,36,13,23
256,Ryan Walter,Canadiens,78,31,14,17
256,Ryan Walter,Canadiens,70,24,8,16
256,Ryan Walter,Canadiens,25,1,0,1
256,Ryan Walter,Canucks,67,17,6,11
256,Ryan Walter,Canucks,25,3,3,0
257,Igor Larionov,Canucks,74,44,17,27
257,Igor Larionov,Canucks,64,34,13,21
257,Igor Larionov,Canucks,72,65,21,44
257,Igor Larionov,Sharks,60,56,18,38
257,Igor Larionov,Sharks,33,24,4,20
257,Igor Larionov,Sharks,4,2,1,1
257,Igor Larionov,Red Wings,69,71,21,50
257,Igor Larionov,Red Wings,64,54,12,42
257,Igor Larionov,Red Wings,69,47,8,39
257,Igor Larionov,Red Wings,75,63,14,49
257,Igor Larionov,Red Wings,79,47,9,38
257,Igor Larionov,Panthers,26,11,5,6
257,Igor Larionov,Red Wings,39,29,4,25
257,Igor Larionov,Red Wings,70,43,11,32
257,Igor Larionov,Red Wings,74,43,10,33
257,Igor Larionov,Devils,49,11,1,10
258,Bob Pulford,Maple Leafs,65,22,11,11
258,Bob Pulford,Maple Leafs,70,31,14,17
258,Bob Pulford,Maple Leafs,70,37,23,14
258,Bob Pulford,Maple Leafs,70,52,24,28
258,Bob Pulford,Maple Leafs,40,29,11,18
258,Bob Pulford,Maple Leafs,70,39,18,21
258,Bob Pulford,Maple Leafs,70,44,19,25
258,Bob Pulford,Maple Leafs,70,48,18,30
258,Bob Pulford,Maple Leafs,65,39,19,20
258,Bob Pulford,Maple Leafs,70,56,28,28
258,Bob Pulford,Maple Leafs,67,45,17,28
258,Bob Pulford,Maple Leafs,74,50,20,30
258,Bob Pulford,Maple Leafs,72,34,11,23
258,Bob Pulford,Maple Leafs,74,37,18,19
258,Bob Pulford,Kings,59,43,17,26
258,Bob Pulford,Kings,73,37,13,24
259,Rick Nash,Blue Jackets,74,39,17,22
259,Rick Nash,Blue Jackets,80,57,41,16
259,Rick Nash,Blue Jackets,54,54,31,23
259,Rick Nash,Blue Jackets,75,57,27,30
259,Rick Nash,Blue Jackets,80,69,38,31
259,Rick Nash,Blue Jackets,78,79,40,39
259,Rick Nash,Blue Jackets,76,67,33,34
259,Rick Nash,Blue Jackets,75,66,32,34
259,Rick Nash,Blue Jackets,82,59,30,29
259,Rick Nash,Rangers,44,42,21,21
259,Rick Nash,Rangers,65,39,26,13
259,Rick Nash,Rangers,12,13,10,3
260,Ronald Ellis,Maple Leafs,1,0,0,0
260,Ronald Ellis,Maple Leafs,62,39,23,16
260,Ronald Ellis,Maple Leafs,70,42,19,23
260,Ronald Ellis,Maple Leafs,67,45,22,23
260,Ronald Ellis,Maple Leafs,74,48,28,20
260,Ronald Ellis,Maple Leafs,72,46,25,21
260,Ronald Ellis,Maple Leafs,76,54,35,19
260,Ronald Ellis,Maple Leafs,78,53,24,29
260,Ronald Ellis,Maple Leafs,78,47,23,24
260,Ronald Ellis,Maple Leafs,78,51,22,29
260,Ronald Ellis,Maple Leafs,70,48,23,25
260,Ronald Ellis,Maple Leafs,79,61,32,29
260,Ronald Ellis,Maple Leafs,80,50,26,24
260,Ronald Ellis,Maple Leafs,63,28,16,12
260,Ronald Ellis,Maple Leafs,59,23,12,11
260,Ronald Ellis,Maple Leafs,27,5,2,3
261,Tony McKegney,Sabres,52,22,8,14
261,Tony McKegney,Sabres,80,52,23,29
261,Tony McKegney,Sabres,80,69,37,32
261,Tony McKegney,Sabres,73,52,23,29
261,Tony McKegney,Sabres,78,73,36,37
261,Tony McKegney,Nordiques,75,51,24,27
261,Tony McKegney,Nordiques,30,21,12,9
261,Tony McKegney,North Stars,27,24,11,13
261,Tony McKegney,North Stars,70,40,15,25
261,Tony McKegney,North Stars,11,5,2,3
261,Tony McKegney,Rangers,64,46,29,17
261,Tony McKegney,Blues,80,78,40,38
261,Tony McKegney,Blues,71,42,25,17
261,Tony McKegney,Red Wings,14,3,2,1
261,Tony McKegney,Nordiques,48,27,16,11
261,Tony McKegney,Nordiques,50,33,17,16
261,Tony McKegney,Blackhawks,9,1,0,1
262,Ralph Backstrom,Canadiens,3,0,0,0
262,Ralph Backstrom,Canadiens,2,1,0,1
262,Ralph Backstrom,Canadiens,64,40,18,22
262,Ralph Backstrom,Canadiens,64,28,13,15
262,Ralph Backstrom,Canadiens,69,32,12,20
262,Ralph Backstrom,Canadiens,66,65,27,38
262,Ralph Backstrom,Canadiens,70,35,23,12
262,Ralph Backstrom,Canadiens,70,29,8,21
262,Ralph Backstrom,Canadiens,70,55,25,30
262,Ralph Backstrom,Canadiens,67,42,22,20
262,Ralph Backstrom,Canadiens,69,41,14,27
262,Ralph Backstrom,Canadiens,70,45,20,25
262,Ralph Backstrom,Canadiens,72,41,13,28
262,Ralph Backstrom,Canadiens,72,43,19,24
262,Ralph Backstrom,Canadiens,16,5,1,4
262,Ralph Backstrom,Kings,33,27,14,13
262,Ralph Backstrom,Kings,76,52,23,29
262,Ralph Backstrom,Kings,63,49,20,29
262,Ralph Backstrom,Blackhawks,16,9,6,3
263,James Patrick,Rangers,12,8,1,7
263,James Patrick,Rangers,75,36,8,28
263,James Patrick,Rangers,75,43,14,29
263,James Patrick,Rangers,78,55,10,45
263,James Patrick,Rangers,70,62,17,45
263,James Patrick,Rangers,68,47,11,36
263,James Patrick,Rangers,73,57,14,43
263,James Patrick,Rangers,74,59,10,49
263,James Patrick,Rangers,80,71,14,57
263,James Patrick,Rangers,60,26,5,21
263,James Patrick,Rangers,6,3,0,3
263,James Patrick,Whalers,47,28,8,20
263,James Patrick,Flames,15,4,2,2
263,James Patrick,Flames,43,10,0,10
263,James Patrick,Flames,80,35,3,32
263,James Patrick,Flames,19,4,3,1
263,James Patrick,Flames,60,17,6,11
263,James Patrick,Sabres,45,8,1,7
263,James Patrick,Sabres,66,13,5,8
263,James Patrick,Sabres,54,13,4,9
263,James Patrick,Sabres,56,13,5,8
263,James Patrick,Sabres,69,16,4,12
263,James Patrick,Sabres,55,11,4,7
264,Roman Hamrlik,Lightning,67,21,6,15
264,Roman Hamrlik,Lightning,64,21,3,18
264,Roman Hamrlik,Lightning,48,23,12,11
264,Roman Hamrlik,Lightning,82,65,16,49
264,Roman Hamrlik,Lightning,79,40,12,28
264,Roman Hamrlik,Lightning,37,15,3,12
264,Roman Hamrlik,Oilers,41,26,6,20
264,Roman Hamrlik,Oilers,75,32,8,24
264,Roman Hamrlik,Oilers,80,45,8,37
264,Roman Hamrlik,Islanders,76,46,16,30
264,Roman Hamrlik,Islanders,70,37,11,26
264,Roman Hamrlik,Islanders,73,41,9,32
264,Roman Hamrlik,Islanders,81,29,7,22
264,Roman Hamrlik,Flames,51,26,7,19
264,Roman Hamrlik,Flames,75,38,7,31
264,Roman Hamrlik,Canadiens,77,26,5,21
264,Roman Hamrlik,Canadiens,81,33,6,27
264,Roman Hamrlik,Canadiens,75,26,6,20
264,Roman Hamrlik,Canadiens,79,34,5,29
264,Roman Hamrlik,Capitals,68,13,2,11
264,Roman Hamrlik,Capitals,4,1,0,1
264,Roman Hamrlik,Rangers,12,0,0,0
265,Teppo Numminen,Jets (1979),69,15,1,14
265,Teppo Numminen,Jets (1979),79,43,11,32
265,Teppo Numminen,Jets (1979),80,33,8,25
265,Teppo Numminen,Jets (1979),80,39,5,34
265,Teppo Numminen,Jets (1979),66,37,7,30
265,Teppo Numminen,Jets (1979),57,23,5,18
265,Teppo Numminen,Jets (1979),42,21,5,16
265,Teppo Numminen,Jets (1979),74,54,11,43
265,Teppo Numminen,Coyotes,82,27,2,25
265,Teppo Numminen,Coyotes,82,51,11,40
265,Teppo Numminen,Coyotes,82,40,10,30
265,Teppo Numminen,Coyotes,79,42,8,34
265,Teppo Numminen,Coyotes,72,31,5,26
265,Teppo Numminen,Coyotes,76,48,13,35
265,Teppo Numminen,Coyotes,78,30,6,24
265,Teppo Numminen,Stars,62,17,3,14
265,Teppo Numminen,Sabres,75,40,2,38
265,Teppo Numminen,Sabres,79,29,2,27
265,Teppo Numminen,Sabres,1,0,0,0
265,Teppo Numminen,Sabres,57,17,2,15
266,Brian Sutter,Blues,35,14,4,10
266,Brian Sutter,Blues,78,22,9,13
266,Brian Sutter,Blues,77,80,41,39
266,Brian Sutter,Blues,71,58,23,35
266,Brian Sutter,Blues,78,69,35,34
266,Brian Sutter,Blues,74,75,39,36
266,Brian Sutter,Blues,79,76,46,30
266,Brian Sutter,Blues,76,83,32,51
266,Brian Sutter,Blues,77,74,37,37
266,Brian Sutter,Blues,44,42,19,23
266,Brian Sutter,Blues,14,6,3,3
266,Brian Sutter,Blues,76,37,15,22
267,Anton Stastny,Nordiques,80,85,39,46
267,Anton Stastny,Nordiques,68,72,26,46
267,Anton Stastny,Nordiques,79,92,32,60
267,Anton Stastny,Nordiques,69,62,25,37
267,Anton Stastny,Nordiques,79,80,38,42
267,Anton Stastny,Nordiques,74,74,31,43
267,Anton Stastny,Nordiques,77,62,27,35
267,Anton Stastny,Nordiques,69,72,27,45
267,Anton Stastny,Nordiques,55,37,7,30
268,Mats Naslund,Canadiens,74,71,26,45
268,Mats Naslund,Canadiens,77,64,29,35
268,Mats Naslund,Canadiens,80,79,42,37
268,Mats Naslund,Canadiens,80,110,43,67
268,Mats Naslund,Canadiens,79,80,25,55
268,Mats Naslund,Canadiens,78,83,24,59
268,Mats Naslund,Canadiens,77,84,33,51
268,Mats Naslund,Canadiens,72,41,21,20
268,Mats Naslund,Bruins,34,22,8,14
269,John Anderson,Maple Leafs,17,3,1,2
269,John Anderson,Maple Leafs,71,26,15,11
269,John Anderson,Maple Leafs,74,53,25,28
269,John Anderson,Maple Leafs,75,43,17,26
269,John Anderson,Maple Leafs,69,57,31,26
269,John Anderson,Maple Leafs,80,80,31,49
269,John Anderson,Maple Leafs,73,68,37,31
269,John Anderson,Maple Leafs,75,63,32,31
269,John Anderson,Nordiques,65,49,21,28
269,John Anderson,Whalers,14,25,8,17
269,John Anderson,Whalers,76,75,31,44
269,John Anderson,Whalers,63,49,17,32
269,John Anderson,Whalers,62,40,16,24
270,Robert Reichel,Flames,66,41,19,22
270,Robert Reichel,Flames,77,54,20,34
270,Robert Reichel,Flames,80,88,40,48
270,Robert Reichel,Flames,84,93,40,53
270,Robert Reichel,Flames,48,35,18,17
270,Robert Reichel,Flames,70,43,16,27
270,Robert Reichel,Islanders,12,19,5,14
270,Robert Reichel,Islanders,82,65,25,40
270,Robert Reichel,Islanders,70,56,19,37
270,Robert Reichel,Coyotes,13,13,7,6
270,Robert Reichel,Maple Leafs,78,51,20,31
270,Robert Reichel,Maple Leafs,81,42,12,30
270,Robert Reichel,Maple Leafs,69,30,11,19
271,Esa Tikkanen,Oilers,35,13,7,6
271,Esa Tikkanen,Oilers,76,78,34,44
271,Esa Tikkanen,Oilers,80,74,23,51
271,Esa Tikkanen,Oilers,67,78,31,47
271,Esa Tikkanen,Oilers,79,63,30,33
271,Esa Tikkanen,Oilers,79,69,27,42
271,Esa Tikkanen,Oilers,40,28,12,16
271,Esa Tikkanen,Oilers,66,33,14,19
271,Esa Tikkanen,Rangers,15,7,2,5
271,Esa Tikkanen,Rangers,83,54,22,32
271,Esa Tikkanen,Blues,43,35,12,23
271,Esa Tikkanen,Blues,11,5,1,4
271,Esa Tikkanen,Devils,9,2,0,2
271,Esa Tikkanen,Canucks,38,37,13,24
271,Esa Tikkanen,Canucks,62,27,12,15
271,Esa Tikkanen,Rangers,14,3,1,2
271,Esa Tikkanen,Panthers,28,9,1,8
271,Esa Tikkanen,Capitals,20,12,2,10
271,Esa Tikkanen,Rangers,32,3,0,3
272,Brent Ashton,Canucks,47,19,5,14
272,Brent Ashton,Canucks,77,29,18,11
272,Brent Ashton,Rockies,80,60,24,36
272,Brent Ashton,Devils,76,33,14,19
272,Brent Ashton,North Stars,68,17,7,10
272,Brent Ashton,North Stars,29,11,4,7
272,Brent Ashton,Nordiques,49,51,27,24
272,Brent Ashton,Nordiques,77,58,26,32
272,Brent Ashton,Nordiques,46,44,25,19
272,Brent Ashton,Red Wings,35,31,15,16
272,Brent Ashton,Red Wings,73,53,26,27
272,Brent Ashton,Jets (1979),75,68,31,37
272,Brent Ashton,Jets (1979),79,56,22,34
272,Brent Ashton,Jets (1979),61,36,12,24
272,Brent Ashton,Jets (1979),7,1,1,0
272,Brent Ashton,Bruins,61,39,17,22
272,Brent Ashton,Bruins,26,4,2,2
272,Brent Ashton,Flames,32,19,8,11
273,Ed Westfall,Bruins,63,11,2,9
273,Ed Westfall,Bruins,48,12,1,11
273,Ed Westfall,Bruins,55,6,1,5
273,Ed Westfall,Bruins,68,27,12,15
273,Ed Westfall,Bruins,59,30,9,21
273,Ed Westfall,Bruins,70,36,12,24
273,Ed Westfall,Bruins,73,36,14,22
273,Ed Westfall,Bruins,70,42,18,24
273,Ed Westfall,Bruins,72,36,14,22
273,Ed Westfall,Bruins,78,59,25,34
273,Ed Westfall,Bruins,77,44,18,26
273,Ed Westfall,Islanders,67,46,15,31
273,Ed Westfall,Islanders,68,42,19,23
273,Ed Westfall,Islanders,73,55,22,33
273,Ed Westfall,Islanders,80,56,25,31
273,Ed Westfall,Islanders,79,47,14,33
273,Ed Westfall,Islanders,71,24,5,19
273,Ed Westfall,Islanders,55,16,5,11
274,Elmer Lach,Canadiens,43,21,7,14
274,Elmer Lach,Canadiens,1,1,0,1
274,Elmer Lach,Canadiens,45,58,18,40
274,Elmer Lach,Canadiens,48,72,24,48
274,Elmer Lach,Canadiens,50,80,26,54
274,Elmer Lach,Canadiens,50,47,13,34
274,Elmer Lach,Canadiens,31,30,14,16
274,Elmer Lach,Canadiens,60,61,30,31
274,Elmer Lach,Canadiens,36,29,11,18
274,Elmer Lach,Canadiens,64,48,15,33
274,Elmer Lach,Canadiens,65,45,21,24
274,Elmer Lach,Canadiens,70,65,15,50
274,Elmer Lach,Canadiens,53,41,16,25
274,Elmer Lach,Canadiens,48,25,5,20
275,Ryan Getzlaf,Ducks,57,39,14,25
275,Ryan Getzlaf,Ducks,82,58,25,33
275,Ryan Getzlaf,Ducks,77,82,24,58
275,Ryan Getzlaf,Ducks,81,91,25,66
275,Ryan Getzlaf,Ducks,66,69,19,50
275,Ryan Getzlaf,Ducks,67,76,19,57
275,Ryan Getzlaf,Ducks,82,57,11,46
275,Ryan Getzlaf,Ducks,44,49,15,34
275,Ryan Getzlaf,Ducks,77,87,31,56
275,Ryan Getzlaf,Ducks,14,15,4,11
276,Brian Mullen,Jets (1979),80,50,24,26
276,Brian Mullen,Jets (1979),75,62,21,41
276,Brian Mullen,Jets (1979),69,71,32,39
276,Brian Mullen,Jets (1979),79,62,28,34
276,Brian Mullen,Jets (1979),69,51,19,32
276,Brian Mullen,Rangers,74,54,25,29
276,Brian Mullen,Rangers,78,64,29,35
276,Brian Mullen,Rangers,76,68,27,41
276,Brian Mullen,Rangers,79,62,19,43
276,Brian Mullen,Sharks,72,46,18,28
276,Brian Mullen,Islanders,81,32,18,14
277,Guy Lapointe,Canadiens,1,0,0,0
277,Guy Lapointe,Canadiens,5,0,0,0
277,Guy Lapointe,Canadiens,78,44,15,29
277,Guy Lapointe,Canadiens,69,49,11,38
277,Guy Lapointe,Canadiens,76,54,19,35
277,Guy Lapointe,Canadiens,71,53,13,40
277,Guy Lapointe,Canadiens,80,75,28,47
277,Guy Lapointe,Canadiens,77,68,21,47
277,Guy Lapointe,Canadiens,77,76,25,51
277,Guy Lapointe,Canadiens,49,42,13,29
277,Guy Lapointe,Canadiens,69,55,13,42
277,Guy Lapointe,Canadiens,45,26,6,20
277,Guy Lapointe,Canadiens,33,10,1,9
277,Guy Lapointe,Canadiens,47,20,1,19
277,Guy Lapointe,Blues,8,6,0,6
277,Guy Lapointe,Blues,54,26,3,23
277,Guy Lapointe,Bruins,45,18,2,16
278,Ron Duguay,Rangers,71,40,20,20
278,Ron Duguay,Rangers,79,63,27,36
278,Ron Duguay,Rangers,73,50,28,22
278,Ron Duguay,Rangers,50,38,17,21
278,Ron Duguay,Rangers,72,76,40,36
278,Ron Duguay,Rangers,72,44,19,25
278,Ron Duguay,Red Wings,80,80,33,47
278,Ron Duguay,Red Wings,80,89,38,51
278,Ron Duguay,Red Wings,67,48,19,29
278,Ron Duguay,Penguins,13,13,6,7
278,Ron Duguay,Penguins,40,18,5,13
278,Ron Duguay,Rangers,34,21,9,12
278,Ron Duguay,Rangers,48,8,4,4
278,Ron Duguay,Kings,15,8,2,6
278,Ron Duguay,Kings,70,24,7,17
279,Keith Primeau,Red Wings,58,15,3,12
279,Keith Primeau,Red Wings,35,16,6,10
279,Keith Primeau,Red Wings,73,32,15,17
279,Keith Primeau,Red Wings,78,73,31,42
279,Keith Primeau,Red Wings,45,42,15,27
279,Keith Primeau,Red Wings,74,52,27,25
279,Keith Primeau,Whalers,75,51,26,25
279,Keith Primeau,Hurricanes,81,63,26,37
279,Keith Primeau,Hurricanes,78,62,30,32
279,Keith Primeau,Flyers,23,17,7,10
279,Keith Primeau,Flyers,71,73,34,39
279,Keith Primeau,Flyers,75,48,19,29
279,Keith Primeau,Flyers,80,46,19,27
279,Keith Primeau,Flyers,54,22,7,15
279,Keith Primeau,Flyers,9,7,1,6
280,Adam Graves,Red Wings,9,1,0,1
280,Adam Graves,Red Wings,56,12,7,5
280,Adam Graves,Red Wings,13,1,0,1
280,Adam Graves,Oilers,63,21,9,12
280,Adam Graves,Oilers,76,25,7,18
280,Adam Graves,Rangers,80,59,26,33
280,Adam Graves,Rangers,84,65,36,29
280,Adam Graves,Rangers,84,79,52,27
280,Adam Graves,Rangers,47,31,17,14
280,Adam Graves,Rangers,82,58,22,36
280,Adam Graves,Rangers,82,61,33,28
280,Adam Graves,Rangers,72,35,23,12
280,Adam Graves,Rangers,82,53,38,15
280,Adam Graves,Rangers,77,40,23,17
280,Adam Graves,Rangers,82,26,10,16
280,Adam Graves,Sharks,81,31,17,14
280,Adam Graves,Sharks,82,18,9,9
281,Fred Stanfield,Blackhawks,58,17,7,10
281,Fred Stanfield,Blackhawks,39,4,2,2
281,Fred Stanfield,Blackhawks,10,1,1,0
281,Fred Stanfield,Bruins,73,64,20,44
281,Fred Stanfield,Bruins,71,54,25,29
281,Fred Stanfield,Bruins,73,58,23,35
281,Fred Stanfield,Bruins,75,76,24,52
281,Fred Stanfield,Bruins,78,79,23,56
281,Fred Stanfield,Bruins,78,78,20,58
281,Fred Stanfield,North Stars,71,44,16,28
281,Fred Stanfield,North Stars,40,26,8,18
281,Fred Stanfield,Sabres,32,33,12,21
281,Fred Stanfield,Sabres,80,48,18,30
281,Fred Stanfield,Sabres,79,23,9,14
281,Fred Stanfield,Sabres,57,11,3,8
282,Chris Drury,Avalanche,79,44,20,24
282,Chris Drury,Avalanche,82,67,20,47
282,Chris Drury,Avalanche,71,65,24,41
282,Chris Drury,Avalanche,82,46,21,25
282,Chris Drury,Flames,80,53,23,30
282,Chris Drury,Sabres,76,53,18,35
282,Chris Drury,Sabres,81,67,30,37
282,Chris Drury,Sabres,77,69,37,32
282,Chris Drury,Rangers,82,58,25,33
282,Chris Drury,Rangers,81,56,22,34
282,Chris Drury,Rangers,77,32,14,18
282,Chris Drury,Rangers,24,5,1,4
283,Derek King,Islanders,2,0,0,0
283,Derek King,Islanders,55,36,12,24
283,Derek King,Islanders,60,43,14,29
283,Derek King,Islanders,46,40,13,27
283,Derek King,Islanders,66,45,19,26
283,Derek King,Islanders,80,78,40,38
283,Derek King,Islanders,77,76,38,38
283,Derek King,Islanders,78,70,30,40
283,Derek King,Islanders,43,26,10,16
283,Derek King,Islanders,61,32,12,20
283,Derek King,Islanders,70,53,23,30
283,Derek King,Whalers,12,6,3,3
283,Derek King,Maple Leafs,77,46,21,25
283,Derek King,Maple Leafs,81,52,24,28
283,Derek King,Maple Leafs,3,0,0,0
283,Derek King,Blues,19,9,2,7
284,Martin Rucinsky,Oilers,2,0,0,0
284,Martin Rucinsky,Nordiques,4,2,1,1
284,Martin Rucinsky,Nordiques,77,48,18,30
284,Martin Rucinsky,Nordiques,60,32,9,23
284,Martin Rucinsky,Nordiques,20,9,3,6
284,Martin Rucinsky,Avalanche,22,15,4,11
284,Martin Rucinsky,Canadiens,56,60,25,35
284,Martin Rucinsky,Canadiens,70,55,28,27
284,Martin Rucinsky,Canadiens,78,53,21,32
284,Martin Rucinsky,Canadiens,73,34,17,17
284,Martin Rucinsky,Canadiens,80,49,25,24
284,Martin Rucinsky,Canadiens,57,38,16,22
284,Martin Rucinsky,Canadiens,18,8,2,6
284,Martin Rucinsky,Stars,42,17,6,11
284,Martin Rucinsky,Rangers,15,13,3,10
284,Martin Rucinsky,Blues,61,30,16,14
284,Martin Rucinsky,Rangers,69,42,13,29
284,Martin Rucinsky,Canucks,13,3,1,2
284,Martin Rucinsky,Rangers,52,55,16,39
284,Martin Rucinsky,Blues,52,33,12,21
284,Martin Rucinsky,Blues,40,16,5,11
285,Ron Greschner,Rangers,70,45,8,37
285,Ron Greschner,Rangers,77,27,6,21
285,Ron Greschner,Rangers,80,47,11,36
285,Ron Greschner,Rangers,78,72,24,48
285,Ron Greschner,Rangers,60,53,17,36
285,Ron Greschner,Rangers,76,58,21,37
285,Ron Greschner,Rangers,74,68,27,41
285,Ron Greschner,Rangers,29,16,5,11
285,Ron Greschner,Rangers,10,8,3,5
285,Ron Greschner,Rangers,77,56,12,44
285,Ron Greschner,Rangers,48,45,16,29
285,Ron Greschner,Rangers,78,48,20,28
285,Ron Greschner,Rangers,61,40,6,34
285,Ron Greschner,Rangers,51,6,1,5
285,Ron Greschner,Rangers,58,11,1,10
285,Ron Greschner,Rangers,55,10,1,9
286,Dickie Moore,Canadiens,33,33,18,15
286,Dickie Moore,Canadiens,18,8,2,6
286,Dickie Moore,Canadiens,13,5,1,4
286,Dickie Moore,Canadiens,67,36,16,20
286,Dickie Moore,Canadiens,70,50,11,39
286,Dickie Moore,Canadiens,70,58,29,29
286,Dickie Moore,Canadiens,70,84,36,48
286,Dickie Moore,Canadiens,70,96,41,55
286,Dickie Moore,Canadiens,62,64,22,42
286,Dickie Moore,Canadiens,57,69,35,34
286,Dickie Moore,Canadiens,57,41,19,22
286,Dickie Moore,Canadiens,67,50,24,26
286,Dickie Moore,Maple Leafs,38,6,2,4
286,Dickie Moore,Blues,27,8,5,3
287,Peter Zezel,Flyers,65,61,15,46
287,Peter Zezel,Flyers,79,54,17,37
287,Peter Zezel,Flyers,71,72,33,39
287,Peter Zezel,Flyers,69,57,22,35
287,Peter Zezel,Flyers,26,17,4,13
287,Peter Zezel,Blues,52,53,17,36
287,Peter Zezel,Blues,73,72,25,47
287,Peter Zezel,Capitals,20,12,7,5
287,Peter Zezel,Maple Leafs,32,28,14,14
287,Peter Zezel,Maple Leafs,64,49,16,33
287,Peter Zezel,Maple Leafs,70,35,12,23
287,Peter Zezel,Maple Leafs,41,16,8,8
287,Peter Zezel,Stars,30,11,6,5
287,Peter Zezel,Blues,57,21,8,13
287,Peter Zezel,Blues,35,13,4,9
287,Peter Zezel,Devils,18,3,0,3
287,Peter Zezel,Devils,5,3,0,3
287,Peter Zezel,Canucks,25,17,5,12
287,Peter Zezel,Canucks,41,14,6,8
288,Walter McKechnie,North Stars,4,0,0,0
288,Walter McKechnie,North Stars,58,14,5,9
288,Walter McKechnie,North Stars,20,4,1,3
288,Walter McKechnie,North Stars,30,4,3,1
288,Walter McKechnie,Seals,56,31,11,20
288,Walter McKechnie,Seals,78,54,16,38
288,Walter McKechnie,Seals,63,52,23,29
288,Walter McKechnie,Bruins,53,6,3,3
288,Walter McKechnie,Red Wings,23,17,6,11
288,Walter McKechnie,Red Wings,80,82,26,56
288,Walter McKechnie,Red Wings,80,59,25,34
288,Walter McKechnie,Capitals,16,5,4,1
288,Walter McKechnie,Barons,53,34,12,22
288,Walter McKechnie,Maple Leafs,79,61,25,36
288,Walter McKechnie,Maple Leafs,54,43,7,36
288,Walter McKechnie,Rockies,17,4,0,4
288,Walter McKechnie,Rockies,53,38,15,23
288,Walter McKechnie,Red Wings,74,55,18,37
288,Walter McKechnie,Red Wings,64,43,14,29
289,Terry O'Reilly,Bruins,1,1,1,0
289,Terry O'Reilly,Bruins,72,27,5,22
289,Terry O'Reilly,Bruins,76,35,11,24
289,Terry O'Reilly,Bruins,68,35,15,20
289,Terry O'Reilly,Bruins,80,50,23,27
289,Terry O'Reilly,Bruins,79,55,14,41
289,Terry O'Reilly,Bruins,77,90,29,61
289,Terry O'Reilly,Bruins,80,77,26,51
289,Terry O'Reilly,Bruins,71,61,19,42
289,Terry O'Reilly,Bruins,77,43,8,35
289,Terry O'Reilly,Bruins,70,52,22,30
289,Terry O'Reilly,Bruins,19,20,6,14
289,Terry O'Reilly,Bruins,58,30,12,18
289,Terry O'Reilly,Bruins,63,30,13,17
290,Syl Apps Jr.,Rangers,31,3,1,2
290,Syl Apps Jr.,Penguins,31,25,9,16
290,Syl Apps Jr.,Penguins,72,59,15,44
290,Syl Apps Jr.,Penguins,77,85,29,56
290,Syl Apps Jr.,Penguins,75,85,24,61
290,Syl Apps Jr.,Penguins,79,79,24,55
290,Syl Apps Jr.,Penguins,80,99,32,67
290,Syl Apps Jr.,Penguins,72,61,18,43
290,Syl Apps Jr.,Penguins,9,7,0,7
290,Syl Apps Jr.,Kings,70,45,19,26
290,Syl Apps Jr.,Kings,80,37,7,30
290,Syl Apps Jr.,Kings,51,21,5,16
291,Mike Ricci,Flyers,68,41,21,20
291,Mike Ricci,Flyers,78,56,20,36
291,Mike Ricci,Nordiques,77,78,27,51
291,Mike Ricci,Nordiques,83,51,30,21
291,Mike Ricci,Nordiques,48,36,15,21
291,Mike Ricci,Avalanche,62,27,6,21
291,Mike Ricci,Avalanche,63,32,13,19
291,Mike Ricci,Avalanche,6,4,0,4
291,Mike Ricci,Sharks,59,23,9,14
291,Mike Ricci,Sharks,82,39,13,26
291,Mike Ricci,Sharks,82,44,20,24
291,Mike Ricci,Sharks,81,44,22,22
291,Mike Ricci,Sharks,79,53,19,34
291,Mike Ricci,Sharks,75,34,11,23
291,Mike Ricci,Sharks,71,26,7,19
291,Mike Ricci,Coyotes,78,16,10,6
291,Mike Ricci,Coyotes,7,1,0,1
292,Matt Cullen,Ducks,61,27,6,21
292,Matt Cullen,Ducks,75,25,11,14
292,Matt Cullen,Ducks,80,39,13,26
292,Matt Cullen,Ducks,82,40,10,30
292,Matt Cullen,Ducks,79,48,18,30
292,Matt Cullen,Ducks,50,21,7,14
292,Matt Cullen,Panthers,30,12,6,6
292,Matt Cullen,Panthers,56,19,6,13
292,Matt Cullen,Hurricanes,78,49,25,24
292,Matt Cullen,Rangers,80,41,16,25
292,Matt Cullen,Hurricanes,59,49,13,36
292,Matt Cullen,Hurricanes,69,43,22,21
292,Matt Cullen,Hurricanes,60,40,12,28
292,Matt Cullen,Senators,21,8,4,4
292,Matt Cullen,Wild,78,39,12,27
292,Matt Cullen,Wild,73,35,14,21
292,Matt Cullen,Wild,42,27,7,20
292,Matt Cullen,Predators,77,39,10,29
292,Matt Cullen,Predators,5,4,1,3
293,Bert Olmstead,Blackhawks,9,2,0,2
293,Bert Olmstead,Blackhawks,70,49,20,29
293,Bert Olmstead,Blackhawks,15,3,2,1
293,Bert Olmstead,Canadiens,39,38,16,22
293,Bert Olmstead,Canadiens,69,35,7,28
293,Bert Olmstead,Canadiens,69,45,17,28
293,Bert Olmstead,Canadiens,70,52,15,37
293,Bert Olmstead,Canadiens,70,58,10,48
293,Bert Olmstead,Canadiens,70,70,14,56
293,Bert Olmstead,Canadiens,64,48,15,33
293,Bert Olmstead,Canadiens,57,37,9,28
293,Bert Olmstead,Maple Leafs,70,41,10,31
293,Bert Olmstead,Maple Leafs,53,36,15,21
293,Bert Olmstead,Maple Leafs,67,52,18,34
293,Bert Olmstead,Maple Leafs,56,36,13,23
294,Brendan Morrison,Devils,11,9,5,4
294,Brendan Morrison,Devils,76,46,13,33
294,Brendan Morrison,Devils,44,26,5,21
294,Brendan Morrison,Canucks,12,9,2,7
294,Brendan Morrison,Canucks,82,54,16,38
294,Brendan Morrison,Canucks,82,67,23,44
294,Brendan Morrison,Canucks,82,71,25,46
294,Brendan Morrison,Canucks,82,60,22,38
294,Brendan Morrison,Canucks,82,56,19,37
294,Brendan Morrison,Canucks,82,51,20,31
294,Brendan Morrison,Canucks,39,25,9,16
294,Brendan Morrison,Ducks,62,22,10,12
294,Brendan Morrison,Stars,19,9,6,3
294,Brendan Morrison,Capitals,74,42,12,30
294,Brendan Morrison,Flames,66,43,9,34
294,Brendan Morrison,Flames,28,11,4,7
294,Brendan Morrison,Blackhawks,11,0,0,0
295,Garry Galley,Kings,78,38,8,30
295,Garry Galley,Kings,49,22,9,13
295,Garry Galley,Kings,30,16,5,11
295,Garry Galley,Capitals,18,11,1,10
295,Garry Galley,Capitals,58,30,7,23
295,Garry Galley,Bruins,78,30,8,22
295,Garry Galley,Bruins,71,35,8,27
295,Garry Galley,Bruins,70,27,6,21
295,Garry Galley,Bruins,38,14,2,12
295,Garry Galley,Flyers,39,18,3,15
295,Garry Galley,Flyers,83,62,13,49
295,Garry Galley,Flyers,81,70,10,60
295,Garry Galley,Flyers,33,22,2,20
295,Garry Galley,Sabres,14,10,1,9
295,Garry Galley,Sabres,78,54,10,44
295,Garry Galley,Sabres,71,38,4,34
295,Garry Galley,Kings,74,37,9,28
295,Garry Galley,Kings,60,16,4,12
295,Garry Galley,Kings,70,30,9,21
295,Garry Galley,Islanders,56,20,6,14
296,Michal Pivonka,Capitals,73,43,18,25
296,Michal Pivonka,Capitals,71,34,11,23
296,Michal Pivonka,Capitals,52,27,8,19
296,Michal Pivonka,Capitals,77,64,25,39
296,Michal Pivonka,Capitals,79,70,20,50
296,Michal Pivonka,Capitals,80,80,23,57
296,Michal Pivonka,Capitals,69,74,21,53
296,Michal Pivonka,Capitals,82,50,14,36
296,Michal Pivonka,Capitals,46,33,10,23
296,Michal Pivonka,Capitals,73,81,16,65
296,Michal Pivonka,Capitals,54,23,7,16
296,Michal Pivonka,Capitals,33,9,3,6
296,Michal Pivonka,Capitals,36,11,5,6
297,Simon Gagne,Flyers,80,48,20,28
297,Simon Gagne,Flyers,69,59,27,32
297,Simon Gagne,Flyers,79,66,33,33
297,Simon Gagne,Flyers,46,27,9,18
297,Simon Gagne,Flyers,80,45,24,21
297,Simon Gagne,Flyers,72,79,47,32
297,Simon Gagne,Flyers,76,68,41,27
297,Simon Gagne,Flyers,25,18,7,11
297,Simon Gagne,Flyers,79,74,34,40
297,Simon Gagne,Flyers,58,40,17,23
297,Simon Gagne,Lightning,63,40,17,23
297,Simon Gagne,Kings,34,17,7,10
297,Simon Gagne,Kings,11,5,0,5
297,Simon Gagne,Flyers,27,11,5,6
297,Simon Gagne,Bruins,10,1,1,0
298,Stu Barnes,Jets (1979),46,17,8,9
298,Stu Barnes,Jets (1979),38,22,12,10
298,Stu Barnes,Jets (1979),18,9,5,4
298,Stu Barnes,Panthers,59,38,18,20
298,Stu Barnes,Panthers,41,29,10,19
298,Stu Barnes,Panthers,72,44,19,25
298,Stu Barnes,Panthers,19,10,2,8
298,Stu Barnes,Penguins,62,39,17,22
298,Stu Barnes,Penguins,78,65,30,35
298,Stu Barnes,Penguins,64,32,20,12
298,Stu Barnes,Sabres,17,4,0,4
298,Stu Barnes,Sabres,82,45,20,25
298,Stu Barnes,Sabres,75,43,19,24
298,Stu Barnes,Sabres,68,48,17,31
298,Stu Barnes,Sabres,68,32,11,21
298,Stu Barnes,Stars,13,7,2,5
298,Stu Barnes,Stars,77,29,11,18
298,Stu Barnes,Stars,78,36,15,21
298,Stu Barnes,Stars,82,25,13,12
298,Stu Barnes,Stars,79,23,12,11
299,Dmitri Khristich,Capitals,40,27,13,14
299,Dmitri Khristich,Capitals,80,73,36,37
299,Dmitri Khristich,Capitals,64,66,31,35
299,Dmitri Khristich,Capitals,83,58,29,29
299,Dmitri Khristich,Capitals,48,26,12,14
299,Dmitri Khristich,Kings,76,64,27,37
299,Dmitri Khristich,Kings,75,56,19,37
299,Dmitri Khristich,Bruins,82,66,29,37
299,Dmitri Khristich,Bruins,79,71,29,42
299,Dmitri Khristich,Maple Leafs,53,30,12,18
299,Dmitri Khristich,Maple Leafs,27,9,3,6
299,Dmitri Khristich,Capitals,43,29,10,19
299,Dmitri Khristich,Capitals,61,21,9,12
300,Jean-Paul Parise,Bruins,3,0,0,0
300,Jean-Paul Parise,Bruins,18,4,2,2
300,Jean-Paul Parise,Maple Leafs,1,1,0,1
300,Jean-Paul Parise,North Stars,43,27,11,16
300,Jean-Paul Parise,North Stars,76,49,22,27
300,Jean-Paul Parise,North Stars,74,72,24,48
300,Jean-Paul Parise,North Stars,73,34,11,23
300,Jean-Paul Parise,North Stars,71,37,19,18
300,Jean-Paul Parise,North Stars,78,75,27,48
300,Jean-Paul Parise,North Stars,78,55,18,37
300,Jean-Paul Parise,North Stars,38,25,9,16
300,Jean-Paul Parise,Islanders,41,30,14,16
300,Jean-Paul Parise,Islanders,80,57,22,35
300,Jean-Paul Parise,Islanders,80,56,25,31
300,Jean-Paul Parise,Islanders,39,28,12,16
300,Jean-Paul Parise,Barons,40,22,9,13
300,Jean-Paul Parise,North Stars,57,22,13,9
301,Thomas Gradin,Canucks,76,51,20,31
301,Thomas Gradin,Canucks,80,75,30,45
301,Thomas Gradin,Canucks,79,69,21,48
301,Thomas Gradin,Canucks,76,86,37,49
301,Thomas Gradin,Canucks,80,86,32,54
301,Thomas Gradin,Canucks,75,78,21,57
301,Thomas Gradin,Canucks,76,64,22,42
301,Thomas Gradin,Canucks,71,41,14,27
301,Thomas Gradin,Bruins,64,43,12,31
302,Reginald MacAdam,Flyers,5,0,0,0
302,Reginald MacAdam,Seals,80,43,18,25
302,Reginald MacAdam,Seals,80,63,32,31
302,Reginald MacAdam,Barons,80,63,22,41
302,Reginald MacAdam,Barons,80,48,16,32
302,Reginald MacAdam,North Stars,69,58,24,34
302,Reginald MacAdam,North Stars,80,93,42,51
302,Reginald MacAdam,North Stars,78,60,21,39
302,Reginald MacAdam,North Stars,79,61,18,43
302,Reginald MacAdam,North Stars,73,33,11,22
302,Reginald MacAdam,North Stars,80,35,22,13
302,Reginald MacAdam,Canucks,80,34,14,20
303,Radek Dvorak,Panthers,77,27,13,14
303,Radek Dvorak,Panthers,78,39,18,21
303,Radek Dvorak,Panthers,64,36,12,24
303,Radek Dvorak,Panthers,82,43,19,24
303,Radek Dvorak,Panthers,35,17,7,10
303,Radek Dvorak,Rangers,46,33,11,22
303,Radek Dvorak,Rangers,82,67,31,36
303,Radek Dvorak,Rangers,65,37,17,20
303,Radek Dvorak,Rangers,63,27,6,21
303,Radek Dvorak,Oilers,12,8,4,4
303,Radek Dvorak,Oilers,78,50,15,35
303,Radek Dvorak,Oilers,64,28,8,20
303,Radek Dvorak,Blues,82,37,10,27
303,Radek Dvorak,Panthers,67,17,8,9
303,Radek Dvorak,Panthers,81,36,15,21
303,Radek Dvorak,Panthers,76,32,14,18
303,Radek Dvorak,Panthers,53,21,7,14
303,Radek Dvorak,Thrashers,13,1,0,1
303,Radek Dvorak,Stars,73,21,4,17
303,Radek Dvorak,Ducks,9,4,4,0
303,Radek Dvorak,Hurricanes,60,9,4,5
304,Donnie Marshall,Canadiens,1,0,0,0
304,Donnie Marshall,Canadiens,39,8,5,3
304,Donnie Marshall,Canadiens,66,5,4,1
304,Donnie Marshall,Canadiens,70,20,12,8
304,Donnie Marshall,Canadiens,68,41,22,19
304,Donnie Marshall,Canadiens,70,32,10,22
304,Donnie Marshall,Canadiens,70,38,16,22
304,Donnie Marshall,Canadiens,70,31,14,17
304,Donnie Marshall,Canadiens,66,46,18,28
304,Donnie Marshall,Canadiens,65,33,13,20
304,Donnie Marshall,Rangers,70,23,11,12
304,Donnie Marshall,Rangers,69,35,20,15
304,Donnie Marshall,Rangers,69,54,26,28
304,Donnie Marshall,Rangers,70,46,24,22
304,Donnie Marshall,Rangers,70,49,19,30
304,Donnie Marshall,Rangers,74,39,20,19
304,Donnie Marshall,Rangers,57,24,9,15
304,Donnie Marshall,Sabres,62,49,20,29
304,Donnie Marshall,Maple Leafs,50,16,2,14
305,Claude Provost,Canadiens,60,29,13,16
305,Claude Provost,Canadiens,67,30,16,14
305,Claude Provost,Canadiens,70,51,19,32
305,Claude Provost,Canadiens,69,38,16,22
305,Claude Provost,Canadiens,70,46,17,29
305,Claude Provost,Canadiens,49,15,11,4
305,Claude Provost,Canadiens,70,62,33,29
305,Claude Provost,Canadiens,67,50,20,30
305,Claude Provost,Canadiens,68,32,15,17
305,Claude Provost,Canadiens,70,64,27,37
305,Claude Provost,Canadiens,70,55,19,36
305,Claude Provost,Canadiens,64,24,11,13
305,Claude Provost,Canadiens,73,44,14,30
305,Claude Provost,Canadiens,73,28,13,15
305,Claude Provost,Canadiens,65,21,10,11
306,Patrik Sundstrom,Canucks,74,46,23,23
306,Patrik Sundstrom,Canucks,78,91,38,53
306,Patrik Sundstrom,Canucks,71,68,25,43
306,Patrik Sundstrom,Canucks,79,66,18,48
306,Patrik Sundstrom,Canucks,72,71,29,42
306,Patrik Sundstrom,Devils,78,51,15,36
306,Patrik Sundstrom,Devils,65,69,28,41
306,Patrik Sundstrom,Devils,74,76,27,49
306,Patrik Sundstrom,Devils,71,46,15,31
306,Patrik Sundstrom,Devils,17,4,1,3
307,Carol Vadnais,Canadiens,11,3,0,3
307,Carol Vadnais,Canadiens,31,2,1,1
307,Carol Vadnais,Seals,76,42,15,27
307,Carol Vadnais,Seals,76,44,24,20
307,Carol Vadnais,Seals,42,26,10,16
307,Carol Vadnais,Seals,52,34,14,20
307,Carol Vadnais,Bruins,16,10,4,6
307,Carol Vadnais,Bruins,78,31,7,24
307,Carol Vadnais,Bruins,78,59,16,43
307,Carol Vadnais,Bruins,79,74,18,56
307,Carol Vadnais,Bruins,12,7,2,5
307,Carol Vadnais,Rangers,64,50,20,30
307,Carol Vadnais,Rangers,74,48,11,37
307,Carol Vadnais,Rangers,80,46,6,40
307,Carol Vadnais,Rangers,77,45,8,37
307,Carol Vadnais,Rangers,66,23,3,20
307,Carol Vadnais,Rangers,74,23,3,20
307,Carol Vadnais,Rangers,50,11,5,6
307,Carol Vadnais,Devils,51,9,2,7
308,Steve Vickers,Rangers,61,53,30,23
308,Steve Vickers,Rangers,75,58,34,24
308,Steve Vickers,Rangers,80,89,41,48
308,Steve Vickers,Rangers,80,83,30,53
308,Steve Vickers,Rangers,75,53,22,31
308,Steve Vickers,Rangers,79,63,19,44
308,Steve Vickers,Rangers,66,47,13,34
308,Steve Vickers,Rangers,75,62,29,33
308,Steve Vickers,Rangers,73,58,19,39
308,Steve Vickers,Rangers,34,20,9,11
309,Mario Tremblay,Canadiens,63,39,21,18
309,Mario Tremblay,Canadiens,71,27,11,16
309,Mario Tremblay,Canadiens,74,46,18,28
309,Mario Tremblay,Canadiens,56,24,10,14
309,Mario Tremblay,Canadiens,76,59,30,29
309,Mario Tremblay,Canadiens,77,42,16,26
309,Mario Tremblay,Canadiens,77,63,25,38
309,Mario Tremblay,Canadiens,80,73,33,40
309,Mario Tremblay,Canadiens,80,67,30,37
309,Mario Tremblay,Canadiens,67,39,14,25
309,Mario Tremblay,Canadiens,75,66,31,35
309,Mario Tremblay,Canadiens,56,39,19,20
310,Troy Murray,Blackhawks,1,0,0,0
310,Troy Murray,Blackhawks,54,16,8,8
310,Troy Murray,Blackhawks,61,30,15,15
310,Troy Murray,Blackhawks,80,66,26,40
310,Troy Murray,Blackhawks,80,99,45,54
310,Troy Murray,Blackhawks,77,71,28,43
310,Troy Murray,Blackhawks,79,58,22,36
310,Troy Murray,Blackhawks,79,51,21,30
310,Troy Murray,Blackhawks,68,55,17,38
310,Troy Murray,Blackhawks,75,37,14,23
310,Troy Murray,Jets (1979),74,47,17,30
310,Troy Murray,Jets (1979),29,7,3,4
310,Troy Murray,Blackhawks,22,4,1,3
310,Troy Murray,Blackhawks,12,1,0,1
310,Troy Murray,Senators,15,5,2,3
310,Troy Murray,Senators,33,14,4,10
310,Troy Murray,Penguins,13,2,0,2
310,Troy Murray,Avalanche,63,21,7,14
311,Keith Acton,Canadiens,2,1,0,1
311,Keith Acton,Canadiens,61,39,15,24
311,Keith Acton,Canadiens,78,88,36,52
311,Keith Acton,Canadiens,78,50,24,26
311,Keith Acton,Canadiens,9,10,3,7
311,Keith Acton,North Stars,62,55,17,38
311,Keith Acton,North Stars,78,58,20,38
311,Keith Acton,North Stars,79,58,26,32
311,Keith Acton,North Stars,78,45,16,29
311,Keith Acton,North Stars,46,19,8,11
311,Keith Acton,Oilers,26,9,3,6
311,Keith Acton,Oilers,46,26,11,15
311,Keith Acton,Flyers,25,13,3,10
311,Keith Acton,Flyers,69,27,13,14
311,Keith Acton,Flyers,76,37,14,23
311,Keith Acton,Flyers,50,17,7,10
311,Keith Acton,Flyers,83,23,8,15
311,Keith Acton,Capitals,6,0,0,0
311,Keith Acton,Islanders,71,9,2,7
312,Jeff Brown,Nordiques,8,5,3,2
312,Jeff Brown,Nordiques,44,29,7,22
312,Jeff Brown,Nordiques,78,52,16,36
312,Jeff Brown,Nordiques,78,68,21,47
312,Jeff Brown,Nordiques,29,16,6,10
312,Jeff Brown,Blues,48,38,10,28
312,Jeff Brown,Blues,67,59,12,47
312,Jeff Brown,Blues,80,59,20,39
312,Jeff Brown,Blues,71,78,25,53
312,Jeff Brown,Blues,63,60,13,47
312,Jeff Brown,Canucks,11,6,1,5
312,Jeff Brown,Canucks,33,31,8,23
312,Jeff Brown,Canucks,28,17,1,16
312,Jeff Brown,Whalers,48,38,7,31
312,Jeff Brown,Whalers,1,0,0,0
312,Jeff Brown,Hurricanes,32,13,3,10
312,Jeff Brown,Maple Leafs,19,9,1,8
312,Jeff Brown,Capitals,9,6,0,6
313,Robert Bourne,Islanders,77,39,16,23
313,Robert Bourne,Islanders,14,5,2,3
313,Robert Bourne,Islanders,75,35,16,19
313,Robert Bourne,Islanders,80,63,30,33
313,Robert Bourne,Islanders,80,61,30,31
313,Robert Bourne,Islanders,73,40,15,25
313,Robert Bourne,Islanders,78,76,35,41
313,Robert Bourne,Islanders,76,53,27,26
313,Robert Bourne,Islanders,77,62,20,42
313,Robert Bourne,Islanders,78,56,22,34
313,Robert Bourne,Islanders,44,20,8,12
313,Robert Bourne,Islanders,62,32,17,15
313,Robert Bourne,Kings,78,22,13,9
313,Robert Bourne,Kings,72,18,7,11
314,Don McKenney,Bruins,69,42,22,20
314,Don McKenney,Bruins,65,34,10,24
314,Don McKenney,Bruins,69,60,21,39
314,Don McKenney,Bruins,70,58,28,30
314,Don McKenney,Bruins,70,62,32,30
314,Don McKenney,Bruins,70,69,20,49
314,Don McKenney,Bruins,68,49,26,23
314,Don McKenney,Bruins,70,55,22,33
314,Don McKenney,Bruins,41,33,14,19
314,Don McKenney,Rangers,21,24,8,16
314,Don McKenney,Rangers,55,26,9,17
314,Don McKenney,Maple Leafs,15,15,9,6
314,Don McKenney,Maple Leafs,52,19,6,13
314,Don McKenney,Red Wings,24,7,1,6
314,Don McKenney,Blues,39,29,9,20
315,Martin Havlat,Senators,73,42,19,23
315,Martin Havlat,Senators,72,50,22,28
315,Martin Havlat,Senators,67,59,24,35
315,Martin Havlat,Senators,68,68,31,37
315,Martin Havlat,Senators,18,16,9,7
315,Martin Havlat,Blackhawks,56,57,25,32
315,Martin Havlat,Blackhawks,35,27,10,17
315,Martin Havlat,Blackhawks,81,77,29,48
315,Martin Havlat,Wild,73,54,18,36
315,Martin Havlat,Wild,78,62,22,40
315,Martin Havlat,Sharks,39,27,7,20
315,Martin Havlat,Sharks,40,18,8,10
315,Martin Havlat,Sharks,48,22,12,10
315,Martin Havlat,Devils,5,3,1,2
316,David Legwand,Predators,1,0,0,0
316,David Legwand,Predators,71,28,13,15
316,David Legwand,Predators,81,41,13,28
316,David Legwand,Predators,63,30,11,19
316,David Legwand,Predators,64,48,17,31
316,David Legwand,Predators,82,47,18,29
316,David Legwand,Predators,44,26,7,19
316,David Legwand,Predators,78,63,27,36
316,David Legwand,Predators,65,44,15,29
316,David Legwand,Predators,73,42,20,22
316,David Legwand,Predators,82,38,11,27
316,David Legwand,Predators,64,41,17,24
316,David Legwand,Predators,78,53,19,34
316,David Legwand,Predators,48,25,12,13
316,David Legwand,Predators,62,40,10,30
316,David Legwand,Red Wings,21,11,4,7
316,David Legwand,Senators,12,5,2,3
317,Tom Fergus,Bruins,61,39,15,24
317,Tom Fergus,Bruins,80,63,28,35
317,Tom Fergus,Bruins,69,61,25,36
317,Tom Fergus,Bruins,79,73,30,43
317,Tom Fergus,Maple Leafs,78,73,31,42
317,Tom Fergus,Maple Leafs,57,49,21,28
317,Tom Fergus,Maple Leafs,63,50,19,31
317,Tom Fergus,Maple Leafs,80,67,22,45
317,Tom Fergus,Maple Leafs,54,45,19,26
317,Tom Fergus,Maple Leafs,14,9,5,4
317,Tom Fergus,Maple Leafs,11,4,1,3
317,Tom Fergus,Canucks,44,34,14,20
317,Tom Fergus,Canucks,36,14,5,9
318,Fredrik Olausson,Jets (1979),72,36,7,29
318,Fredrik Olausson,Jets (1979),38,15,5,10
318,Fredrik Olausson,Jets (1979),75,62,15,47
318,Fredrik Olausson,Jets (1979),77,55,9,46
318,Fredrik Olausson,Jets (1979),71,41,12,29
318,Fredrik Olausson,Jets (1979),77,62,20,42
318,Fredrik Olausson,Jets (1979),68,57,16,41
318,Fredrik Olausson,Jets (1979),18,7,2,5
318,Fredrik Olausson,Oilers,55,28,9,19
318,Fredrik Olausson,Oilers,33,10,0,10
318,Fredrik Olausson,Oilers,20,6,0,6
318,Fredrik Olausson,Ducks,36,18,2,16
318,Fredrik Olausson,Ducks,20,11,2,9
318,Fredrik Olausson,Penguins,51,27,7,20
318,Fredrik Olausson,Penguins,76,33,6,27
318,Fredrik Olausson,Ducks,74,56,16,40
318,Fredrik Olausson,Ducks,70,34,15,19
318,Fredrik Olausson,Red Wings,47,15,2,13
318,Fredrik Olausson,Ducks,44,8,2,6
319,Shawn McEachern,Penguins,15,4,0,4
319,Shawn McEachern,Penguins,84,61,28,33
319,Shawn McEachern,Kings,49,21,8,13
319,Shawn McEachern,Penguins,27,21,12,9
319,Shawn McEachern,Penguins,44,26,13,13
319,Shawn McEachern,Bruins,82,53,24,29
319,Shawn McEachern,Senators,65,31,11,20
319,Shawn McEachern,Senators,81,48,24,24
319,Shawn McEachern,Senators,77,56,31,25
319,Shawn McEachern,Senators,69,51,29,22
319,Shawn McEachern,Senators,82,72,32,40
319,Shawn McEachern,Senators,80,46,15,31
319,Shawn McEachern,Thrashers,46,26,10,16
319,Shawn McEachern,Thrashers,82,55,17,38
319,Shawn McEachern,Bruins,28,8,2,6
320,Laurie Boschman,Maple Leafs,80,48,16,32
320,Laurie Boschman,Maple Leafs,53,33,14,19
320,Laurie Boschman,Maple Leafs,54,28,9,19
320,Laurie Boschman,Oilers,11,5,2,3
320,Laurie Boschman,Oilers,62,20,8,12
320,Laurie Boschman,Jets (1979),12,8,3,5
320,Laurie Boschman,Jets (1979),61,74,28,46
320,Laurie Boschman,Jets (1979),80,76,32,44
320,Laurie Boschman,Jets (1979),77,69,27,42
320,Laurie Boschman,Jets (1979),80,41,17,24
320,Laurie Boschman,Jets (1979),80,48,25,23
320,Laurie Boschman,Jets (1979),70,36,10,26
320,Laurie Boschman,Jets (1979),66,27,10,17
320,Laurie Boschman,Devils,78,20,11,9
320,Laurie Boschman,Devils,75,28,8,20
320,Laurie Boschman,Senators,70,16,9,7
321,Bob MacMillan,Rangers,22,3,1,2
321,Bob MacMillan,Blues,80,52,20,32
321,Bob MacMillan,Blues,80,58,19,39
321,Bob MacMillan,Blues,28,19,7,12
321,Bob MacMillan,Flames,52,52,31,21
321,Bob MacMillan,Flames,79,108,37,71
321,Bob MacMillan,Flames,77,61,22,39
321,Bob MacMillan,Flames,77,63,28,35
321,Bob MacMillan,Flames,23,11,4,7
321,Bob MacMillan,Rockies,57,50,18,32
321,Bob MacMillan,Devils,71,48,19,29
321,Bob MacMillan,Devils,71,40,17,23
321,Bob MacMillan,Blackhawks,36,12,5,7
322,Dainius Zubrus,Flyers,68,21,8,13
322,Dainius Zubrus,Flyers,69,33,8,25
322,Dainius Zubrus,Flyers,63,8,3,5
322,Dainius Zubrus,Canadiens,17,8,3,5
322,Dainius Zubrus,Canadiens,73,42,14,28
322,Dainius Zubrus,Canadiens,49,24,12,12
322,Dainius Zubrus,Capitals,12,2,1,1
322,Dainius Zubrus,Capitals,71,43,17,26
322,Dainius Zubrus,Capitals,63,35,13,22
322,Dainius Zubrus,Capitals,54,27,12,15
322,Dainius Zubrus,Capitals,71,57,23,34
322,Dainius Zubrus,Capitals,60,52,20,32
322,Dainius Zubrus,Sabres,19,8,4,4
322,Dainius Zubrus,Devils,82,38,13,25
322,Dainius Zubrus,Devils,82,40,15,25
322,Dainius Zubrus,Devils,51,27,10,17
322,Dainius Zubrus,Devils,79,30,13,17
322,Dainius Zubrus,Devils,82,44,17,27
322,Dainius Zubrus,Devils,22,9,2,7
322,Dainius Zubrus,Devils,82,26,13,13
322,Dainius Zubrus,Devils,14,2,2,0
323,Milt Schmidt,Bruins,26,10,2,8
323,Milt Schmidt,Bruins,44,27,13,14
323,Milt Schmidt,Bruins,41,32,15,17
323,Milt Schmidt,Bruins,48,52,22,30
323,Milt Schmidt,Bruins,45,38,13,25
323,Milt Schmidt,Bruins,36,35,14,21
323,Milt Schmidt,Bruins,48,31,13,18
323,Milt Schmidt,Bruins,59,62,27,35
323,Milt Schmidt,Bruins,33,26,9,17
323,Milt Schmidt,Bruins,44,32,10,22
323,Milt Schmidt,Bruins,68,41,19,22
323,Milt Schmidt,Bruins,62,61,22,39
323,Milt Schmidt,Bruins,69,50,21,29
323,Milt Schmidt,Bruins,68,34,11,23
323,Milt Schmidt,Bruins,62,32,14,18
323,Milt Schmidt,Bruins,23,12,4,8
324,Guy Chouinard,Flames,5,0,0,0
324,Guy Chouinard,Flames,4,2,0,2
324,Guy Chouinard,Flames,80,50,17,33
324,Guy Chouinard,Flames,73,58,28,30
324,Guy Chouinard,Flames,80,107,50,57
324,Guy Chouinard,Flames,76,77,31,46
324,Guy Chouinard,Flames,52,83,31,52
324,Guy Chouinard,Flames,64,80,23,57
324,Guy Chouinard,Flames,80,72,13,59
324,Guy Chouinard,Blues,64,46,12,34
325,Eric Desjardins,Canadiens,36,14,2,12
325,Eric Desjardins,Canadiens,55,16,3,13
325,Eric Desjardins,Canadiens,62,25,7,18
325,Eric Desjardins,Canadiens,77,38,6,32
325,Eric Desjardins,Canadiens,82,45,13,32
325,Eric Desjardins,Canadiens,84,35,12,23
325,Eric Desjardins,Canadiens,9,6,0,6
325,Eric Desjardins,Flyers,34,23,5,18
325,Eric Desjardins,Flyers,80,47,7,40
325,Eric Desjardins,Flyers,82,46,12,34
325,Eric Desjardins,Flyers,77,33,6,27
325,Eric Desjardins,Flyers,68,51,15,36
325,Eric Desjardins,Flyers,81,55,14,41
325,Eric Desjardins,Flyers,79,48,15,33
325,Eric Desjardins,Flyers,65,25,6,19
325,Eric Desjardins,Flyers,79,32,8,24
325,Eric Desjardins,Flyers,48,12,1,11
325,Eric Desjardins,Flyers,45,24,4,20
326,Eric Nesterenko,Maple Leafs,1,0,0,0
326,Eric Nesterenko,Maple Leafs,35,16,10,6
326,Eric Nesterenko,Maple Leafs,68,23,14,9
326,Eric Nesterenko,Maple Leafs,62,30,15,15
326,Eric Nesterenko,Maple Leafs,40,10,4,6
326,Eric Nesterenko,Blackhawks,24,23,8,15
326,Eric Nesterenko,Blackhawks,70,38,20,18
326,Eric Nesterenko,Blackhawks,70,34,16,18
326,Eric Nesterenko,Blackhawks,61,36,13,23
326,Eric Nesterenko,Blackhawks,68,38,19,19
326,Eric Nesterenko,Blackhawks,68,29,15,14
326,Eric Nesterenko,Blackhawks,67,27,12,15
326,Eric Nesterenko,Blackhawks,70,26,7,19
326,Eric Nesterenko,Blackhawks,56,30,14,16
326,Eric Nesterenko,Blackhawks,67,40,15,25
326,Eric Nesterenko,Blackhawks,68,37,14,23
326,Eric Nesterenko,Blackhawks,71,36,11,25
326,Eric Nesterenko,Blackhawks,72,32,15,17
326,Eric Nesterenko,Blackhawks,67,34,16,18
326,Eric Nesterenko,Blackhawks,76,23,8,15
326,Eric Nesterenko,Blackhawks,38,12,4,8
327,Petr Klima,Red Wings,74,56,32,24
327,Petr Klima,Red Wings,77,53,30,23
327,Petr Klima,Red Wings,78,62,37,25
327,Petr Klima,Red Wings,51,41,25,16
327,Petr Klima,Red Wings,13,10,5,5
327,Petr Klima,Oilers,63,53,25,28
327,Petr Klima,Oilers,70,68,40,28
327,Petr Klima,Oilers,57,34,21,13
327,Petr Klima,Oilers,68,48,32,16
327,Petr Klima,Lightning,75,55,28,27
327,Petr Klima,Lightning,47,26,13,13
327,Petr Klima,Lightning,67,52,22,30
327,Petr Klima,Kings,8,4,0,4
327,Petr Klima,Penguins,9,4,1,3
327,Petr Klima,Oilers,16,6,1,5
327,Petr Klima,Red Wings,13,1,1,0
328,Jim Pappin,Maple Leafs,50,19,11,8
328,Jim Pappin,Maple Leafs,44,18,9,9
328,Jim Pappin,Maple Leafs,7,3,0,3
328,Jim Pappin,Maple Leafs,64,32,21,11
328,Jim Pappin,Maple Leafs,58,28,13,15
328,Jim Pappin,Blackhawks,75,70,30,40
328,Jim Pappin,Blackhawks,66,53,28,25
328,Jim Pappin,Blackhawks,58,45,22,23
328,Jim Pappin,Blackhawks,64,48,27,21
328,Jim Pappin,Blackhawks,76,92,41,51
328,Jim Pappin,Blackhawks,78,73,32,41
328,Jim Pappin,Blackhawks,71,63,36,27
328,Jim Pappin,Seals,32,19,6,13
328,Jim Pappin,Barons,24,10,2,8
329,Dick Duff,Maple Leafs,3,0,0,0
329,Dick Duff,Maple Leafs,69,37,18,19
329,Dick Duff,Maple Leafs,70,40,26,14
329,Dick Duff,Maple Leafs,65,49,26,23
329,Dick Duff,Maple Leafs,69,53,29,24
329,Dick Duff,Maple Leafs,67,41,19,22
329,Dick Duff,Maple Leafs,67,33,16,17
329,Dick Duff,Maple Leafs,51,37,17,20
329,Dick Duff,Maple Leafs,69,35,16,19
329,Dick Duff,Maple Leafs,52,17,7,10
329,Dick Duff,Rangers,14,8,4,4
329,Dick Duff,Rangers,29,12,3,9
329,Dick Duff,Canadiens,40,16,9,7
329,Dick Duff,Canadiens,63,45,21,24
329,Dick Duff,Canadiens,51,23,12,11
329,Dick Duff,Canadiens,66,46,25,21
329,Dick Duff,Canadiens,68,40,19,21
329,Dick Duff,Canadiens,17,2,1,1
329,Dick Duff,Kings,32,13,5,8
329,Dick Duff,Kings,7,1,1,0
329,Dick Duff,Sabres,53,20,7,13
329,Dick Duff,Sabres,8,4,2,2
330,Joseph Juneau,Bruins,14,19,5,14
330,Joseph Juneau,Bruins,84,102,32,70
330,Joseph Juneau,Bruins,63,72,14,58
330,Joseph Juneau,Capitals,11,13,5,8
330,Joseph Juneau,Capitals,44,43,5,38
330,Joseph Juneau,Capitals,80,64,14,50
330,Joseph Juneau,Capitals,58,42,15,27
330,Joseph Juneau,Capitals,56,31,9,22
330,Joseph Juneau,Capitals,63,41,14,27
330,Joseph Juneau,Sabres,9,2,1,1
330,Joseph Juneau,Senators,65,37,13,24
330,Joseph Juneau,Coyotes,69,33,10,23
330,Joseph Juneau,Canadiens,70,36,8,28
330,Joseph Juneau,Canadiens,72,22,6,16
330,Joseph Juneau,Canadiens,70,15,5,10
331,Sergei Samsonov,Bruins,81,47,22,25
331,Sergei Samsonov,Bruins,79,51,25,26
331,Sergei Samsonov,Bruins,77,45,19,26
331,Sergei Samsonov,Bruins,82,75,29,46
331,Sergei Samsonov,Bruins,74,70,29,41
331,Sergei Samsonov,Bruins,8,11,5,6
331,Sergei Samsonov,Bruins,58,40,17,23
331,Sergei Samsonov,Bruins,55,37,18,19
331,Sergei Samsonov,Oilers,19,16,5,11
331,Sergei Samsonov,Canadiens,63,26,9,17
331,Sergei Samsonov,Blackhawks,23,4,0,4
331,Sergei Samsonov,Hurricanes,38,32,14,18
331,Sergei Samsonov,Hurricanes,81,48,16,32
331,Sergei Samsonov,Hurricanes,72,29,14,15
331,Sergei Samsonov,Hurricanes,58,26,10,16
331,Sergei Samsonov,Panthers,20,14,3,11
332,Kimmo Timonen,Predators,50,12,4,8
332,Kimmo Timonen,Predators,51,33,8,25
332,Kimmo Timonen,Predators,82,25,12,13
332,Kimmo Timonen,Predators,82,42,13,29
332,Kimmo Timonen,Predators,72,40,6,34
332,Kimmo Timonen,Predators,77,44,12,32
332,Kimmo Timonen,Predators,79,50,11,39
332,Kimmo Timonen,Predators,80,55,13,42
332,Kimmo Timonen,Flyers,80,44,8,36
332,Kimmo Timonen,Flyers,77,43,3,40
332,Kimmo Timonen,Flyers,82,39,6,33
332,Kimmo Timonen,Flyers,82,37,6,31
332,Kimmo Timonen,Flyers,76,43,4,39
332,Kimmo Timonen,Flyers,45,29,5,24
332,Kimmo Timonen,Flyers,77,35,6,29
333,Mike Krushelnyski,Bruins,17,6,3,3
333,Mike Krushelnyski,Bruins,79,65,23,42
333,Mike Krushelnyski,Bruins,66,45,25,20
333,Mike Krushelnyski,Oilers,80,88,43,45
333,Mike Krushelnyski,Oilers,54,40,16,24
333,Mike Krushelnyski,Oilers,80,51,16,35
333,Mike Krushelnyski,Oilers,76,47,20,27
333,Mike Krushelnyski,Kings,78,62,26,36
333,Mike Krushelnyski,Kings,63,41,16,25
333,Mike Krushelnyski,Kings,15,6,1,5
333,Mike Krushelnyski,Maple Leafs,59,39,17,22
333,Mike Krushelnyski,Maple Leafs,72,24,9,15
333,Mike Krushelnyski,Maple Leafs,84,39,19,20
333,Mike Krushelnyski,Maple Leafs,54,11,5,6
333,Mike Krushelnyski,Red Wings,20,5,2,3
334,Brenden Morrow,Stars,64,33,14,19
334,Brenden Morrow,Stars,82,44,20,24
334,Brenden Morrow,Stars,72,35,17,18
334,Brenden Morrow,Stars,71,43,21,22
334,Brenden Morrow,Stars,81,49,25,24
334,Brenden Morrow,Stars,81,65,23,42
334,Brenden Morrow,Stars,40,31,16,15
334,Brenden Morrow,Stars,82,74,32,42
334,Brenden Morrow,Stars,18,15,5,10
334,Brenden Morrow,Stars,76,46,20,26
334,Brenden Morrow,Stars,82,56,33,23
334,Brenden Morrow,Stars,57,26,11,15
334,Brenden Morrow,Stars,29,11,6,5
334,Brenden Morrow,Penguins,15,14,6,8
334,Brenden Morrow,Blues,71,25,13,12
334,Brenden Morrow,Lightning,13,1,0,1
335,Chris Gratton,Lightning,84,42,13,29
335,Chris Gratton,Lightning,46,27,7,20
335,Chris Gratton,Lightning,82,38,17,21
335,Chris Gratton,Lightning,82,62,30,32
335,Chris Gratton,Flyers,82,62,22,40
335,Chris Gratton,Flyers,26,8,1,7
335,Chris Gratton,Lightning,52,26,7,19
335,Chris Gratton,Lightning,58,41,14,27
335,Chris Gratton,Sabres,14,8,1,7
335,Chris Gratton,Sabres,82,40,19,21
335,Chris Gratton,Sabres,82,39,15,24
335,Chris Gratton,Sabres,66,44,15,29
335,Chris Gratton,Coyotes,14,1,0,1
335,Chris Gratton,Coyotes,68,29,11,18
335,Chris Gratton,Avalanche,13,3,2,1
335,Chris Gratton,Panthers,76,39,17,22
335,Chris Gratton,Panthers,81,35,13,22
335,Chris Gratton,Lightning,60,21,10,11
335,Chris Gratton,Lightning,18,2,0,2
335,Chris Gratton,Blue Jackets,6,1,0,1
336,David Ellett,Jets (1979),80,38,11,27
336,David Ellett,Jets (1979),80,46,15,31
336,David Ellett,Jets (1979),78,44,13,31
336,David Ellett,Jets (1979),68,58,13,45
336,David Ellett,Jets (1979),75,56,22,34
336,David Ellett,Jets (1979),77,46,17,29
336,David Ellett,Jets (1979),17,11,4,7
336,David Ellett,Maple Leafs,60,38,8,30
336,David Ellett,Maple Leafs,79,51,18,33
336,David Ellett,Maple Leafs,70,40,6,34
336,David Ellett,Maple Leafs,68,43,7,36
336,David Ellett,Maple Leafs,33,15,5,10
336,David Ellett,Maple Leafs,80,22,3,19
336,David Ellett,Maple Leafs,56,14,4,10
336,David Ellett,Devils,20,7,2,5
336,David Ellett,Bruins,82,23,3,20
336,David Ellett,Bruins,54,6,0,6
336,David Ellett,Blues,52,10,2,8
337,Bill Gadsby,Blackhawks,48,18,8,10
337,Bill Gadsby,Blackhawks,60,16,6,10
337,Bill Gadsby,Blackhawks,50,13,3,10
337,Bill Gadsby,Blackhawks,70,35,10,25
337,Bill Gadsby,Blackhawks,25,10,3,7
337,Bill Gadsby,Blackhawks,59,22,7,15
337,Bill Gadsby,Blackhawks,68,22,2,20
337,Bill Gadsby,Blackhawks,70,41,12,29
337,Bill Gadsby,Blackhawks,18,8,3,5
337,Bill Gadsby,Rangers,52,16,8,8
337,Bill Gadsby,Rangers,70,51,9,42
337,Bill Gadsby,Rangers,70,41,4,37
337,Bill Gadsby,Rangers,65,46,14,32
337,Bill Gadsby,Rangers,70,51,5,46
337,Bill Gadsby,Rangers,65,31,9,22
337,Bill Gadsby,Rangers,65,35,9,26
337,Bill Gadsby,Red Wings,70,37,7,30
337,Bill Gadsby,Red Wings,70,28,4,24
337,Bill Gadsby,Red Wings,64,18,2,16
337,Bill Gadsby,Red Wings,61,12,0,12
337,Bill Gadsby,Red Wings,58,17,5,12
338,David Lonsberry,Bruins,8,1,0,1
338,David Lonsberry,Bruins,19,4,2,2
338,David Lonsberry,Bruins,6,0,0,0
338,David Lonsberry,Kings,76,42,20,22
338,David Lonsberry,Kings,76,53,25,28
338,David Lonsberry,Kings,50,23,9,14
338,David Lonsberry,Flyers,32,14,7,7
338,David Lonsberry,Flyers,77,50,21,29
338,David Lonsberry,Flyers,75,51,32,19
338,David Lonsberry,Flyers,80,49,24,25
338,David Lonsberry,Flyers,80,47,19,28
338,David Lonsberry,Flyers,75,55,23,32
338,David Lonsberry,Flyers,78,48,18,30
338,David Lonsberry,Penguins,80,46,24,22
338,David Lonsberry,Penguins,76,33,15,18
338,David Lonsberry,Penguins,80,50,17,33
339,Wendel Clark,Maple Leafs,66,45,34,11
339,Wendel Clark,Maple Leafs,80,60,37,23
339,Wendel Clark,Maple Leafs,28,23,12,11
339,Wendel Clark,Maple Leafs,15,11,7,4
339,Wendel Clark,Maple Leafs,38,26,18,8
339,Wendel Clark,Maple Leafs,63,34,18,16
339,Wendel Clark,Maple Leafs,43,40,19,21
339,Wendel Clark,Maple Leafs,66,39,17,22
339,Wendel Clark,Maple Leafs,64,76,46,30
339,Wendel Clark,Nordiques,37,30,12,18
339,Wendel Clark,Islanders,58,43,24,19
339,Wendel Clark,Maple Leafs,13,15,8,7
339,Wendel Clark,Maple Leafs,65,49,30,19
339,Wendel Clark,Maple Leafs,47,19,12,7
339,Wendel Clark,Lightning,65,42,28,14
339,Wendel Clark,Red Wings,12,6,4,2
339,Wendel Clark,Blackhawks,13,2,2,0
339,Wendel Clark,Maple Leafs,20,4,2,2
340,Thomas Vanek,Sabres,81,48,25,23
340,Thomas Vanek,Sabres,82,84,43,41
340,Thomas Vanek,Sabres,82,64,36,28
340,Thomas Vanek,Sabres,73,64,40,24
340,Thomas Vanek,Sabres,71,53,28,25
340,Thomas Vanek,Sabres,80,73,32,41
340,Thomas Vanek,Sabres,78,61,26,35
340,Thomas Vanek,Sabres,38,41,20,21
340,Thomas Vanek,Sabres,13,9,4,5
340,Thomas Vanek,Islanders,47,44,17,27
340,Thomas Vanek,Canadiens,18,15,6,9
340,Thomas Vanek,Wild,12,8,1,7
341,Don Maloney,Rangers,28,26,9,17
341,Don Maloney,Rangers,79,73,25,48
341,Don Maloney,Rangers,61,52,29,23
341,Don Maloney,Rangers,54,58,22,36
341,Don Maloney,Rangers,78,69,29,40
341,Don Maloney,Rangers,79,66,24,42
341,Don Maloney,Rangers,37,27,11,16
341,Don Maloney,Rangers,68,28,11,17
341,Don Maloney,Rangers,72,57,19,38
341,Don Maloney,Rangers,66,33,12,21
341,Don Maloney,Rangers,31,13,4,9
341,Don Maloney,Whalers,21,14,3,11
341,Don Maloney,Islanders,79,43,16,27
341,Don Maloney,Islanders,12,5,0,5
342,Sandis Ozolinsh,Sharks,37,23,7,16
342,Sandis Ozolinsh,Sharks,81,64,26,38
342,Sandis Ozolinsh,Sharks,48,25,9,16
342,Sandis Ozolinsh,Sharks,7,4,1,3
342,Sandis Ozolinsh,Avalanche,66,50,13,37
342,Sandis Ozolinsh,Avalanche,80,68,23,45
342,Sandis Ozolinsh,Avalanche,66,51,13,38
342,Sandis Ozolinsh,Avalanche,39,32,7,25
342,Sandis Ozolinsh,Avalanche,82,52,16,36
342,Sandis Ozolinsh,Hurricanes,72,44,12,32
342,Sandis Ozolinsh,Hurricanes,46,23,4,19
342,Sandis Ozolinsh,Panthers,37,29,10,19
342,Sandis Ozolinsh,Panthers,51,26,7,19
342,Sandis Ozolinsh,Ducks,31,18,5,13
342,Sandis Ozolinsh,Ducks,36,16,5,11
342,Sandis Ozolinsh,Ducks,17,6,3,3
342,Sandis Ozolinsh,Rangers,19,14,3,11
342,Sandis Ozolinsh,Rangers,21,3,0,3
342,Sandis Ozolinsh,Sharks,39,16,3,13
343,Rob Ramage,Rockies,75,28,8,20
343,Rob Ramage,Rockies,79,62,20,42
343,Rob Ramage,Rockies,80,42,13,29
343,Rob Ramage,Blues,78,51,16,35
343,Rob Ramage,Blues,80,60,15,45
343,Rob Ramage,Blues,80,38,7,31
343,Rob Ramage,Blues,77,66,10,56
343,Rob Ramage,Blues,59,39,11,28
343,Rob Ramage,Blues,67,42,8,34
343,Rob Ramage,Flames,12,7,1,6
343,Rob Ramage,Flames,68,16,3,13
343,Rob Ramage,Maple Leafs,80,49,8,41
343,Rob Ramage,Maple Leafs,80,35,10,25
343,Rob Ramage,North Stars,34,9,4,5
343,Rob Ramage,Lightning,66,17,5,12
343,Rob Ramage,Canadiens,8,1,0,1
343,Rob Ramage,Canadiens,6,1,0,1
343,Rob Ramage,Flyers,15,1,0,1
344,Tomas Kaberle,Maple Leafs,57,22,4,18
344,Tomas Kaberle,Maple Leafs,82,40,7,33
344,Tomas Kaberle,Maple Leafs,82,45,6,39
344,Tomas Kaberle,Maple Leafs,69,39,10,29
344,Tomas Kaberle,Maple Leafs,82,47,11,36
344,Tomas Kaberle,Maple Leafs,71,31,3,28
344,Tomas Kaberle,Maple Leafs,82,67,9,58
344,Tomas Kaberle,Maple Leafs,74,58,11,47
344,Tomas Kaberle,Maple Leafs,82,53,8,45
344,Tomas Kaberle,Maple Leafs,57,31,4,27
344,Tomas Kaberle,Maple Leafs,82,49,7,42
344,Tomas Kaberle,Maple Leafs,58,38,3,35
344,Tomas Kaberle,Bruins,24,9,1,8
344,Tomas Kaberle,Hurricanes,29,9,0,9
344,Tomas Kaberle,Canadiens,43,22,3,19
344,Tomas Kaberle,Canadiens,10,3,0,3
345,Corey Perry,Ducks,56,25,13,12
345,Corey Perry,Ducks,82,44,17,27
345,Corey Perry,Ducks,70,54,29,25
345,Corey Perry,Ducks,78,72,32,40
345,Corey Perry,Ducks,82,76,27,49
345,Corey Perry,Ducks,82,98,50,48
345,Corey Perry,Ducks,80,60,37,23
345,Corey Perry,Ducks,44,36,15,21
345,Corey Perry,Ducks,81,82,43,39
345,Corey Perry,Ducks,13,15,11,4
346,James Carson,Kings,80,79,37,42
346,James Carson,Kings,80,107,55,52
346,James Carson,Oilers,80,100,49,51
346,James Carson,Oilers,4,3,1,2
346,James Carson,Red Wings,44,36,20,16
346,James Carson,Red Wings,64,46,21,25
346,James Carson,Red Wings,80,69,34,35
346,James Carson,Red Wings,52,51,25,26
346,James Carson,Kings,34,22,12,10
346,James Carson,Kings,25,11,4,7
346,James Carson,Canucks,34,17,7,10
346,James Carson,Whalers,38,19,9,10
346,James Carson,Whalers,11,1,1,0
347,Dan Boyle,Panthers,22,8,3,5
347,Dan Boyle,Panthers,13,3,0,3
347,Dan Boyle,Panthers,69,22,4,18
347,Dan Boyle,Panthers,25,6,3,3
347,Dan Boyle,Lightning,41,20,5,15
347,Dan Boyle,Lightning,77,53,13,40
347,Dan Boyle,Lightning,78,39,9,30
347,Dan Boyle,Lightning,79,53,15,38
347,Dan Boyle,Lightning,82,63,20,43
347,Dan Boyle,Lightning,37,25,4,21
347,Dan Boyle,Sharks,77,57,16,41
347,Dan Boyle,Sharks,76,58,15,43
347,Dan Boyle,Sharks,76,50,9,41
347,Dan Boyle,Sharks,81,48,9,39
347,Dan Boyle,Sharks,46,20,7,13
347,Dan Boyle,Sharks,75,36,12,24
347,Dan Boyle,Rangers,1,0,0,0
348,Tony Tanti,Blackhawks,2,0,0,0
348,Tony Tanti,Blackhawks,1,1,1,0
348,Tony Tanti,Canucks,39,16,8,8
348,Tony Tanti,Canucks,79,86,45,41
348,Tony Tanti,Canucks,68,59,39,20
348,Tony Tanti,Canucks,77,72,39,33
348,Tony Tanti,Canucks,77,79,41,38
348,Tony Tanti,Canucks,73,77,40,37
348,Tony Tanti,Canucks,77,49,24,25
348,Tony Tanti,Canucks,41,32,14,18
348,Tony Tanti,Penguins,37,32,14,18
348,Tony Tanti,Penguins,46,18,6,12
348,Tony Tanti,Sabres,10,8,1,7
348,Tony Tanti,Sabres,70,31,15,16
349,Ted Kennedy,Maple Leafs,2,1,0,1
349,Ted Kennedy,Maple Leafs,49,49,26,23
349,Ted Kennedy,Maple Leafs,49,54,29,25
349,Ted Kennedy,Maple Leafs,21,5,3,2
349,Ted Kennedy,Maple Leafs,60,60,28,32
349,Ted Kennedy,Maple Leafs,60,46,25,21
349,Ted Kennedy,Maple Leafs,59,39,18,21
349,Ted Kennedy,Maple Leafs,53,44,20,24
349,Ted Kennedy,Maple Leafs,63,61,18,43
349,Ted Kennedy,Maple Leafs,70,52,19,33
349,Ted Kennedy,Maple Leafs,43,37,14,23
349,Ted Kennedy,Maple Leafs,67,38,15,23
349,Ted Kennedy,Maple Leafs,70,52,10,42
349,Ted Kennedy,Maple Leafs,30,22,6,16
350,Paul Reinhart,Flames,79,47,9,38
350,Paul Reinhart,Flames,74,67,18,49
350,Paul Reinhart,Flames,62,61,13,48
350,Paul Reinhart,Flames,78,75,17,58
350,Paul Reinhart,Flames,27,21,6,15
350,Paul Reinhart,Flames,75,69,23,46
350,Paul Reinhart,Flames,32,33,8,25
350,Paul Reinhart,Flames,76,68,15,53
350,Paul Reinhart,Flames,14,4,0,4
350,Paul Reinhart,Canucks,64,57,7,50
350,Paul Reinhart,Canucks,67,57,17,40
351,Bill Harris,Islanders,78,50,28,22
351,Bill Harris,Islanders,78,50,23,27
351,Bill Harris,Islanders,80,62,25,37
351,Bill Harris,Islanders,80,70,32,38
351,Bill Harris,Islanders,80,67,24,43
351,Bill Harris,Islanders,80,60,22,38
351,Bill Harris,Islanders,80,54,15,39
351,Bill Harris,Islanders,67,30,15,15
351,Bill Harris,Kings,11,7,4,3
351,Bill Harris,Kings,80,49,20,29
351,Bill Harris,Kings,16,4,1,3
351,Bill Harris,Maple Leafs,20,2,2,0
351,Bill Harris,Maple Leafs,76,30,11,19
351,Bill Harris,Maple Leafs,50,17,7,10
351,Bill Harris,Kings,21,6,2,4
352,Robert Schmautz,Blackhawks,13,5,3,2
352,Robert Schmautz,Blackhawks,63,16,9,7
352,Robert Schmautz,Canucks,26,10,5,5
352,Robert Schmautz,Canucks,60,25,12,13
352,Robert Schmautz,Canucks,77,71,38,33
352,Robert Schmautz,Canucks,49,45,26,19
352,Robert Schmautz,Bruins,27,20,7,13
352,Robert Schmautz,Bruins,56,51,21,30
352,Robert Schmautz,Bruins,75,62,28,34
352,Robert Schmautz,Bruins,57,52,23,29
352,Robert Schmautz,Bruins,54,54,27,27
352,Robert Schmautz,Bruins,65,42,20,22
352,Robert Schmautz,Bruins,20,14,8,6
352,Robert Schmautz,Oilers,29,16,8,8
352,Robert Schmautz,Rockies,20,13,9,4
352,Robert Schmautz,Canucks,73,61,27,34
353,Mike Murphy,Blues,63,43,20,23
353,Mike Murphy,Blues,64,45,18,27
353,Mike Murphy,Rangers,15,8,4,4
353,Mike Murphy,Rangers,16,3,2,1
353,Mike Murphy,Kings,53,29,13,16
353,Mike Murphy,Kings,78,68,30,38
353,Mike Murphy,Kings,80,68,26,42
353,Mike Murphy,Kings,76,61,25,36
353,Mike Murphy,Kings,72,56,20,36
353,Mike Murphy,Kings,64,45,16,29
353,Mike Murphy,Kings,80,49,27,22
353,Mike Murphy,Kings,68,39,16,23
353,Mike Murphy,Kings,28,15,5,10
353,Mike Murphy,Kings,74,27,16,11
354,Pete Stemkowski,Maple Leafs,1,0,0,0
354,Pete Stemkowski,Maple Leafs,36,20,5,15
354,Pete Stemkowski,Maple Leafs,56,16,4,12
354,Pete Stemkowski,Maple Leafs,68,35,13,22
354,Pete Stemkowski,Maple Leafs,60,22,7,15
354,Pete Stemkowski,Red Wings,13,9,3,6
354,Pete Stemkowski,Red Wings,71,52,21,31
354,Pete Stemkowski,Red Wings,76,49,25,24
354,Pete Stemkowski,Red Wings,10,4,2,2
354,Pete Stemkowski,Rangers,68,45,16,29
354,Pete Stemkowski,Rangers,59,28,11,17
354,Pete Stemkowski,Rangers,78,59,22,37
354,Pete Stemkowski,Rangers,78,70,25,45
354,Pete Stemkowski,Rangers,77,59,24,35
354,Pete Stemkowski,Rangers,75,41,13,28
354,Pete Stemkowski,Rangers,61,15,2,13
354,Pete Stemkowski,Kings,80,31,13,18
355,Bengt-Ake Gustafsson,Capitals,80,60,22,38
355,Bengt-Ake Gustafsson,Capitals,72,55,21,34
355,Bengt-Ake Gustafsson,Capitals,70,60,26,34
355,Bengt-Ake Gustafsson,Capitals,67,64,22,42
355,Bengt-Ake Gustafsson,Capitals,69,75,32,43
355,Bengt-Ake Gustafsson,Capitals,51,43,14,29
355,Bengt-Ake Gustafsson,Capitals,70,75,23,52
355,Bengt-Ake Gustafsson,Capitals,78,54,18,36
355,Bengt-Ake Gustafsson,Capitals,72,69,18,51
356,Don Luce,Rangers,12,3,1,2
356,Don Luce,Rangers,9,1,0,1
356,Don Luce,Red Wings,58,14,3,11
356,Don Luce,Sabres,78,19,11,8
356,Don Luce,Sabres,78,43,18,25
356,Don Luce,Sabres,75,57,26,31
356,Don Luce,Sabres,80,76,33,43
356,Don Luce,Sabres,77,70,21,49
356,Don Luce,Sabres,80,69,26,43
356,Don Luce,Sabres,78,61,26,35
356,Don Luce,Sabres,79,61,26,35
356,Don Luce,Sabres,80,43,14,29
356,Don Luce,Sabres,61,28,15,13
356,Don Luce,Kings,10,1,1,0
356,Don Luce,Maple Leafs,39,8,4,4
357,John Cullen,Penguins,79,49,12,37
357,John Cullen,Penguins,72,92,32,60
357,John Cullen,Penguins,65,94,31,63
357,John Cullen,Whalers,13,16,8,8
357,John Cullen,Whalers,77,77,26,51
357,John Cullen,Whalers,19,9,5,4
357,John Cullen,Maple Leafs,47,41,13,28
357,John Cullen,Maple Leafs,53,30,13,17
357,John Cullen,Penguins,46,37,13,24
357,John Cullen,Lightning,76,50,16,34
357,John Cullen,Lightning,70,55,18,37
357,John Cullen,Lightning,4,0,0,0
358,Scott Hartnell,Predators,75,16,2,14
358,Scott Hartnell,Predators,75,41,14,27
358,Scott Hartnell,Predators,82,34,12,22
358,Scott Hartnell,Predators,59,33,18,15
358,Scott Hartnell,Predators,81,48,25,23
358,Scott Hartnell,Predators,64,39,22,17
358,Scott Hartnell,Flyers,80,43,24,19
358,Scott Hartnell,Flyers,82,60,30,30
358,Scott Hartnell,Flyers,81,44,14,30
358,Scott Hartnell,Flyers,82,49,24,25
358,Scott Hartnell,Flyers,82,67,37,30
358,Scott Hartnell,Flyers,32,11,8,3
358,Scott Hartnell,Flyers,78,52,20,32
358,Scott Hartnell,Blue Jackets,13,12,3,9
359,Anze Kopitar,Kings,72,61,20,41
359,Anze Kopitar,Kings,82,77,32,45
359,Anze Kopitar,Kings,82,66,27,39
359,Anze Kopitar,Kings,82,81,34,47
359,Anze Kopitar,Kings,75,73,25,48
359,Anze Kopitar,Kings,82,76,25,51
359,Anze Kopitar,Kings,47,42,10,32
359,Anze Kopitar,Kings,82,70,29,41
359,Anze Kopitar,Kings,11,3,2,1
360,Mike Knuble,Red Wings,9,1,1,0
360,Mike Knuble,Red Wings,53,13,7,6
360,Mike Knuble,Rangers,82,35,15,20
360,Mike Knuble,Rangers,59,14,9,5
360,Mike Knuble,Bruins,14,6,3,3
360,Mike Knuble,Bruins,82,20,7,13
360,Mike Knuble,Bruins,54,14,8,6
360,Mike Knuble,Bruins,75,59,30,29
360,Mike Knuble,Bruins,82,46,21,25
360,Mike Knuble,Flyers,82,65,34,31
360,Mike Knuble,Flyers,64,54,24,30
360,Mike Knuble,Flyers,82,55,29,26
360,Mike Knuble,Flyers,82,47,27,20
360,Mike Knuble,Capitals,69,53,29,24
360,Mike Knuble,Capitals,79,40,24,16
360,Mike Knuble,Capitals,72,18,6,12
360,Mike Knuble,Flyers,28,8,4,4
361,Mike Sillinger,Red Wings,3,1,0,1
361,Mike Sillinger,Red Wings,51,21,4,17
361,Mike Sillinger,Red Wings,62,29,8,21
361,Mike Sillinger,Red Wings,13,8,2,6
361,Mike Sillinger,Ducks,15,7,2,5
361,Mike Sillinger,Ducks,62,34,13,21
361,Mike Sillinger,Canucks,12,4,1,3
361,Mike Sillinger,Canucks,78,37,17,20
361,Mike Sillinger,Canucks,48,19,10,9
361,Mike Sillinger,Flyers,27,22,11,11
361,Mike Sillinger,Flyers,25,3,0,3
361,Mike Sillinger,Lightning,54,10,8,2
361,Mike Sillinger,Lightning,67,44,19,25
361,Mike Sillinger,Panthers,13,8,4,4
361,Mike Sillinger,Panthers,55,34,13,21
361,Mike Sillinger,Senators,13,7,3,4
361,Mike Sillinger,Blue Jackets,80,43,20,23
361,Mike Sillinger,Blue Jackets,75,43,18,25
361,Mike Sillinger,Coyotes,60,14,8,6
361,Mike Sillinger,Blues,16,10,5,5
361,Mike Sillinger,Blues,48,41,22,19
361,Mike Sillinger,Predators,31,22,10,12
361,Mike Sillinger,Islanders,82,59,26,33
361,Mike Sillinger,Islanders,52,26,14,12
361,Mike Sillinger,Islanders,7,2,2,0
362,Bill Cowley,Eagles,41,12,5,7
362,Bill Cowley,Bruins,48,21,11,10
362,Bill Cowley,Bruins,46,35,13,22
362,Bill Cowley,Bruins,48,39,17,22
362,Bill Cowley,Bruins,34,42,8,34
362,Bill Cowley,Bruins,48,40,13,27
362,Bill Cowley,Bruins,46,62,17,45
362,Bill Cowley,Bruins,28,27,4,23
362,Bill Cowley,Bruins,48,72,27,45
362,Bill Cowley,Bruins,36,71,30,41
362,Bill Cowley,Bruins,49,65,25,40
362,Bill Cowley,Bruins,26,24,12,12
362,Bill Cowley,Bruins,51,38,13,25
363,Max Bentley,Blackhawks,36,17,7,10
363,Max Bentley,Blackhawks,39,30,13,17
363,Max Bentley,Blackhawks,47,70,26,44
363,Max Bentley,Blackhawks,47,61,31,30
363,Max Bentley,Blackhawks,60,72,29,43
363,Max Bentley,Blackhawks,6,6,3,3
363,Max Bentley,Maple Leafs,53,48,23,25
363,Max Bentley,Maple Leafs,60,41,19,22
363,Max Bentley,Maple Leafs,69,41,23,18
363,Max Bentley,Maple Leafs,67,62,21,41
363,Max Bentley,Maple Leafs,69,41,24,17
363,Max Bentley,Maple Leafs,36,23,12,11
363,Max Bentley,Rangers,57,32,14,18
364,Justin Williams,Flyers,63,25,12,13
364,Justin Williams,Flyers,75,40,17,23
364,Justin Williams,Flyers,41,24,8,16
364,Justin Williams,Flyers,47,26,6,20
364,Justin Williams,Hurricanes,32,18,5,13
364,Justin Williams,Hurricanes,82,76,31,45
364,Justin Williams,Hurricanes,82,67,33,34
364,Justin Williams,Hurricanes,37,30,9,21
364,Justin Williams,Hurricanes,32,10,3,7
364,Justin Williams,Kings,12,4,1,3
364,Justin Williams,Kings,49,29,10,19
364,Justin Williams,Kings,73,57,22,35
364,Justin Williams,Kings,82,59,22,37
364,Justin Williams,Kings,48,33,11,22
364,Justin Williams,Kings,82,43,19,24
364,Justin Williams,Kings,13,3,1,2
365,Benoit Hogue,Sabres,3,2,1,1
365,Benoit Hogue,Sabres,69,44,14,30
365,Benoit Hogue,Sabres,45,18,11,7
365,Benoit Hogue,Sabres,76,47,19,28
365,Benoit Hogue,Sabres,3,1,0,1
365,Benoit Hogue,Islanders,72,75,30,45
365,Benoit Hogue,Islanders,70,75,33,42
365,Benoit Hogue,Islanders,83,69,36,33
365,Benoit Hogue,Islanders,33,10,6,4
365,Benoit Hogue,Maple Leafs,12,6,3,3
365,Benoit Hogue,Maple Leafs,44,37,12,25
365,Benoit Hogue,Stars,34,27,7,20
365,Benoit Hogue,Stars,73,43,19,24
365,Benoit Hogue,Stars,53,22,6,16
365,Benoit Hogue,Lightning,62,25,11,14
365,Benoit Hogue,Stars,12,4,1,3
365,Benoit Hogue,Coyotes,27,13,3,10
365,Benoit Hogue,Stars,34,10,3,7
365,Benoit Hogue,Stars,32,6,3,3
365,Benoit Hogue,Bruins,17,8,4,4
365,Benoit Hogue,Capitals,9,1,0,1
366,Doug Bentley,Blackhawks,39,19,12,7
366,Doug Bentley,Blackhawks,47,28,8,20
366,Doug Bentley,Blackhawks,38,26,12,14
366,Doug Bentley,Blackhawks,50,73,33,40
366,Doug Bentley,Blackhawks,50,77,38,39
366,Doug Bentley,Blackhawks,36,40,19,21
366,Doug Bentley,Blackhawks,52,55,21,34
366,Doug Bentley,Blackhawks,60,57,20,37
366,Doug Bentley,Blackhawks,58,66,23,43
366,Doug Bentley,Blackhawks,64,53,20,33
366,Doug Bentley,Blackhawks,44,32,9,23
366,Doug Bentley,Blackhawks,8,5,2,3
366,Doug Bentley,Rangers,20,12,2,10
367,Gary Dornhoefer,Bruins,32,22,12,10
367,Gary Dornhoefer,Bruins,20,1,0,1
367,Gary Dornhoefer,Bruins,10,1,0,1
367,Gary Dornhoefer,Flyers,65,43,13,30
367,Gary Dornhoefer,Flyers,60,24,8,16
367,Gary Dornhoefer,Flyers,65,55,26,29
367,Gary Dornhoefer,Flyers,57,40,20,20
367,Gary Dornhoefer,Flyers,75,49,17,32
367,Gary Dornhoefer,Flyers,77,79,30,49
367,Gary Dornhoefer,Flyers,57,50,11,39
367,Gary Dornhoefer,Flyers,69,44,17,27
367,Gary Dornhoefer,Flyers,74,63,28,35
367,Gary Dornhoefer,Flyers,79,59,25,34
367,Gary Dornhoefer,Flyers,47,12,7,5
368,Craig Conroy,Canadiens,6,1,1,0
368,Craig Conroy,Canadiens,7,0,0,0
368,Craig Conroy,Blues,61,17,6,11
368,Craig Conroy,Blues,81,43,14,29
368,Craig Conroy,Blues,69,39,14,25
368,Craig Conroy,Blues,79,27,12,15
368,Craig Conroy,Blues,69,25,11,14
368,Craig Conroy,Flames,14,7,3,4
368,Craig Conroy,Flames,81,75,27,48
368,Craig Conroy,Flames,79,59,22,37
368,Craig Conroy,Flames,63,47,8,39
368,Craig Conroy,Kings,78,66,22,44
368,Craig Conroy,Kings,52,16,5,11
368,Craig Conroy,Flames,28,21,8,13
368,Craig Conroy,Flames,79,34,12,22
368,Craig Conroy,Flames,82,48,12,36
368,Craig Conroy,Flames,63,15,3,12
368,Craig Conroy,Flames,18,2,2,0
369,Bill Goldsworthy,Bruins,2,0,0,0
369,Bill Goldsworthy,Bruins,13,4,3,1
369,Bill Goldsworthy,Bruins,18,8,3,5
369,Bill Goldsworthy,North Stars,68,33,14,19
369,Bill Goldsworthy,North Stars,68,24,14,10
369,Bill Goldsworthy,North Stars,75,65,36,29
369,Bill Goldsworthy,North Stars,77,65,34,31
369,Bill Goldsworthy,North Stars,78,62,31,31
369,Bill Goldsworthy,North Stars,75,60,27,33
369,Bill Goldsworthy,North Stars,74,74,48,26
369,Bill Goldsworthy,North Stars,71,72,37,35
369,Bill Goldsworthy,North Stars,68,46,24,22
369,Bill Goldsworthy,North Stars,16,5,2,3
369,Bill Goldsworthy,Rangers,61,22,10,12
369,Bill Goldsworthy,Rangers,7,1,0,1
370,Mark Napier,Canadiens,54,31,11,20
370,Mark Napier,Canadiens,76,49,16,33
370,Mark Napier,Canadiens,79,71,35,36
370,Mark Napier,Canadiens,80,81,40,41
370,Mark Napier,Canadiens,73,67,40,27
370,Mark Napier,Canadiens,5,5,3,2
370,Mark Napier,North Stars,58,41,13,28
370,Mark Napier,North Stars,39,28,10,18
370,Mark Napier,Oilers,33,35,9,26
370,Mark Napier,Oilers,80,56,24,32
370,Mark Napier,Oilers,62,21,8,13
370,Mark Napier,Sabres,15,10,5,5
370,Mark Napier,Sabres,47,18,10,8
370,Mark Napier,Sabres,66,28,11,17
371,Bill Mosienko,Blackhawks,12,14,6,8
371,Bill Mosienko,Blackhawks,2,2,2,0
371,Bill Mosienko,Blackhawks,50,70,32,38
371,Bill Mosienko,Blackhawks,50,54,28,26
371,Bill Mosienko,Blackhawks,40,48,18,30
371,Bill Mosienko,Blackhawks,59,52,25,27
371,Bill Mosienko,Blackhawks,40,25,16,9
371,Bill Mosienko,Blackhawks,60,42,17,25
371,Bill Mosienko,Blackhawks,69,46,18,28
371,Bill Mosienko,Blackhawks,65,36,21,15
371,Bill Mosienko,Blackhawks,70,53,31,22
371,Bill Mosienko,Blackhawks,65,37,17,20
371,Bill Mosienko,Blackhawks,65,34,15,19
371,Bill Mosienko,Blackhawks,64,27,12,15
372,Doug Harvey,Canadiens,35,8,4,4
372,Doug Harvey,Canadiens,55,16,3,13
372,Doug Harvey,Canadiens,70,24,4,20
372,Doug Harvey,Canadiens,70,29,5,24
372,Doug Harvey,Canadiens,68,29,6,23
372,Doug Harvey,Canadiens,69,34,4,30
372,Doug Harvey,Canadiens,68,37,8,29
372,Doug Harvey,Canadiens,70,49,6,43
372,Doug Harvey,Canadiens,62,44,5,39
372,Doug Harvey,Canadiens,70,50,6,44
372,Doug Harvey,Canadiens,68,41,9,32
372,Doug Harvey,Canadiens,61,20,4,16
372,Doug Harvey,Canadiens,66,27,6,21
372,Doug Harvey,Canadiens,58,39,6,33
372,Doug Harvey,Rangers,69,30,6,24
372,Doug Harvey,Rangers,68,39,4,35
372,Doug Harvey,Rangers,14,2,0,2
372,Doug Harvey,Red Wings,2,0,0,0
372,Doug Harvey,Blues,70,22,2,20
373,Viktor Kozlov,Sharks,16,2,2,0
373,Viktor Kozlov,Sharks,62,19,6,13
373,Viktor Kozlov,Sharks,78,41,16,25
373,Viktor Kozlov,Sharks,18,7,5,2
373,Viktor Kozlov,Panthers,46,23,12,11
373,Viktor Kozlov,Panthers,65,51,16,35
373,Viktor Kozlov,Panthers,80,70,17,53
373,Viktor Kozlov,Panthers,51,37,14,23
373,Viktor Kozlov,Panthers,50,27,9,18
373,Viktor Kozlov,Panthers,74,56,22,34
373,Viktor Kozlov,Panthers,48,27,11,16
373,Viktor Kozlov,Devils,11,6,2,4
373,Viktor Kozlov,Devils,69,25,12,13
373,Viktor Kozlov,Islanders,81,51,25,26
373,Viktor Kozlov,Capitals,81,54,16,38
373,Viktor Kozlov,Capitals,67,41,13,28
374,Glen Wesley,Bruins,79,37,7,30
374,Glen Wesley,Bruins,77,54,19,35
374,Glen Wesley,Bruins,78,36,9,27
374,Glen Wesley,Bruins,80,43,11,32
374,Glen Wesley,Bruins,78,46,9,37
374,Glen Wesley,Bruins,64,33,8,25
374,Glen Wesley,Bruins,81,58,14,44
374,Glen Wesley,Whalers,48,16,2,14
374,Glen Wesley,Whalers,68,24,8,16
374,Glen Wesley,Whalers,68,32,6,26
374,Glen Wesley,Hurricanes,82,25,6,19
374,Glen Wesley,Hurricanes,74,24,7,17
374,Glen Wesley,Hurricanes,78,22,7,15
374,Glen Wesley,Hurricanes,71,21,5,16
374,Glen Wesley,Hurricanes,77,18,5,13
374,Glen Wesley,Hurricanes,63,8,1,7
374,Glen Wesley,Maple Leafs,7,3,0,3
374,Glen Wesley,Hurricanes,74,6,0,6
374,Glen Wesley,Hurricanes,64,10,2,8
374,Glen Wesley,Hurricanes,68,13,1,12
374,Glen Wesley,Hurricanes,78,8,1,7
375,Daniel Grant,Canadiens,1,0,0,0
375,Daniel Grant,Canadiens,22,7,3,4
375,Daniel Grant,North Stars,75,65,34,31
375,Daniel Grant,North Stars,76,57,29,28
375,Daniel Grant,North Stars,78,57,34,23
375,Daniel Grant,North Stars,78,43,18,25
375,Daniel Grant,North Stars,78,67,32,35
375,Daniel Grant,North Stars,78,64,29,35
375,Daniel Grant,Red Wings,80,87,50,37
375,Daniel Grant,Red Wings,39,23,10,13
375,Daniel Grant,Red Wings,42,12,2,10
375,Daniel Grant,Red Wings,13,4,2,2
375,Daniel Grant,Kings,41,29,10,19
375,Daniel Grant,Kings,35,21,10,11
376,Timothy Young,North Stars,63,51,18,33
376,Timothy Young,North Stars,80,95,29,66
376,Timothy Young,North Stars,78,58,23,35
376,Timothy Young,North Stars,73,56,24,32
376,Timothy Young,North Stars,77,74,31,43
376,Timothy Young,North Stars,74,66,25,41
376,Timothy Young,North Stars,49,41,10,31
376,Timothy Young,North Stars,70,53,18,35
376,Timothy Young,Jets (1979),44,34,15,19
376,Timothy Young,Flyers,20,8,2,6
377,Ronald Sutter,Flyers,10,2,1,1
377,Ronald Sutter,Flyers,79,51,19,32
377,Ronald Sutter,Flyers,73,45,16,29
377,Ronald Sutter,Flyers,75,60,18,42
377,Ronald Sutter,Flyers,39,28,10,18
377,Ronald Sutter,Flyers,69,33,8,25
377,Ronald Sutter,Flyers,55,48,26,22
377,Ronald Sutter,Flyers,75,48,22,26
377,Ronald Sutter,Flyers,80,45,17,28
377,Ronald Sutter,Blues,68,46,19,27
377,Ronald Sutter,Blues,59,27,12,15
377,Ronald Sutter,Blues,36,18,6,12
377,Ronald Sutter,Nordiques,37,22,9,13
377,Ronald Sutter,Islanders,27,5,1,4
377,Ronald Sutter,Bruins,18,12,5,7
377,Ronald Sutter,Sharks,78,12,5,7
377,Ronald Sutter,Sharks,57,9,2,7
377,Ronald Sutter,Sharks,59,9,3,6
377,Ronald Sutter,Sharks,78,11,5,6
377,Ronald Sutter,Flames,21,4,1,3
378,Calle Johansson,Sabres,71,42,4,38
378,Calle Johansson,Sabres,47,13,2,11
378,Calle Johansson,Capitals,12,8,1,7
378,Calle Johansson,Capitals,70,39,8,31
378,Calle Johansson,Capitals,80,52,11,41
378,Calle Johansson,Capitals,80,56,14,42
378,Calle Johansson,Capitals,77,45,7,38
378,Calle Johansson,Capitals,84,42,9,33
378,Calle Johansson,Capitals,46,31,5,26
378,Calle Johansson,Capitals,78,35,10,25
378,Calle Johansson,Capitals,65,17,6,11
378,Calle Johansson,Capitals,73,35,15,20
378,Calle Johansson,Capitals,67,29,8,21
378,Calle Johansson,Capitals,82,32,7,25
378,Calle Johansson,Capitals,76,36,7,29
378,Calle Johansson,Capitals,11,2,2,0
378,Calle Johansson,Capitals,82,15,3,12
378,Calle Johansson,Maple Leafs,8,6,0,6
379,Kenny Wharram,Blackhawks,1,0,0,0
379,Kenny Wharram,Blackhawks,29,8,1,7
379,Kenny Wharram,Blackhawks,3,0,0,0
379,Kenny Wharram,Blackhawks,66,19,10,9
379,Kenny Wharram,Blackhawks,59,25,14,11
379,Kenny Wharram,Blackhawks,64,45,16,29
379,Kenny Wharram,Blackhawks,62,37,14,23
379,Kenny Wharram,Blackhawks,55,38,20,18
379,Kenny Wharram,Blackhawks,70,71,39,32
379,Kenny Wharram,Blackhawks,68,44,24,20
379,Kenny Wharram,Blackhawks,69,43,26,17
379,Kenny Wharram,Blackhawks,70,65,31,34
379,Kenny Wharram,Blackhawks,74,69,27,42
379,Kenny Wharram,Blackhawks,76,69,30,39
380,Jason Pominville,Sabres,1,0,0,0
380,Jason Pominville,Sabres,57,30,18,12
380,Jason Pominville,Sabres,82,68,34,34
380,Jason Pominville,Sabres,82,80,27,53
380,Jason Pominville,Sabres,82,66,20,46
380,Jason Pominville,Sabres,82,62,24,38
380,Jason Pominville,Sabres,73,52,22,30
380,Jason Pominville,Sabres,82,73,30,43
380,Jason Pominville,Sabres,37,25,10,15
380,Jason Pominville,Wild,10,9,4,5
380,Jason Pominville,Wild,82,60,30,30
380,Jason Pominville,Wild,12,7,3,4
381,Mark Osborne,Red Wings,80,67,26,41
381,Mark Osborne,Red Wings,80,43,19,24
381,Mark Osborne,Rangers,73,51,23,28
381,Mark Osborne,Rangers,23,8,4,4
381,Mark Osborne,Rangers,62,40,16,24
381,Mark Osborne,Rangers,58,32,17,15
381,Mark Osborne,Maple Leafs,16,15,5,10
381,Mark Osborne,Maple Leafs,79,60,23,37
381,Mark Osborne,Maple Leafs,75,46,16,30
381,Mark Osborne,Maple Leafs,78,73,23,50
381,Mark Osborne,Maple Leafs,18,6,3,3
381,Mark Osborne,Jets (1979),37,16,8,8
381,Mark Osborne,Jets (1979),43,16,4,12
381,Mark Osborne,Maple Leafs,11,4,3,1
381,Mark Osborne,Maple Leafs,76,26,12,14
381,Mark Osborne,Maple Leafs,73,24,9,15
381,Mark Osborne,Rangers,37,4,1,3
382,Tomas Holmstrom,Red Wings,47,9,6,3
382,Tomas Holmstrom,Red Wings,57,22,5,17
382,Tomas Holmstrom,Red Wings,82,34,13,21
382,Tomas Holmstrom,Red Wings,72,35,13,22
382,Tomas Holmstrom,Red Wings,73,40,16,24
382,Tomas Holmstrom,Red Wings,69,26,8,18
382,Tomas Holmstrom,Red Wings,74,40,20,20
382,Tomas Holmstrom,Red Wings,67,30,15,15
382,Tomas Holmstrom,Red Wings,81,59,29,30
382,Tomas Holmstrom,Red Wings,77,52,30,22
382,Tomas Holmstrom,Red Wings,59,40,20,20
382,Tomas Holmstrom,Red Wings,53,37,14,23
382,Tomas Holmstrom,Red Wings,68,45,25,20
382,Tomas Holmstrom,Red Wings,73,37,18,19
382,Tomas Holmstrom,Red Wings,74,24,11,13
383,Guy Charron,Canadiens,5,0,0,0
383,Guy Charron,Canadiens,15,4,2,2
383,Guy Charron,Red Wings,24,12,8,4
383,Guy Charron,Red Wings,64,25,9,16
383,Guy Charron,Red Wings,75,36,18,18
383,Guy Charron,Red Wings,76,55,25,30
383,Guy Charron,Red Wings,26,11,1,10
383,Guy Charron,Scouts,51,42,13,29
383,Guy Charron,Scouts,78,71,27,44
383,Guy Charron,Capitals,80,82,36,46
383,Guy Charron,Capitals,80,73,38,35
383,Guy Charron,Capitals,80,70,28,42
383,Guy Charron,Capitals,33,31,11,20
383,Guy Charron,Capitals,47,18,5,13
384,David Poulin,Flyers,2,2,2,0
384,David Poulin,Flyers,73,76,31,45
384,David Poulin,Flyers,73,74,30,44
384,David Poulin,Flyers,79,69,27,42
384,David Poulin,Flyers,75,70,25,45
384,David Poulin,Flyers,68,51,19,32
384,David Poulin,Flyers,69,35,18,17
384,David Poulin,Flyers,28,17,9,8
384,David Poulin,Bruins,32,25,6,19
384,David Poulin,Bruins,31,20,8,12
384,David Poulin,Bruins,18,8,4,4
384,David Poulin,Bruins,84,49,16,33
384,David Poulin,Capitals,63,25,6,19
384,David Poulin,Capitals,29,9,4,5
385,Ron Stewart,Maple Leafs,70,35,13,22
385,Ron Stewart,Maple Leafs,70,25,14,11
385,Ron Stewart,Maple Leafs,53,19,14,5
385,Ron Stewart,Maple Leafs,69,27,13,14
385,Ron Stewart,Maple Leafs,65,35,15,20
385,Ron Stewart,Maple Leafs,70,39,15,24
385,Ron Stewart,Maple Leafs,70,34,21,13
385,Ron Stewart,Maple Leafs,67,34,14,20
385,Ron Stewart,Maple Leafs,51,25,13,12
385,Ron Stewart,Maple Leafs,60,17,8,9
385,Ron Stewart,Maple Leafs,63,32,16,16
385,Ron Stewart,Maple Leafs,65,19,14,5
385,Ron Stewart,Maple Leafs,65,27,16,11
385,Ron Stewart,Bruins,70,36,20,16
385,Ron Stewart,Bruins,56,24,14,10
385,Ron Stewart,Blues,19,12,7,5
385,Ron Stewart,Rangers,55,14,7,7
385,Ron Stewart,Rangers,75,29,18,11
385,Ron Stewart,Rangers,76,24,14,10
385,Ron Stewart,Rangers,76,11,5,6
385,Ron Stewart,Canucks,42,4,3,1
385,Ron Stewart,Rangers,13,2,0,2
385,Ron Stewart,Rangers,11,1,0,1
385,Ron Stewart,Islanders,22,4,2,2
386,Camille Henry,Rangers,66,39,24,15
386,Camille Henry,Rangers,21,7,5,2
386,Camille Henry,Rangers,36,29,14,15
386,Camille Henry,Rangers,70,56,32,24
386,Camille Henry,Rangers,70,58,23,35
386,Camille Henry,Rangers,49,27,12,15
386,Camille Henry,Rangers,53,53,28,25
386,Camille Henry,Rangers,60,38,23,15
386,Camille Henry,Rangers,60,60,37,23
386,Camille Henry,Rangers,68,55,29,26
386,Camille Henry,Rangers,48,36,21,15
386,Camille Henry,Blackhawks,22,8,5,3
386,Camille Henry,Rangers,36,20,8,12
386,Camille Henry,Blues,64,39,17,22
386,Camille Henry,Blues,4,3,1,2
387,Syd Howe,Senators (1917),12,2,1,1
387,Syd Howe,Quakers,44,20,9,11
387,Syd Howe,Maple Leafs,3,0,0,0
387,Syd Howe,Senators (1917),48,24,12,12
387,Syd Howe,Senators (1917),42,20,13,7
387,Syd Howe,Eagles,36,27,14,13
387,Syd Howe,Red Wings,14,20,8,12
387,Syd Howe,Red Wings,48,30,16,14
387,Syd Howe,Red Wings,45,27,17,10
387,Syd Howe,Red Wings,48,27,8,19
387,Syd Howe,Red Wings,48,36,16,20
387,Syd Howe,Red Wings,46,37,14,23
387,Syd Howe,Red Wings,48,44,20,24
387,Syd Howe,Red Wings,48,35,16,19
387,Syd Howe,Red Wings,50,55,20,35
387,Syd Howe,Red Wings,46,60,32,28
387,Syd Howe,Red Wings,46,53,17,36
387,Syd Howe,Red Wings,26,11,4,7
388,Joe Murphy,Red Wings,5,1,0,1
388,Joe Murphy,Red Wings,50,19,10,9
388,Joe Murphy,Red Wings,26,8,1,7
388,Joe Murphy,Red Wings,9,4,3,1
388,Joe Murphy,Oilers,62,25,7,18
388,Joe Murphy,Oilers,80,62,27,35
388,Joe Murphy,Oilers,80,82,35,47
388,Joe Murphy,Blackhawks,19,17,7,10
388,Joe Murphy,Blackhawks,81,70,31,39
388,Joe Murphy,Blackhawks,40,41,23,18
388,Joe Murphy,Blackhawks,70,51,22,29
388,Joe Murphy,Blues,75,45,20,25
388,Joe Murphy,Blues,27,13,4,9
388,Joe Murphy,Sharks,10,9,5,4
388,Joe Murphy,Sharks,76,48,25,23
388,Joe Murphy,Bruins,26,14,7,7
388,Joe Murphy,Capitals,29,13,5,8
388,Joe Murphy,Capitals,14,6,1,5
389,Bryan McCabe,Islanders,82,23,7,16
389,Bryan McCabe,Islanders,82,28,8,20
389,Bryan McCabe,Islanders,56,12,3,9
389,Bryan McCabe,Canucks,26,12,1,11
389,Bryan McCabe,Canucks,69,21,7,14
389,Bryan McCabe,Blackhawks,79,25,6,19
389,Bryan McCabe,Maple Leafs,82,29,5,24
389,Bryan McCabe,Maple Leafs,82,43,17,26
389,Bryan McCabe,Maple Leafs,75,24,6,18
389,Bryan McCabe,Maple Leafs,75,53,16,37
389,Bryan McCabe,Maple Leafs,73,68,19,49
389,Bryan McCabe,Maple Leafs,82,57,15,42
389,Bryan McCabe,Maple Leafs,54,23,5,18
389,Bryan McCabe,Panthers,69,39,15,24
389,Bryan McCabe,Panthers,82,43,8,35
389,Bryan McCabe,Panthers,48,22,5,17
389,Bryan McCabe,Rangers,19,6,2,4
390,Doug Bodger,Penguins,65,31,5,26
390,Doug Bodger,Penguins,79,37,4,33
390,Doug Bodger,Penguins,76,49,11,38
390,Doug Bodger,Penguins,69,45,14,31
390,Doug Bodger,Penguins,10,5,1,4
390,Doug Bodger,Sabres,61,47,7,40
390,Doug Bodger,Sabres,71,48,12,36
390,Doug Bodger,Sabres,58,28,5,23
390,Doug Bodger,Sabres,73,46,11,35
390,Doug Bodger,Sabres,81,54,9,45
390,Doug Bodger,Sabres,75,39,7,32
390,Doug Bodger,Sabres,44,20,3,17
390,Doug Bodger,Sabres,16,5,0,5
390,Doug Bodger,Sharks,57,23,4,19
390,Doug Bodger,Sharks,81,16,1,15
390,Doug Bodger,Sharks,28,10,4,6
390,Doug Bodger,Devils,49,10,5,5
390,Doug Bodger,Kings,65,14,3,11
390,Doug Bodger,Canucks,13,1,0,1
391,Toe Blake,Maroons,8,0,0,0
391,Toe Blake,Canadiens,11,3,1,2
391,Toe Blake,Canadiens,43,22,10,12
391,Toe Blake,Canadiens,43,33,17,16
391,Toe Blake,Canadiens,48,47,24,23
391,Toe Blake,Canadiens,48,36,17,19
391,Toe Blake,Canadiens,48,32,12,20
391,Toe Blake,Canadiens,48,45,17,28
391,Toe Blake,Canadiens,48,59,23,36
391,Toe Blake,Canadiens,41,59,26,33
391,Toe Blake,Canadiens,49,67,29,38
391,Toe Blake,Canadiens,50,50,29,21
391,Toe Blake,Canadiens,60,50,21,29
391,Toe Blake,Canadiens,32,24,9,15
392,Lucien DeBlois,Rangers,71,30,22,8
392,Lucien DeBlois,Rangers,62,28,11,17
392,Lucien DeBlois,Rangers,6,4,3,1
392,Lucien DeBlois,Rockies,70,43,24,19
392,Lucien DeBlois,Rockies,74,42,26,16
392,Lucien DeBlois,Jets (1979),65,52,25,27
392,Lucien DeBlois,Jets (1979),79,54,27,27
392,Lucien DeBlois,Jets (1979),80,79,34,45
392,Lucien DeBlois,Canadiens,51,23,12,11
392,Lucien DeBlois,Canadiens,61,31,14,17
392,Lucien DeBlois,Rangers,40,11,3,8
392,Lucien DeBlois,Rangers,74,30,9,21
392,Lucien DeBlois,Rangers,73,33,9,24
392,Lucien DeBlois,Nordiques,70,17,9,8
392,Lucien DeBlois,Nordiques,14,4,2,2
392,Lucien DeBlois,Maple Leafs,38,22,10,12
392,Lucien DeBlois,Maple Leafs,54,19,8,11
392,Lucien DeBlois,Jets (1979),11,3,1,2
393,J-P Dumont,Blackhawks,25,15,9,6
393,J-P Dumont,Blackhawks,47,18,10,8
393,J-P Dumont,Sabres,79,51,23,28
393,J-P Dumont,Sabres,76,44,23,21
393,J-P Dumont,Sabres,76,35,14,21
393,J-P Dumont,Sabres,77,53,22,31
393,J-P Dumont,Sabres,54,40,20,20
393,J-P Dumont,Predators,82,66,21,45
393,J-P Dumont,Predators,80,72,29,43
393,J-P Dumont,Predators,82,65,16,49
393,J-P Dumont,Predators,74,45,17,28
393,J-P Dumont,Predators,70,19,10,9
394,Zdeno Chara,Islanders,25,1,0,1
394,Zdeno Chara,Islanders,59,8,2,6
394,Zdeno Chara,Islanders,65,11,2,9
394,Zdeno Chara,Islanders,82,9,2,7
394,Zdeno Chara,Senators,75,23,10,13
394,Zdeno Chara,Senators,74,39,9,30
394,Zdeno Chara,Senators,79,41,16,25
394,Zdeno Chara,Senators,71,43,16,27
394,Zdeno Chara,Bruins,80,43,11,32
394,Zdeno Chara,Bruins,77,51,17,34
394,Zdeno Chara,Bruins,80,50,19,31
394,Zdeno Chara,Bruins,80,44,7,37
394,Zdeno Chara,Bruins,81,44,14,30
394,Zdeno Chara,Bruins,79,52,12,40
394,Zdeno Chara,Bruins,48,19,7,12
394,Zdeno Chara,Bruins,77,40,17,23
394,Zdeno Chara,Bruins,9,3,2,1
395,Martin Erat,Predators,80,33,9,24
395,Martin Erat,Predators,27,8,1,7
395,Martin Erat,Predators,76,49,16,33
395,Martin Erat,Predators,80,49,20,29
395,Martin Erat,Predators,68,57,16,41
395,Martin Erat,Predators,76,57,23,34
395,Martin Erat,Predators,71,50,17,33
395,Martin Erat,Predators,74,49,21,28
395,Martin Erat,Predators,64,50,17,33
395,Martin Erat,Predators,71,58,19,39
395,Martin Erat,Predators,36,21,4,17
395,Martin Erat,Capitals,9,3,1,2
395,Martin Erat,Capitals,53,24,1,23
395,Martin Erat,Coyotes,17,5,2,3
395,Martin Erat,Coyotes,13,7,4,3
396,Mike Rogers,Whalers,80,105,44,61
396,Mike Rogers,Whalers,80,105,40,65
396,Mike Rogers,Rangers,80,103,38,65
396,Mike Rogers,Rangers,71,76,29,47
396,Mike Rogers,Rangers,78,61,23,38
396,Mike Rogers,Rangers,78,64,26,38
396,Mike Rogers,Rangers,9,4,1,3
396,Mike Rogers,Oilers,8,1,1,0
397,Tim Horton,Maple Leafs,1,0,0,0
397,Tim Horton,Maple Leafs,4,0,0,0
397,Tim Horton,Maple Leafs,70,16,2,14
397,Tim Horton,Maple Leafs,70,31,7,24
397,Tim Horton,Maple Leafs,67,14,5,9
397,Tim Horton,Maple Leafs,35,5,0,5
397,Tim Horton,Maple Leafs,66,25,6,19
397,Tim Horton,Maple Leafs,53,26,6,20
397,Tim Horton,Maple Leafs,70,26,5,21
397,Tim Horton,Maple Leafs,70,32,3,29
397,Tim Horton,Maple Leafs,57,21,6,15
397,Tim Horton,Maple Leafs,70,38,10,28
397,Tim Horton,Maple Leafs,70,25,6,19
397,Tim Horton,Maple Leafs,70,29,9,20
397,Tim Horton,Maple Leafs,70,28,12,16
397,Tim Horton,Maple Leafs,70,28,6,22
397,Tim Horton,Maple Leafs,70,25,8,17
397,Tim Horton,Maple Leafs,69,27,4,23
397,Tim Horton,Maple Leafs,74,40,11,29
397,Tim Horton,Maple Leafs,59,22,3,19
397,Tim Horton,Rangers,15,6,1,5
397,Tim Horton,Rangers,78,20,2,18
397,Tim Horton,Penguins,44,11,2,9
397,Tim Horton,Sabres,69,17,1,16
397,Tim Horton,Sabres,55,6,0,6
398,Ron Schock,Bruins,5,3,1,2
398,Ron Schock,Bruins,33,11,4,7
398,Ron Schock,Bruins,24,4,2,2
398,Ron Schock,Bruins,66,30,10,20
398,Ron Schock,Blues,55,18,9,9
398,Ron Schock,Blues,67,39,12,27
398,Ron Schock,Penguins,76,29,8,21
398,Ron Schock,Penguins,71,40,14,26
398,Ron Schock,Penguins,77,46,17,29
398,Ron Schock,Penguins,78,49,13,36
398,Ron Schock,Penguins,77,43,14,29
398,Ron Schock,Penguins,80,86,23,63
398,Ron Schock,Penguins,80,62,18,44
398,Ron Schock,Penguins,80,49,17,32
398,Ron Schock,Sabres,40,8,4,4
399,Yanic Perreault,Maple Leafs,13,6,3,3
399,Yanic Perreault,Kings,26,7,2,5
399,Yanic Perreault,Kings,78,49,25,24
399,Yanic Perreault,Kings,41,25,11,14
399,Yanic Perreault,Kings,79,48,28,20
399,Yanic Perreault,Kings,64,27,10,17
399,Yanic Perreault,Maple Leafs,12,15,7,8
399,Yanic Perreault,Maple Leafs,58,45,18,27
399,Yanic Perreault,Maple Leafs,76,52,24,28
399,Yanic Perreault,Canadiens,82,56,27,29
399,Yanic Perreault,Canadiens,73,46,24,22
399,Yanic Perreault,Canadiens,69,31,16,15
399,Yanic Perreault,Predators,69,57,22,35
399,Yanic Perreault,Coyotes,49,33,19,14
399,Yanic Perreault,Maple Leafs,17,5,2,3
399,Yanic Perreault,Blackhawks,53,14,9,5
400,Jeff Friesen,Sharks,48,25,15,10
400,Jeff Friesen,Sharks,79,46,15,31
400,Jeff Friesen,Sharks,82,62,28,34
400,Jeff Friesen,Sharks,79,63,31,32
400,Jeff Friesen,Sharks,78,57,22,35
400,Jeff Friesen,Sharks,82,61,26,35
400,Jeff Friesen,Sharks,64,36,12,24
400,Jeff Friesen,Ducks,15,12,2,10
400,Jeff Friesen,Ducks,81,43,17,26
400,Jeff Friesen,Devils,81,51,23,28
400,Jeff Friesen,Devils,81,37,17,20
400,Jeff Friesen,Capitals,33,7,3,4
400,Jeff Friesen,Ducks,18,4,1,3
400,Jeff Friesen,Flames,72,12,6,6
401,Nels Stewart,Maroons,36,42,34,8
401,Nels Stewart,Maroons,43,21,17,4
401,Nels Stewart,Maroons,41,34,27,7
401,Nels Stewart,Maroons,44,29,21,8
401,Nels Stewart,Maroons,44,55,39,16
401,Nels Stewart,Maroons,42,39,25,14
401,Nels Stewart,Maroons,38,33,22,11
401,Nels Stewart,Bruins,47,36,18,18
401,Nels Stewart,Bruins,48,39,22,17
401,Nels Stewart,Bruins,47,39,21,18
401,Nels Stewart,Americans,48,29,14,15
401,Nels Stewart,Bruins,11,5,3,2
401,Nels Stewart,Americans,32,30,20,10
401,Nels Stewart,Americans,48,36,19,17
401,Nels Stewart,Americans,46,35,16,19
401,Nels Stewart,Americans,35,13,6,7
402,Aaron Broten,Rockies,2,0,0,0
402,Aaron Broten,Rockies,58,39,15,24
402,Aaron Broten,Devils,73,55,16,39
402,Aaron Broten,Devils,80,36,13,23
402,Aaron Broten,Devils,80,57,22,35
402,Aaron Broten,Devils,66,43,18,25
402,Aaron Broten,Devils,80,79,26,53
402,Aaron Broten,Devils,80,83,26,57
402,Aaron Broten,Devils,80,59,16,43
402,Aaron Broten,Devils,42,18,10,8
402,Aaron Broten,North Stars,35,18,9,9
402,Aaron Broten,Nordiques,20,9,5,4
402,Aaron Broten,Maple Leafs,27,10,6,4
402,Aaron Broten,Jets (1979),25,9,4,5
403,Brian Rafalski,Devils,75,32,5,27
403,Brian Rafalski,Devils,78,52,9,43
403,Brian Rafalski,Devils,76,47,7,40
403,Brian Rafalski,Devils,79,40,3,37
403,Brian Rafalski,Devils,69,36,6,30
403,Brian Rafalski,Devils,82,49,6,43
403,Brian Rafalski,Devils,82,55,8,47
403,Brian Rafalski,Red Wings,73,55,13,42
403,Brian Rafalski,Red Wings,78,59,10,49
403,Brian Rafalski,Red Wings,78,42,8,34
403,Brian Rafalski,Red Wings,63,48,4,44
404,Zach Parise,Devils,81,32,14,18
404,Zach Parise,Devils,82,62,31,31
404,Zach Parise,Devils,81,65,32,33
404,Zach Parise,Devils,82,94,45,49
404,Zach Parise,Devils,81,82,38,44
404,Zach Parise,Devils,13,6,3,3
404,Zach Parise,Devils,82,69,31,38
404,Zach Parise,Wild,48,38,18,20
404,Zach Parise,Wild,67,56,29,27
404,Zach Parise,Wild,11,10,4,6
405,Jere Lehtinen,Stars,57,28,6,22
405,Jere Lehtinen,Stars,63,43,16,27
405,Jere Lehtinen,Stars,72,42,23,19
405,Jere Lehtinen,Stars,74,52,20,32
405,Jere Lehtinen,Stars,17,8,3,5
405,Jere Lehtinen,Stars,74,45,20,25
405,Jere Lehtinen,Stars,73,49,25,24
405,Jere Lehtinen,Stars,80,48,31,17
405,Jere Lehtinen,Stars,58,26,13,13
405,Jere Lehtinen,Stars,80,52,33,19
405,Jere Lehtinen,Stars,73,43,26,17
405,Jere Lehtinen,Stars,48,37,15,22
405,Jere Lehtinen,Stars,48,24,8,16
405,Jere Lehtinen,Stars,58,17,4,13
406,Robert Murray,Blackhawks,64,3,1,2
406,Robert Murray,Blackhawks,77,21,10,11
406,Robert Murray,Blackhawks,70,31,14,17
406,Robert Murray,Blackhawks,79,51,19,32
406,Robert Murray,Blackhawks,74,50,16,34
406,Robert Murray,Blackhawks,77,60,13,47
406,Robert Murray,Blackhawks,45,30,8,22
406,Robert Murray,Blackhawks,79,39,7,32
406,Robert Murray,Blackhawks,78,48,11,37
406,Robert Murray,Blackhawks,80,43,5,38
406,Robert Murray,Blackhawks,80,38,9,29
406,Robert Murray,Blackhawks,79,44,6,38
406,Robert Murray,Blackhawks,62,26,6,20
406,Robert Murray,Blackhawks,15,6,2,4
406,Robert Murray,Blackhawks,49,24,5,19
407,Dave Williams,Maple Leafs,42,29,10,19
407,Dave Williams,Maple Leafs,78,40,21,19
407,Dave Williams,Maple Leafs,77,43,18,25
407,Dave Williams,Maple Leafs,78,50,19,31
407,Dave Williams,Maple Leafs,77,39,19,20
407,Dave Williams,Maple Leafs,55,40,22,18
407,Dave Williams,Canucks,23,13,8,5
407,Dave Williams,Canucks,77,62,35,27
407,Dave Williams,Canucks,77,38,17,21
407,Dave Williams,Canucks,68,21,8,13
407,Dave Williams,Canucks,67,31,15,16
407,Dave Williams,Red Wings,55,11,3,8
407,Dave Williams,Kings,12,7,4,3
407,Dave Williams,Kings,72,49,20,29
407,Dave Williams,Kings,76,34,16,18
407,Dave Williams,Kings,2,0,0,0
407,Dave Williams,Whalers,26,6,6,0
408,Bobby Nystrom,Islanders,11,2,1,1
408,Bobby Nystrom,Islanders,77,41,21,20
408,Bobby Nystrom,Islanders,76,55,27,28
408,Bobby Nystrom,Islanders,80,48,23,25
408,Bobby Nystrom,Islanders,80,56,29,27
408,Bobby Nystrom,Islanders,80,59,30,29
408,Bobby Nystrom,Islanders,78,39,19,20
408,Bobby Nystrom,Islanders,67,39,21,18
408,Bobby Nystrom,Islanders,79,44,14,30
408,Bobby Nystrom,Islanders,74,47,22,25
408,Bobby Nystrom,Islanders,74,30,10,20
408,Bobby Nystrom,Islanders,74,44,15,29
408,Bobby Nystrom,Islanders,36,7,2,5
408,Bobby Nystrom,Islanders,14,2,1,1
409,Patrick Flatley,Islanders,16,9,2,7
409,Patrick Flatley,Islanders,78,51,20,31
409,Patrick Flatley,Islanders,73,52,18,34
409,Patrick Flatley,Islanders,63,51,16,35
409,Patrick Flatley,Islanders,40,24,9,15
409,Patrick Flatley,Islanders,41,25,10,15
409,Patrick Flatley,Islanders,62,49,17,32
409,Patrick Flatley,Islanders,56,45,20,25
409,Patrick Flatley,Islanders,38,36,8,28
409,Patrick Flatley,Islanders,80,60,13,47
409,Patrick Flatley,Islanders,64,42,12,30
409,Patrick Flatley,Islanders,45,27,7,20
409,Patrick Flatley,Islanders,56,17,8,9
409,Patrick Flatley,Rangers,68,22,10,12
410,Donald Audette,Sabres,8,7,4,3
410,Donald Audette,Sabres,63,48,31,17
410,Donald Audette,Sabres,44,19,12,7
410,Donald Audette,Sabres,77,59,29,30
410,Donald Audette,Sabres,46,37,24,13
410,Donald Audette,Sabres,23,25,12,13
410,Donald Audette,Sabres,73,50,28,22
410,Donald Audette,Sabres,75,44,24,20
410,Donald Audette,Kings,49,36,18,18
410,Donald Audette,Kings,49,32,12,20
410,Donald Audette,Thrashers,14,11,7,4
410,Donald Audette,Thrashers,64,71,32,39
410,Donald Audette,Sabres,12,8,2,6
410,Donald Audette,Stars,20,12,4,8
410,Donald Audette,Canadiens,13,6,1,5
410,Donald Audette,Canadiens,54,23,11,12
410,Donald Audette,Canadiens,23,8,3,5
410,Donald Audette,Panthers,28,13,6,7
411,Mike Cammalleri,Kings,28,8,5,3
411,Mike Cammalleri,Kings,31,15,9,6
411,Mike Cammalleri,Kings,80,55,26,29
411,Mike Cammalleri,Kings,81,80,34,46
411,Mike Cammalleri,Kings,63,47,19,28
411,Mike Cammalleri,Flames,81,82,39,43
411,Mike Cammalleri,Canadiens,65,50,26,24
411,Mike Cammalleri,Canadiens,67,47,19,28
411,Mike Cammalleri,Canadiens,38,22,9,13
411,Mike Cammalleri,Flames,28,19,11,8
411,Mike Cammalleri,Flames,44,32,13,19
411,Mike Cammalleri,Flames,63,45,26,19
411,Mike Cammalleri,Devils,8,7,5,2
412,Mark Johnson,Penguins,17,8,3,5
412,Mark Johnson,Penguins,73,33,10,23
412,Mark Johnson,Penguins,46,21,10,11
412,Mark Johnson,North Stars,10,4,2,2
412,Mark Johnson,Whalers,73,69,31,38
412,Mark Johnson,Whalers,79,87,35,52
412,Mark Johnson,Whalers,49,47,19,28
412,Mark Johnson,Blues,17,10,4,6
412,Mark Johnson,Devils,80,62,21,41
412,Mark Johnson,Devils,68,51,25,26
412,Mark Johnson,Devils,54,33,14,19
412,Mark Johnson,Devils,40,38,13,25
412,Mark Johnson,Devils,63,45,16,29
413,Joel Otto,Flames,17,12,4,8
413,Joel Otto,Flames,79,59,25,34
413,Joel Otto,Flames,68,50,19,31
413,Joel Otto,Flames,62,52,13,39
413,Joel Otto,Flames,72,53,23,30
413,Joel Otto,Flames,75,33,13,20
413,Joel Otto,Flames,76,39,19,20
413,Joel Otto,Flames,78,34,13,21
413,Joel Otto,Flames,75,52,19,33
413,Joel Otto,Flames,81,23,11,12
413,Joel Otto,Flames,47,21,8,13
413,Joel Otto,Flyers,67,41,12,29
413,Joel Otto,Flyers,78,32,13,19
413,Joel Otto,Flyers,68,7,3,4
414,Nicklas Backstrom,Capitals,82,69,14,55
414,Nicklas Backstrom,Capitals,82,88,22,66
414,Nicklas Backstrom,Capitals,82,101,33,68
414,Nicklas Backstrom,Capitals,77,65,18,47
414,Nicklas Backstrom,Capitals,42,44,14,30
414,Nicklas Backstrom,Capitals,48,48,8,40
414,Nicklas Backstrom,Capitals,82,79,18,61
414,Nicklas Backstrom,Capitals,13,13,3,10
415,Darryl Sydor,Kings,18,6,1,5
415,Darryl Sydor,Kings,80,29,6,23
415,Darryl Sydor,Kings,84,35,8,27
415,Darryl Sydor,Kings,48,23,4,19
415,Darryl Sydor,Kings,58,12,1,11
415,Darryl Sydor,Stars,26,8,2,6
415,Darryl Sydor,Stars,82,48,8,40
415,Darryl Sydor,Stars,79,46,11,35
415,Darryl Sydor,Stars,74,48,14,34
415,Darryl Sydor,Stars,74,34,8,26
415,Darryl Sydor,Stars,81,47,10,37
415,Darryl Sydor,Stars,78,33,4,29
415,Darryl Sydor,Stars,81,36,5,31
415,Darryl Sydor,Blue Jackets,49,15,2,13
415,Darryl Sydor,Lightning,31,7,1,6
415,Darryl Sydor,Lightning,80,23,4,19
415,Darryl Sydor,Stars,74,21,5,16
415,Darryl Sydor,Penguins,74,13,1,12
415,Darryl Sydor,Penguins,8,2,1,1
415,Darryl Sydor,Stars,65,13,2,11
415,Darryl Sydor,Blues,47,8,0,8
416,Lynn Libett,Red Wings,22,3,2,1
416,Lynn Libett,Red Wings,75,24,10,14
416,Lynn Libett,Red Wings,76,40,20,20
416,Lynn Libett,Red Wings,78,29,16,13
416,Lynn Libett,Red Wings,77,53,31,22
416,Lynn Libett,Red Wings,78,53,19,34
416,Lynn Libett,Red Wings,67,48,24,24
416,Lynn Libett,Red Wings,80,51,23,28
416,Lynn Libett,Red Wings,80,46,20,26
416,Lynn Libett,Red Wings,80,41,14,27
416,Lynn Libett,Red Wings,80,45,23,22
416,Lynn Libett,Red Wings,68,34,15,19
416,Lynn Libett,Penguins,78,26,14,12
416,Lynn Libett,Penguins,43,12,6,6
417,Patrice Bergeron,Bruins,71,39,16,23
417,Patrice Bergeron,Bruins,81,73,31,42
417,Patrice Bergeron,Bruins,77,70,22,48
417,Patrice Bergeron,Bruins,10,7,3,4
417,Patrice Bergeron,Bruins,64,39,8,31
417,Patrice Bergeron,Bruins,73,52,19,33
417,Patrice Bergeron,Bruins,80,57,22,35
417,Patrice Bergeron,Bruins,81,64,22,42
417,Patrice Bergeron,Bruins,42,32,10,22
417,Patrice Bergeron,Bruins,80,62,30,32
417,Patrice Bergeron,Bruins,15,9,2,7
418,Brian Bradley,Flames,5,1,0,1
418,Brian Bradley,Flames,40,28,10,18
418,Brian Bradley,Canucks,11,8,3,5
418,Brian Bradley,Canucks,71,45,18,27
418,Brian Bradley,Canucks,67,48,19,29
418,Brian Bradley,Canucks,44,31,11,20
418,Brian Bradley,Maple Leafs,26,11,0,11
418,Brian Bradley,Maple Leafs,59,31,10,21
418,Brian Bradley,Lightning,80,86,42,44
418,Brian Bradley,Lightning,78,64,24,40
418,Brian Bradley,Lightning,46,40,13,27
418,Brian Bradley,Lightning,75,79,23,56
418,Brian Bradley,Lightning,35,24,7,17
418,Brian Bradley,Lightning,14,7,2,5
419,Dennis Hextall,Rangers,13,5,1,4
419,Dennis Hextall,Kings,28,12,5,7
419,Dennis Hextall,Seals,78,52,21,31
419,Dennis Hextall,North Stars,33,16,6,10
419,Dennis Hextall,North Stars,78,82,30,52
419,Dennis Hextall,North Stars,78,82,20,62
419,Dennis Hextall,North Stars,80,74,17,57
419,Dennis Hextall,North Stars,59,46,11,35
419,Dennis Hextall,Red Wings,17,14,5,9
419,Dennis Hextall,Red Wings,78,46,14,32
419,Dennis Hextall,Red Wings,78,49,16,33
419,Dennis Hextall,Red Wings,20,12,4,8
419,Dennis Hextall,Capitals,26,11,2,9
419,Dennis Hextall,Capitals,15,2,1,1
420,Patrick Kane,Blackhawks,82,72,21,51
420,Patrick Kane,Blackhawks,80,70,25,45
420,Patrick Kane,Blackhawks,82,88,30,58
420,Patrick Kane,Blackhawks,73,73,27,46
420,Patrick Kane,Blackhawks,82,66,23,43
420,Patrick Kane,Blackhawks,47,55,23,32
420,Patrick Kane,Blackhawks,69,69,29,40
420,Patrick Kane,Blackhawks,14,9,4,5
421,Robert Gainey,Canadiens,66,10,3,7
421,Robert Gainey,Canadiens,80,37,17,20
421,Robert Gainey,Canadiens,78,28,15,13
421,Robert Gainey,Canadiens,80,33,14,19
421,Robert Gainey,Canadiens,66,31,15,16
421,Robert Gainey,Canadiens,79,38,20,18
421,Robert Gainey,Canadiens,64,33,14,19
421,Robert Gainey,Canadiens,78,47,23,24
421,Robert Gainey,Canadiens,79,45,21,24
421,Robert Gainey,Canadiens,80,30,12,18
421,Robert Gainey,Canadiens,77,39,17,22
421,Robert Gainey,Canadiens,79,32,19,13
421,Robert Gainey,Canadiens,80,43,20,23
421,Robert Gainey,Canadiens,47,16,8,8
421,Robert Gainey,Canadiens,78,22,11,11
421,Robert Gainey,Canadiens,49,17,10,7
422,Valeri Kamensky,Nordiques,23,21,7,14
422,Valeri Kamensky,Nordiques,32,37,15,22
422,Valeri Kamensky,Nordiques,76,65,28,37
422,Valeri Kamensky,Nordiques,40,30,10,20
422,Valeri Kamensky,Avalanche,81,85,38,47
422,Valeri Kamensky,Avalanche,68,66,28,38
422,Valeri Kamensky,Avalanche,75,66,26,40
422,Valeri Kamensky,Avalanche,65,44,14,30
422,Valeri Kamensky,Rangers,58,32,13,19
422,Valeri Kamensky,Rangers,65,34,14,20
422,Valeri Kamensky,Stars,24,9,3,6
422,Valeri Kamensky,Devils,30,12,4,8
423,William Malone,Penguins,66,37,18,19
423,William Malone,Penguins,78,61,18,43
423,William Malone,Penguins,80,65,35,30
423,William Malone,Penguins,51,51,19,32
423,William Malone,Penguins,62,50,21,29
423,William Malone,Penguins,78,39,15,24
423,William Malone,Penguins,80,61,17,44
423,William Malone,Whalers,78,54,17,37
423,William Malone,Whalers,76,61,22,39
423,William Malone,Whalers,22,13,6,7
423,William Malone,Nordiques,27,8,3,5
423,William Malone,Nordiques,6,1,0,1
424,Ed Jovanovski,Panthers,70,21,10,11
424,Ed Jovanovski,Panthers,61,23,7,16
424,Ed Jovanovski,Panthers,81,23,9,14
424,Ed Jovanovski,Panthers,41,16,3,13
424,Ed Jovanovski,Canucks,31,11,2,9
424,Ed Jovanovski,Canucks,75,26,5,21
424,Ed Jovanovski,Canucks,79,47,12,35
424,Ed Jovanovski,Canucks,82,48,17,31
424,Ed Jovanovski,Canucks,67,46,6,40
424,Ed Jovanovski,Canucks,56,23,7,16
424,Ed Jovanovski,Canucks,44,33,8,25
424,Ed Jovanovski,Coyotes,54,29,11,18
424,Ed Jovanovski,Coyotes,80,51,12,39
424,Ed Jovanovski,Coyotes,82,36,9,27
424,Ed Jovanovski,Coyotes,66,34,10,24
424,Ed Jovanovski,Coyotes,50,14,5,9
424,Ed Jovanovski,Panthers,66,13,3,10
424,Ed Jovanovski,Panthers,6,1,0,1
424,Ed Jovanovski,Panthers,37,5,1,4
425,Derek Roy,Sabres,49,19,9,10
425,Derek Roy,Sabres,70,46,18,28
425,Derek Roy,Sabres,75,63,21,42
425,Derek Roy,Sabres,78,81,32,49
425,Derek Roy,Sabres,82,70,28,42
425,Derek Roy,Sabres,80,69,26,43
425,Derek Roy,Sabres,35,35,10,25
425,Derek Roy,Sabres,80,44,17,27
425,Derek Roy,Stars,30,22,4,18
425,Derek Roy,Canucks,12,6,3,3
425,Derek Roy,Blues,75,37,9,28
425,Derek Roy,Predators,13,7,0,7
426,Gregory Sheppard,Bruins,64,50,24,26
426,Gregory Sheppard,Bruins,75,47,16,31
426,Gregory Sheppard,Bruins,76,78,30,48
426,Gregory Sheppard,Bruins,70,74,31,43
426,Gregory Sheppard,Bruins,77,67,31,36
426,Gregory Sheppard,Bruins,54,59,23,36
426,Gregory Sheppard,Penguins,60,37,15,22
426,Gregory Sheppard,Penguins,76,37,13,24
426,Gregory Sheppard,Penguins,47,28,11,17
426,Gregory Sheppard,Penguins,58,21,11,10
427,Todd Marchant,Rangers,1,0,0,0
427,Todd Marchant,Oilers,3,1,0,1
427,Todd Marchant,Oilers,45,27,13,14
427,Todd Marchant,Oilers,81,38,19,19
427,Todd Marchant,Oilers,79,33,14,19
427,Todd Marchant,Oilers,76,35,14,21
427,Todd Marchant,Oilers,82,36,14,22
427,Todd Marchant,Oilers,82,40,17,23
427,Todd Marchant,Oilers,71,39,13,26
427,Todd Marchant,Oilers,82,34,12,22
427,Todd Marchant,Oilers,77,60,20,40
427,Todd Marchant,Blue Jackets,77,34,9,25
427,Todd Marchant,Blue Jackets,18,9,3,6
427,Todd Marchant,Ducks,61,25,6,19
427,Todd Marchant,Ducks,56,23,8,15
427,Todd Marchant,Ducks,75,16,9,7
427,Todd Marchant,Ducks,72,18,5,13
427,Todd Marchant,Ducks,78,22,9,13
427,Todd Marchant,Ducks,79,8,1,7
428,Pierre Pilote,Blackhawks,20,8,3,5
428,Pierre Pilote,Blackhawks,70,17,3,14
428,Pierre Pilote,Blackhawks,70,30,6,24
428,Pierre Pilote,Blackhawks,70,37,7,30
428,Pierre Pilote,Blackhawks,70,45,7,38
428,Pierre Pilote,Blackhawks,70,35,6,29
428,Pierre Pilote,Blackhawks,59,42,7,35
428,Pierre Pilote,Blackhawks,59,26,8,18
428,Pierre Pilote,Blackhawks,70,53,7,46
428,Pierre Pilote,Blackhawks,68,59,14,45
428,Pierre Pilote,Blackhawks,51,36,2,34
428,Pierre Pilote,Blackhawks,70,52,6,46
428,Pierre Pilote,Blackhawks,74,37,1,36
428,Pierre Pilote,Maple Leafs,69,21,3,18
429,Erik Cole,Hurricanes,81,40,16,24
429,Erik Cole,Hurricanes,53,27,14,13
429,Erik Cole,Hurricanes,80,42,18,24
429,Erik Cole,Hurricanes,60,59,30,29
429,Erik Cole,Hurricanes,71,61,29,32
429,Erik Cole,Hurricanes,73,51,22,29
429,Erik Cole,Oilers,63,27,16,11
429,Erik Cole,Hurricanes,17,15,2,13
429,Erik Cole,Hurricanes,40,16,11,5
429,Erik Cole,Hurricanes,82,52,26,26
429,Erik Cole,Canadiens,82,61,35,26
429,Erik Cole,Canadiens,19,6,3,3
429,Erik Cole,Stars,28,7,6,1
429,Erik Cole,Stars,75,29,16,13
429,Erik Cole,Stars,12,4,3,1
430,Craig Simpson,Penguins,76,28,11,17
430,Craig Simpson,Penguins,72,51,26,25
430,Craig Simpson,Penguins,21,26,13,13
430,Craig Simpson,Oilers,59,64,43,21
430,Craig Simpson,Oilers,66,76,35,41
430,Craig Simpson,Oilers,80,61,29,32
430,Craig Simpson,Oilers,75,57,30,27
430,Craig Simpson,Oilers,79,61,24,37
430,Craig Simpson,Oilers,60,46,24,22
430,Craig Simpson,Sabres,22,16,8,8
430,Craig Simpson,Sabres,24,11,4,7
431,Alexander Semin,Capitals,52,22,10,12
431,Alexander Semin,Capitals,77,73,38,35
431,Alexander Semin,Capitals,63,42,26,16
431,Alexander Semin,Capitals,62,79,34,45
431,Alexander Semin,Capitals,73,84,40,44
431,Alexander Semin,Capitals,65,54,28,26
431,Alexander Semin,Capitals,77,54,21,33
431,Alexander Semin,Hurricanes,44,44,13,31
431,Alexander Semin,Hurricanes,65,42,22,20
431,Alexander Semin,Hurricanes,10,3,0,3
432,Radek Bonk,Senators,42,11,3,8
432,Radek Bonk,Senators,76,35,16,19
432,Radek Bonk,Senators,53,18,5,13
432,Radek Bonk,Senators,65,16,7,9
432,Radek Bonk,Senators,81,32,16,16
432,Radek Bonk,Senators,80,60,23,37
432,Radek Bonk,Senators,74,59,23,36
432,Radek Bonk,Senators,82,70,25,45
432,Radek Bonk,Senators,70,54,22,32
432,Radek Bonk,Senators,66,44,12,32
432,Radek Bonk,Canadiens,61,21,6,15
432,Radek Bonk,Canadiens,74,23,13,10
432,Radek Bonk,Predators,79,29,14,15
432,Radek Bonk,Predators,66,25,9,16
433,Jeff O'Neill,Whalers,65,27,8,19
433,Jeff O'Neill,Whalers,72,30,14,16
433,Jeff O'Neill,Hurricanes,74,39,19,20
433,Jeff O'Neill,Hurricanes,75,31,16,15
433,Jeff O'Neill,Hurricanes,80,63,25,38
433,Jeff O'Neill,Hurricanes,82,67,41,26
433,Jeff O'Neill,Hurricanes,76,64,31,33
433,Jeff O'Neill,Hurricanes,82,61,30,31
433,Jeff O'Neill,Hurricanes,67,34,14,20
433,Jeff O'Neill,Maple Leafs,74,38,19,19
433,Jeff O'Neill,Maple Leafs,74,42,20,22
434,Al Secord,Bruins,71,23,16,7
434,Al Secord,Bruins,77,39,23,16
434,Al Secord,Bruins,18,3,0,3
434,Al Secord,Blackhawks,41,22,13,9
434,Al Secord,Blackhawks,80,75,44,31
434,Al Secord,Blackhawks,80,86,54,32
434,Al Secord,Blackhawks,14,8,4,4
434,Al Secord,Blackhawks,51,26,15,11
434,Al Secord,Blackhawks,80,76,40,36
434,Al Secord,Blackhawks,77,58,29,29
434,Al Secord,Maple Leafs,74,42,15,27
434,Al Secord,Maple Leafs,40,15,5,10
434,Al Secord,Flyers,20,1,1,0
434,Al Secord,Blackhawks,43,21,14,7
435,Sylvain Turgeon,Whalers,76,72,40,32
435,Sylvain Turgeon,Whalers,64,62,31,31
435,Sylvain Turgeon,Whalers,76,79,45,34
435,Sylvain Turgeon,Whalers,41,36,23,13
435,Sylvain Turgeon,Whalers,71,49,23,26
435,Sylvain Turgeon,Whalers,42,30,16,14
435,Sylvain Turgeon,Devils,72,47,30,17
435,Sylvain Turgeon,Canadiens,19,12,5,7
435,Sylvain Turgeon,Canadiens,56,20,9,11
435,Sylvain Turgeon,Senators,72,43,25,18
435,Sylvain Turgeon,Senators,47,26,11,15
435,Sylvain Turgeon,Senators,33,19,11,8
436,Darcy Rota,Blackhawks,74,33,21,12
436,Darcy Rota,Blackhawks,78,44,22,22
436,Darcy Rota,Blackhawks,79,37,20,17
436,Darcy Rota,Blackhawks,76,46,24,22
436,Darcy Rota,Blackhawks,78,37,17,20
436,Darcy Rota,Blackhawks,63,30,13,17
436,Darcy Rota,Flames,13,14,9,5
436,Darcy Rota,Flames,44,18,10,8
436,Darcy Rota,Canucks,26,11,5,6
436,Darcy Rota,Canucks,80,56,25,31
436,Darcy Rota,Canucks,51,40,20,20
436,Darcy Rota,Canucks,73,81,42,39
436,Darcy Rota,Canucks,59,48,28,20
437,Ales Hemsky,Oilers,59,30,6,24
437,Ales Hemsky,Oilers,71,34,12,22
437,Ales Hemsky,Oilers,81,77,19,58
437,Ales Hemsky,Oilers,64,53,13,40
437,Ales Hemsky,Oilers,74,71,20,51
437,Ales Hemsky,Oilers,72,66,23,43
437,Ales Hemsky,Oilers,22,22,7,15
437,Ales Hemsky,Oilers,47,42,14,28
437,Ales Hemsky,Oilers,69,36,10,26
437,Ales Hemsky,Oilers,38,20,9,11
437,Ales Hemsky,Oilers,55,26,9,17
437,Ales Hemsky,Senators,20,17,4,13
437,Ales Hemsky,Stars,13,1,0,1
438,Keith Crowder,Bruins,47,25,13,12
438,Keith Crowder,Bruins,71,44,23,21
438,Keith Crowder,Bruins,74,74,35,39
438,Keith Crowder,Bruins,63,52,24,28
438,Keith Crowder,Bruins,79,70,32,38
438,Keith Crowder,Bruins,78,84,38,46
438,Keith Crowder,Bruins,58,52,22,30
438,Keith Crowder,Bruins,68,43,17,26
438,Keith Crowder,Bruins,69,33,15,18
438,Keith Crowder,Kings,55,17,4,13
439,Tony Granato,Rangers,78,63,36,27
439,Tony Granato,Rangers,37,25,7,18
439,Tony Granato,Kings,19,11,5,6
439,Tony Granato,Kings,68,64,30,34
439,Tony Granato,Kings,80,68,39,29
439,Tony Granato,Kings,81,82,37,45
439,Tony Granato,Kings,50,21,7,14
439,Tony Granato,Kings,33,24,13,11
439,Tony Granato,Kings,49,35,17,18
439,Tony Granato,Sharks,76,40,25,15
439,Tony Granato,Sharks,59,25,16,9
439,Tony Granato,Sharks,35,12,6,6
439,Tony Granato,Sharks,48,13,6,7
439,Tony Granato,Sharks,60,9,4,5
440,Patrick Sharp,Flyers,3,0,0,0
440,Patrick Sharp,Flyers,41,7,5,2
440,Patrick Sharp,Flyers,22,8,5,3
440,Patrick Sharp,Blackhawks,50,23,9,14
440,Patrick Sharp,Blackhawks,80,35,20,15
440,Patrick Sharp,Blackhawks,80,62,36,26
440,Patrick Sharp,Blackhawks,61,44,26,18
440,Patrick Sharp,Blackhawks,82,66,25,41
440,Patrick Sharp,Blackhawks,74,71,34,37
440,Patrick Sharp,Blackhawks,74,69,33,36
440,Patrick Sharp,Blackhawks,28,20,6,14
440,Patrick Sharp,Blackhawks,82,78,34,44
440,Patrick Sharp,Blackhawks,13,9,3,6
441,Andre Boudrias,Canadiens,4,5,1,4
441,Andre Boudrias,Canadiens,1,0,0,0
441,Andre Boudrias,Canadiens,2,1,0,1
441,Andre Boudrias,North Stars,74,53,18,35
441,Andre Boudrias,North Stars,53,13,4,9
441,Andre Boudrias,Blackhawks,20,14,4,10
441,Andre Boudrias,Blues,50,17,3,14
441,Andre Boudrias,Canucks,77,66,25,41
441,Andre Boudrias,Canucks,78,61,27,34
441,Andre Boudrias,Canucks,77,70,30,40
441,Andre Boudrias,Canucks,78,75,16,59
441,Andre Boudrias,Canucks,77,78,16,62
441,Andre Boudrias,Canucks,71,38,7,31
442,Dirk Graham,North Stars,6,2,1,1
442,Dirk Graham,North Stars,36,23,12,11
442,Dirk Graham,North Stars,80,55,22,33
442,Dirk Graham,North Stars,76,54,25,29
442,Dirk Graham,North Stars,28,12,7,5
442,Dirk Graham,Blackhawks,42,36,17,19
442,Dirk Graham,Blackhawks,80,78,33,45
442,Dirk Graham,Blackhawks,73,54,22,32
442,Dirk Graham,Blackhawks,80,45,24,21
442,Dirk Graham,Blackhawks,80,47,17,30
442,Dirk Graham,Blackhawks,84,37,20,17
442,Dirk Graham,Blackhawks,67,33,15,18
442,Dirk Graham,Blackhawks,40,13,4,9
443,Andy McDonald,Ducks,16,1,1,0
443,Andy McDonald,Ducks,53,28,7,21
443,Andy McDonald,Ducks,46,21,10,11
443,Andy McDonald,Ducks,79,30,9,21
443,Andy McDonald,Ducks,82,85,34,51
443,Andy McDonald,Ducks,82,78,27,51
443,Andy McDonald,Ducks,33,16,4,12
443,Andy McDonald,Blues,49,36,14,22
443,Andy McDonald,Blues,46,44,15,29
443,Andy McDonald,Blues,79,57,24,33
443,Andy McDonald,Blues,58,50,20,30
443,Andy McDonald,Blues,25,22,10,12
443,Andy McDonald,Blues,37,21,7,14
444,Steve Rucchin,Ducks,43,17,6,11
444,Steve Rucchin,Ducks,64,44,19,25
444,Steve Rucchin,Ducks,79,67,19,48
444,Steve Rucchin,Ducks,72,53,17,36
444,Steve Rucchin,Ducks,69,62,23,39
444,Steve Rucchin,Ducks,71,57,19,38
444,Steve Rucchin,Ducks,16,8,3,5
444,Steve Rucchin,Ducks,38,23,7,16
444,Steve Rucchin,Ducks,82,58,20,38
444,Steve Rucchin,Ducks,82,43,20,23
444,Steve Rucchin,Rangers,72,36,13,23
444,Steve Rucchin,Thrashers,47,21,5,16
445,Nelson Emerson,Blues,4,3,0,3
445,Nelson Emerson,Blues,79,59,23,36
445,Nelson Emerson,Blues,82,73,22,51
445,Nelson Emerson,Jets (1979),83,74,33,41
445,Nelson Emerson,Jets (1979),48,37,14,23
445,Nelson Emerson,Whalers,81,58,29,29
445,Nelson Emerson,Whalers,66,38,9,29
445,Nelson Emerson,Hurricanes,81,45,21,24
445,Nelson Emerson,Hurricanes,35,21,8,13
445,Nelson Emerson,Blackhawks,27,14,4,10
445,Nelson Emerson,Senators,3,2,1,1
445,Nelson Emerson,Thrashers,58,33,14,19
445,Nelson Emerson,Kings,5,2,1,1
445,Nelson Emerson,Kings,78,22,11,11
445,Nelson Emerson,Kings,41,7,5,2
446,Brian Gionta,Devils,33,11,4,7
446,Brian Gionta,Devils,58,25,12,13
446,Brian Gionta,Devils,75,29,21,8
446,Brian Gionta,Devils,82,89,48,41
446,Brian Gionta,Devils,62,45,25,20
446,Brian Gionta,Devils,82,53,22,31
446,Brian Gionta,Devils,81,60,20,40
446,Brian Gionta,Canadiens,61,46,28,18
446,Brian Gionta,Canadiens,82,46,29,17
446,Brian Gionta,Canadiens,31,15,8,7
446,Brian Gionta,Canadiens,48,26,14,12
446,Brian Gionta,Canadiens,81,40,18,22
446,Brian Gionta,Sabres,15,2,0,2
447,Marco Sturm,Sharks,74,30,10,20
447,Marco Sturm,Sharks,78,38,16,22
447,Marco Sturm,Sharks,74,27,12,15
447,Marco Sturm,Sharks,81,32,14,18
447,Marco Sturm,Sharks,77,41,21,20
447,Marco Sturm,Sharks,82,48,28,20
447,Marco Sturm,Sharks,64,41,21,20
447,Marco Sturm,Sharks,23,16,6,10
447,Marco Sturm,Bruins,51,43,23,20
447,Marco Sturm,Bruins,76,44,27,17
447,Marco Sturm,Bruins,80,56,27,29
447,Marco Sturm,Bruins,19,13,7,6
447,Marco Sturm,Bruins,76,37,22,15
447,Marco Sturm,Kings,17,9,4,5
447,Marco Sturm,Capitals,18,7,1,6
447,Marco Sturm,Canucks,6,0,0,0
447,Marco Sturm,Panthers,42,5,3,2
448,Jason Blake,Kings,1,1,1,0
448,Jason Blake,Kings,64,23,5,18
448,Jason Blake,Kings,17,4,1,3
448,Jason Blake,Islanders,30,12,4,8
448,Jason Blake,Islanders,82,18,8,10
448,Jason Blake,Islanders,81,55,25,30
448,Jason Blake,Islanders,75,47,22,25
448,Jason Blake,Islanders,76,57,28,29
448,Jason Blake,Islanders,82,69,40,29
448,Jason Blake,Maple Leafs,82,52,15,37
448,Jason Blake,Maple Leafs,78,63,25,38
448,Jason Blake,Maple Leafs,56,26,10,16
448,Jason Blake,Ducks,26,15,6,9
448,Jason Blake,Ducks,76,32,16,16
448,Jason Blake,Ducks,45,12,7,5
449,Bruce Driver,Devils,4,2,0,2
449,Bruce Driver,Devils,67,32,9,23
449,Bruce Driver,Devils,40,18,3,15
449,Bruce Driver,Devils,74,34,6,28
449,Bruce Driver,Devils,74,55,15,40
449,Bruce Driver,Devils,27,16,1,15
449,Bruce Driver,Devils,75,53,7,46
449,Bruce Driver,Devils,73,45,9,36
449,Bruce Driver,Devils,78,42,7,35
449,Bruce Driver,Devils,83,54,14,40
449,Bruce Driver,Devils,66,32,8,24
449,Bruce Driver,Devils,41,16,4,12
449,Bruce Driver,Rangers,66,37,3,34
449,Bruce Driver,Rangers,79,30,5,25
449,Bruce Driver,Rangers,75,20,5,15
450,Chris Kunitz,Ducks,21,6,0,6
450,Chris Kunitz,Thrashers,2,0,0,0
450,Chris Kunitz,Ducks,67,41,19,22
450,Chris Kunitz,Ducks,81,60,25,35
450,Chris Kunitz,Ducks,82,50,21,29
450,Chris Kunitz,Ducks,62,35,16,19
450,Chris Kunitz,Penguins,20,18,7,11
450,Chris Kunitz,Penguins,50,32,13,19
450,Chris Kunitz,Penguins,66,48,23,25
450,Chris Kunitz,Penguins,82,61,26,35
450,Chris Kunitz,Penguins,48,52,22,30
450,Chris Kunitz,Penguins,78,68,35,33
450,Chris Kunitz,Penguins,12,14,8,6
451,Jason Allison,Capitals,2,1,0,1
451,Jason Allison,Capitals,12,3,2,1
451,Jason Allison,Capitals,19,3,0,3
451,Jason Allison,Capitals,53,22,5,17
451,Jason Allison,Bruins,19,12,3,9
451,Jason Allison,Bruins,81,83,33,50
451,Jason Allison,Bruins,82,76,23,53
451,Jason Allison,Bruins,37,28,10,18
451,Jason Allison,Bruins,82,95,36,59
451,Jason Allison,Kings,73,74,19,55
451,Jason Allison,Kings,26,28,6,22
451,Jason Allison,Maple Leafs,66,60,17,43
452,Donald Marcotte,Bruins,1,0,0,0
452,Donald Marcotte,Bruins,7,1,1,0
452,Donald Marcotte,Bruins,35,12,9,3
452,Donald Marcotte,Bruins,75,28,15,13
452,Donald Marcotte,Bruins,47,10,6,4
452,Donald Marcotte,Bruins,78,55,24,31
452,Donald Marcotte,Bruins,78,50,24,26
452,Donald Marcotte,Bruins,80,64,31,33
452,Donald Marcotte,Bruins,58,36,16,20
452,Donald Marcotte,Bruins,80,45,27,18
452,Donald Marcotte,Bruins,77,54,20,34
452,Donald Marcotte,Bruins,79,47,20,27
452,Donald Marcotte,Bruins,32,15,4,11
452,Donald Marcotte,Bruins,72,33,20,13
452,Donald Marcotte,Bruins,69,34,13,21
453,Claude Larose,Canadiens,4,0,0,0
453,Claude Larose,Canadiens,21,2,1,1
453,Claude Larose,Canadiens,68,37,21,16
453,Claude Larose,Canadiens,64,33,15,18
453,Claude Larose,Canadiens,69,35,19,16
453,Claude Larose,Canadiens,42,11,2,9
453,Claude Larose,North Stars,67,62,25,37
453,Claude Larose,North Stars,75,47,24,23
453,Claude Larose,Canadiens,64,23,10,13
453,Claude Larose,Canadiens,77,38,20,18
453,Claude Larose,Canadiens,73,34,11,23
453,Claude Larose,Canadiens,39,24,17,7
453,Claude Larose,Canadiens,8,3,1,2
453,Claude Larose,Blues,56,27,10,17
453,Claude Larose,Blues,67,38,13,25
453,Claude Larose,Blues,80,48,29,19
453,Claude Larose,Blues,69,21,8,13
454,Michal Handzus,Blues,66,16,4,12
454,Michal Handzus,Blues,81,53,25,28
454,Michal Handzus,Blues,36,24,10,14
454,Michal Handzus,Coyotes,10,8,4,4
454,Michal Handzus,Coyotes,79,45,15,30
454,Michal Handzus,Flyers,82,44,23,21
454,Michal Handzus,Flyers,82,58,20,38
454,Michal Handzus,Flyers,73,44,11,33
454,Michal Handzus,Blackhawks,8,8,3,5
454,Michal Handzus,Kings,82,21,7,14
454,Michal Handzus,Kings,82,42,18,24
454,Michal Handzus,Kings,81,42,20,22
454,Michal Handzus,Kings,82,30,12,18
454,Michal Handzus,Sharks,67,24,7,17
454,Michal Handzus,Sharks,28,2,1,1
454,Michal Handzus,Blackhawks,11,6,1,5
454,Michal Handzus,Blackhawks,59,16,4,12
455,Tod Sloan,Maple Leafs,1,0,0,0
455,Tod Sloan,Maple Leafs,29,7,3,4
455,Tod Sloan,Maple Leafs,70,56,31,25
455,Tod Sloan,Maple Leafs,68,48,25,23
455,Tod Sloan,Maple Leafs,70,25,15,10
455,Tod Sloan,Maple Leafs,67,43,11,32
455,Tod Sloan,Maple Leafs,63,28,13,15
455,Tod Sloan,Maple Leafs,70,66,37,29
455,Tod Sloan,Maple Leafs,52,35,14,21
455,Tod Sloan,Maple Leafs,59,38,13,25
455,Tod Sloan,Blackhawks,59,62,27,35
455,Tod Sloan,Blackhawks,70,40,20,20
455,Tod Sloan,Blackhawks,67,34,11,23
456,Andre Savard,Bruins,72,30,16,14
456,Andre Savard,Bruins,77,44,19,25
456,Andre Savard,Bruins,79,40,17,23
456,Andre Savard,Sabres,80,60,25,35
456,Andre Savard,Sabres,80,39,19,20
456,Andre Savard,Sabres,65,40,18,22
456,Andre Savard,Sabres,33,13,3,10
456,Andre Savard,Sabres,79,74,31,43
456,Andre Savard,Sabres,62,38,18,20
456,Andre Savard,Sabres,68,41,16,25
456,Andre Savard,Nordiques,60,44,20,24
456,Andre Savard,Nordiques,35,19,9,10
457,Mike Fisher,Senators,32,9,4,5
457,Mike Fisher,Senators,60,19,7,12
457,Mike Fisher,Senators,58,24,15,9
457,Mike Fisher,Senators,74,38,18,20
457,Mike Fisher,Senators,24,10,4,6
457,Mike Fisher,Senators,68,44,22,22
457,Mike Fisher,Senators,68,48,22,26
457,Mike Fisher,Senators,79,47,23,24
457,Mike Fisher,Senators,78,32,13,19
457,Mike Fisher,Senators,79,53,25,28
457,Mike Fisher,Senators,55,24,14,10
457,Mike Fisher,Predators,27,12,5,7
457,Mike Fisher,Predators,72,51,24,27
457,Mike Fisher,Predators,38,21,10,11
457,Mike Fisher,Predators,75,49,20,29
458,Craig MacTavish,Bruins,46,28,11,17
458,Craig MacTavish,Bruins,24,8,3,5
458,Craig MacTavish,Bruins,2,1,0,1
458,Craig MacTavish,Bruins,75,30,10,20
458,Craig MacTavish,Bruins,70,43,20,23
458,Craig MacTavish,Oilers,74,47,23,24
458,Craig MacTavish,Oilers,79,39,20,19
458,Craig MacTavish,Oilers,80,32,15,17
458,Craig MacTavish,Oilers,80,52,21,31
458,Craig MacTavish,Oilers,80,43,21,22
458,Craig MacTavish,Oilers,80,32,17,15
458,Craig MacTavish,Oilers,80,30,12,18
458,Craig MacTavish,Oilers,82,30,10,20
458,Craig MacTavish,Oilers,66,26,16,10
458,Craig MacTavish,Rangers,12,6,4,2
458,Craig MacTavish,Flyers,45,12,3,9
458,Craig MacTavish,Flyers,55,13,5,8
458,Craig MacTavish,Blues,13,1,0,1
458,Craig MacTavish,Blues,50,7,2,5
459,Gerard Gallant,Red Wings,32,18,6,12
459,Gerard Gallant,Red Wings,52,39,20,19
459,Gerard Gallant,Red Wings,80,72,38,34
459,Gerard Gallant,Red Wings,73,73,34,39
459,Gerard Gallant,Red Wings,76,93,39,54
459,Gerard Gallant,Red Wings,69,80,36,44
459,Gerard Gallant,Red Wings,45,26,10,16
459,Gerard Gallant,Red Wings,69,36,14,22
459,Gerard Gallant,Red Wings,67,30,10,20
459,Gerard Gallant,Lightning,51,13,4,9
459,Gerard Gallant,Lightning,1,0,0,0
460,Yvon Lambert,Canadiens,1,0,0,0
460,Yvon Lambert,Canadiens,60,16,6,10
460,Yvon Lambert,Canadiens,80,67,32,35
460,Yvon Lambert,Canadiens,80,67,32,35
460,Yvon Lambert,Canadiens,79,52,24,28
460,Yvon Lambert,Canadiens,77,40,18,22
460,Yvon Lambert,Canadiens,79,66,26,40
460,Yvon Lambert,Canadiens,77,53,21,32
460,Yvon Lambert,Canadiens,73,54,22,32
460,Yvon Lambert,Sabres,77,64,25,39
461,Ron Murphy,Rangers,15,4,3,1
461,Ron Murphy,Rangers,27,4,1,3
461,Ron Murphy,Rangers,66,30,14,16
461,Ron Murphy,Rangers,66,44,16,28
461,Ron Murphy,Rangers,33,19,7,12
461,Ron Murphy,Blackhawks,69,28,11,17
461,Ron Murphy,Blackhawks,59,47,17,30
461,Ron Murphy,Blackhawks,63,36,15,21
461,Ron Murphy,Blackhawks,70,40,21,19
461,Ron Murphy,Blackhawks,60,28,12,16
461,Ron Murphy,Blackhawks,68,34,18,16
461,Ron Murphy,Blackhawks,70,19,11,8
461,Ron Murphy,Red Wings,58,39,20,19
461,Ron Murphy,Red Wings,32,17,10,7
461,Ron Murphy,Bruins,2,1,0,1
461,Ron Murphy,Bruins,39,27,11,16
461,Ron Murphy,Bruins,12,1,0,1
461,Ron Murphy,Bruins,60,54,16,38
461,Ron Murphy,Bruins,20,7,2,5
462,James Fox,Kings,71,43,18,25
462,James Fox,Kings,77,68,30,38
462,James Fox,Kings,77,68,28,40
462,James Fox,Kings,80,72,30,42
462,James Fox,Kings,79,83,30,53
462,James Fox,Kings,39,31,14,17
462,James Fox,Kings,76,61,19,42
462,James Fox,Kings,68,51,16,35
462,James Fox,Kings,11,2,1,1
463,Dale McCourt,Red Wings,76,72,33,39
463,Dale McCourt,Red Wings,79,71,28,43
463,Dale McCourt,Red Wings,80,81,30,51
463,Dale McCourt,Red Wings,80,86,30,56
463,Dale McCourt,Red Wings,26,27,13,14
463,Dale McCourt,Sabres,52,42,20,22
463,Dale McCourt,Sabres,62,52,20,32
463,Dale McCourt,Sabres,5,4,1,3
463,Dale McCourt,Maple Leafs,72,43,19,24
464,Lubomir Visnovsky,Kings,81,39,7,32
464,Lubomir Visnovsky,Kings,72,21,4,17
464,Lubomir Visnovsky,Kings,57,24,8,16
464,Lubomir Visnovsky,Kings,58,29,8,21
464,Lubomir Visnovsky,Kings,80,67,17,50
464,Lubomir Visnovsky,Kings,69,58,18,40
464,Lubomir Visnovsky,Kings,82,41,8,33
464,Lubomir Visnovsky,Oilers,50,31,8,23
464,Lubomir Visnovsky,Oilers,57,32,10,22
464,Lubomir Visnovsky,Ducks,16,13,5,8
464,Lubomir Visnovsky,Ducks,81,68,18,50
464,Lubomir Visnovsky,Ducks,68,27,6,21
464,Lubomir Visnovsky,Islanders,35,14,3,11
464,Lubomir Visnovsky,Islanders,24,11,3,8
464,Lubomir Visnovsky,Islanders,7,3,1,2
465,Paul Henderson,Red Wings,2,0,0,0
465,Paul Henderson,Red Wings,32,6,3,3
465,Paul Henderson,Red Wings,70,21,8,13
465,Paul Henderson,Red Wings,69,46,22,24
465,Paul Henderson,Red Wings,46,40,21,19
465,Paul Henderson,Red Wings,50,33,13,20
465,Paul Henderson,Maple Leafs,13,11,5,6
465,Paul Henderson,Maple Leafs,74,59,27,32
465,Paul Henderson,Maple Leafs,67,42,20,22
465,Paul Henderson,Maple Leafs,72,60,30,30
465,Paul Henderson,Maple Leafs,73,57,38,19
465,Paul Henderson,Maple Leafs,40,34,18,16
465,Paul Henderson,Maple Leafs,69,55,24,31
465,Paul Henderson,Flames,30,13,7,6
466,Phil Kessel,Bruins,70,29,11,18
466,Phil Kessel,Bruins,82,37,19,18
466,Phil Kessel,Bruins,70,60,36,24
466,Phil Kessel,Maple Leafs,70,55,30,25
466,Phil Kessel,Maple Leafs,82,64,32,32
466,Phil Kessel,Maple Leafs,82,82,37,45
466,Phil Kessel,Maple Leafs,48,52,20,32
466,Phil Kessel,Maple Leafs,82,80,37,43
466,Phil Kessel,Maple Leafs,13,18,7,11
467,Radim Vrbata,Avalanche,52,30,18,12
467,Radim Vrbata,Avalanche,66,30,11,19
467,Radim Vrbata,Hurricanes,10,5,5,0
467,Radim Vrbata,Hurricanes,80,25,12,13
467,Radim Vrbata,Hurricanes,16,5,2,3
467,Radim Vrbata,Blackhawks,45,34,13,21
467,Radim Vrbata,Blackhawks,77,41,14,27
467,Radim Vrbata,Coyotes,76,56,27,29
467,Radim Vrbata,Lightning,18,6,3,3
467,Radim Vrbata,Coyotes,82,43,24,19
467,Radim Vrbata,Coyotes,79,48,19,29
467,Radim Vrbata,Coyotes,77,62,35,27
467,Radim Vrbata,Coyotes,34,28,12,16
467,Radim Vrbata,Coyotes,80,51,20,31
467,Radim Vrbata,Canucks,14,13,6,7
468,Dallas Drake,Red Wings,72,44,18,26
468,Dallas Drake,Red Wings,47,32,10,22
468,Dallas Drake,Jets (1979),15,8,3,5
468,Dallas Drake,Jets (1979),43,26,8,18
468,Dallas Drake,Jets (1979),69,39,19,20
468,Dallas Drake,Coyotes,63,36,17,19
468,Dallas Drake,Coyotes,60,40,11,29
468,Dallas Drake,Coyotes,53,31,9,22
468,Dallas Drake,Coyotes,79,45,15,30
468,Dallas Drake,Blues,82,41,12,29
468,Dallas Drake,Blues,80,26,11,15
468,Dallas Drake,Blues,80,30,20,10
468,Dallas Drake,Blues,79,35,13,22
468,Dallas Drake,Blues,62,26,2,24
468,Dallas Drake,Blues,60,12,6,6
468,Dallas Drake,Red Wings,65,6,3,3
469,Eric Vail,Flames,23,11,2,9
469,Eric Vail,Flames,72,60,39,21
469,Eric Vail,Flames,60,47,16,31
469,Eric Vail,Flames,78,71,32,39
469,Eric Vail,Flames,79,58,22,36
469,Eric Vail,Flames,80,83,35,48
469,Eric Vail,Flames,77,53,28,25
469,Eric Vail,Flames,64,64,28,36
469,Eric Vail,Flames,6,5,4,1
469,Eric Vail,Red Wings,52,24,10,14
470,Darcy Tucker,Canadiens,3,0,0,0
470,Darcy Tucker,Canadiens,73,20,7,13
470,Darcy Tucker,Canadiens,39,6,1,5
470,Darcy Tucker,Lightning,35,14,6,8
470,Darcy Tucker,Lightning,82,43,21,22
470,Darcy Tucker,Lightning,50,34,14,20
470,Darcy Tucker,Maple Leafs,27,17,7,10
470,Darcy Tucker,Maple Leafs,82,37,16,21
470,Darcy Tucker,Maple Leafs,77,59,24,35
470,Darcy Tucker,Maple Leafs,77,36,10,26
470,Darcy Tucker,Maple Leafs,64,32,21,11
470,Darcy Tucker,Maple Leafs,74,61,28,33
470,Darcy Tucker,Maple Leafs,56,43,24,19
470,Darcy Tucker,Maple Leafs,74,34,18,16
470,Darcy Tucker,Avalanche,63,16,8,8
470,Darcy Tucker,Avalanche,71,24,10,14
471,Busher Jackson,Maple Leafs,31,18,12,6
471,Busher Jackson,Maple Leafs,43,31,18,13
471,Busher Jackson,Maple Leafs,48,53,28,25
471,Busher Jackson,Maple Leafs,48,44,27,17
471,Busher Jackson,Maple Leafs,38,38,20,18
471,Busher Jackson,Maple Leafs,42,44,22,22
471,Busher Jackson,Maple Leafs,47,22,11,11
471,Busher Jackson,Maple Leafs,46,40,21,19
471,Busher Jackson,Maple Leafs,48,34,17,17
471,Busher Jackson,Maple Leafs,41,27,10,17
471,Busher Jackson,Americans,43,20,12,8
471,Busher Jackson,Americans,46,26,8,18
471,Busher Jackson,Bruins,26,12,5,7
471,Busher Jackson,Bruins,44,34,19,15
471,Busher Jackson,Bruins,42,32,11,21
472,Michael Ryder,Canadiens,81,63,25,38
472,Michael Ryder,Canadiens,81,55,30,25
472,Michael Ryder,Canadiens,82,58,30,28
472,Michael Ryder,Canadiens,70,31,14,17
472,Michael Ryder,Bruins,74,53,27,26
472,Michael Ryder,Bruins,82,33,18,15
472,Michael Ryder,Bruins,79,41,18,23
472,Michael Ryder,Stars,82,62,35,27
472,Michael Ryder,Stars,19,14,6,8
472,Michael Ryder,Canadiens,27,21,10,11
472,Michael Ryder,Devils,82,34,18,16
472,Michael Ryder,Devils,14,9,4,5
473,Dit Clapper,Bruins,40,5,4,1
473,Dit Clapper,Bruins,40,11,9,2
473,Dit Clapper,Bruins,44,61,41,20
473,Dit Clapper,Bruins,43,30,22,8
473,Dit Clapper,Bruins,48,39,17,22
473,Dit Clapper,Bruins,48,28,14,14
473,Dit Clapper,Bruins,48,22,10,12
473,Dit Clapper,Bruins,48,37,21,16
473,Dit Clapper,Bruins,44,25,12,13
473,Dit Clapper,Bruins,48,25,17,8
473,Dit Clapper,Bruins,46,15,6,9
473,Dit Clapper,Bruins,42,26,13,13
473,Dit Clapper,Bruins,44,28,10,18
473,Dit Clapper,Bruins,48,26,8,18
473,Dit Clapper,Bruins,32,15,3,12
473,Dit Clapper,Bruins,38,23,5,18
473,Dit Clapper,Bruins,50,31,6,25
473,Dit Clapper,Bruins,46,22,8,14
473,Dit Clapper,Bruins,30,5,2,3
473,Dit Clapper,Bruins,6,0,0,0
474,John McKenzie,Blackhawks,32,7,3,4
474,John McKenzie,Red Wings,59,20,8,12
474,John McKenzie,Red Wings,16,4,3,1
474,John McKenzie,Blackhawks,45,18,9,9
474,John McKenzie,Blackhawks,51,18,8,10
474,John McKenzie,Rangers,35,11,6,5
474,John McKenzie,Bruins,36,22,13,9
474,John McKenzie,Bruins,69,36,17,19
474,John McKenzie,Bruins,74,66,28,38
474,John McKenzie,Bruins,60,56,29,27
474,John McKenzie,Bruins,72,70,29,41
474,John McKenzie,Bruins,65,77,31,46
474,John McKenzie,Bruins,77,69,22,47
475,Mike Richards,Flyers,79,34,11,23
475,Mike Richards,Flyers,59,32,10,22
475,Mike Richards,Flyers,73,75,28,47
475,Mike Richards,Flyers,79,80,30,50
475,Mike Richards,Flyers,82,62,31,31
475,Mike Richards,Flyers,81,66,23,43
475,Mike Richards,Kings,74,44,18,26
475,Mike Richards,Kings,48,32,12,20
475,Mike Richards,Kings,82,41,11,30
475,Mike Richards,Kings,14,7,2,5
476,Howie Morenz,Canadiens,24,16,13,3
476,Howie Morenz,Canadiens,30,39,28,11
476,Howie Morenz,Canadiens,31,26,23,3
476,Howie Morenz,Canadiens,44,32,25,7
476,Howie Morenz,Canadiens,43,51,33,18
476,Howie Morenz,Canadiens,42,27,17,10
476,Howie Morenz,Canadiens,44,50,40,10
476,Howie Morenz,Canadiens,39,51,28,23
476,Howie Morenz,Canadiens,48,49,24,25
476,Howie Morenz,Canadiens,46,35,14,21
476,Howie Morenz,Canadiens,39,21,8,13
476,Howie Morenz,Blackhawks,48,34,8,26
476,Howie Morenz,Blackhawks,23,15,4,11
476,Howie Morenz,Rangers,19,6,2,4
476,Howie Morenz,Canadiens,30,20,4,16
477,Jeff Carter,Flyers,81,42,23,19
477,Jeff Carter,Flyers,62,37,14,23
477,Jeff Carter,Flyers,82,53,29,24
477,Jeff Carter,Flyers,82,84,46,38
477,Jeff Carter,Flyers,74,61,33,28
477,Jeff Carter,Flyers,80,66,36,30
477,Jeff Carter,Blue Jackets,39,25,15,10
477,Jeff Carter,Kings,16,9,6,3
477,Jeff Carter,Kings,48,33,26,7
477,Jeff Carter,Kings,72,50,27,23
477,Jeff Carter,Kings,14,12,5,7
478,Sid Abel,Red Wings,15,2,1,1
478,Sid Abel,Red Wings,24,6,1,5
478,Sid Abel,Red Wings,47,33,11,22
478,Sid Abel,Red Wings,48,49,18,31
478,Sid Abel,Red Wings,49,42,18,24
478,Sid Abel,Red Wings,7,2,0,2
478,Sid Abel,Red Wings,60,48,19,29
478,Sid Abel,Red Wings,60,44,14,30
478,Sid Abel,Red Wings,60,54,28,26
478,Sid Abel,Red Wings,69,69,34,35
478,Sid Abel,Red Wings,69,61,23,38
478,Sid Abel,Red Wings,62,53,17,36
478,Sid Abel,Blackhawks,39,9,5,4
478,Sid Abel,Blackhawks,3,0,0,0
479,Shawn Horcoff,Oilers,49,16,9,7
479,Shawn Horcoff,Oilers,61,22,8,14
479,Shawn Horcoff,Oilers,78,33,12,21
479,Shawn Horcoff,Oilers,80,40,15,25
479,Shawn Horcoff,Oilers,79,73,22,51
479,Shawn Horcoff,Oilers,80,51,16,35
479,Shawn Horcoff,Oilers,53,50,21,29
479,Shawn Horcoff,Oilers,80,53,17,36
479,Shawn Horcoff,Oilers,77,36,13,23
479,Shawn Horcoff,Oilers,47,27,9,18
479,Shawn Horcoff,Oilers,81,34,13,21
479,Shawn Horcoff,Oilers,31,12,7,5
479,Shawn Horcoff,Stars,77,20,7,13
479,Shawn Horcoff,Stars,13,5,2,3
480,Douglas Risebrough,Canadiens,64,47,15,32
480,Douglas Risebrough,Canadiens,80,44,16,28
480,Douglas Risebrough,Canadiens,78,60,22,38
480,Douglas Risebrough,Canadiens,72,41,18,23
480,Douglas Risebrough,Canadiens,48,25,10,15
480,Douglas Risebrough,Canadiens,44,18,8,10
480,Douglas Risebrough,Canadiens,48,34,13,21
480,Douglas Risebrough,Canadiens,59,33,15,18
480,Douglas Risebrough,Flames,71,58,21,37
480,Douglas Risebrough,Flames,77,51,23,28
480,Douglas Risebrough,Flames,15,12,7,5
480,Douglas Risebrough,Flames,62,43,15,28
480,Douglas Risebrough,Flames,22,5,2,3
481,Alexei Zhitnik,Kings,78,48,12,36
481,Alexei Zhitnik,Kings,81,52,12,40
481,Alexei Zhitnik,Kings,11,7,2,5
481,Alexei Zhitnik,Sabres,21,7,2,5
481,Alexei Zhitnik,Sabres,80,36,6,30
481,Alexei Zhitnik,Sabres,80,35,7,28
481,Alexei Zhitnik,Sabres,78,45,15,30
481,Alexei Zhitnik,Sabres,81,33,7,26
481,Alexei Zhitnik,Sabres,74,13,2,11
481,Alexei Zhitnik,Sabres,78,37,8,29
481,Alexei Zhitnik,Sabres,82,34,1,33
481,Alexei Zhitnik,Sabres,70,21,3,18
481,Alexei Zhitnik,Sabres,68,28,4,24
481,Alexei Zhitnik,Islanders,59,29,5,24
481,Alexei Zhitnik,Islanders,30,11,2,9
481,Alexei Zhitnik,Flyers,31,13,3,10
481,Alexei Zhitnik,Thrashers,18,14,2,12
481,Alexei Zhitnik,Thrashers,65,8,3,5
482,Bruce MacGregor,Red Wings,12,1,0,1
482,Bruce MacGregor,Red Wings,65,18,6,12
482,Bruce MacGregor,Red Wings,67,22,11,11
482,Bruce MacGregor,Red Wings,63,32,11,21
482,Bruce MacGregor,Red Wings,66,41,21,20
482,Bruce MacGregor,Red Wings,70,34,20,14
482,Bruce MacGregor,Red Wings,70,47,28,19
482,Bruce MacGregor,Red Wings,71,39,15,24
482,Bruce MacGregor,Red Wings,69,41,18,23
482,Bruce MacGregor,Red Wings,73,38,15,23
482,Bruce MacGregor,Red Wings,47,22,6,16
482,Bruce MacGregor,Rangers,27,25,12,13
482,Bruce MacGregor,Rangers,75,40,19,21
482,Bruce MacGregor,Rangers,52,26,14,12
482,Bruce MacGregor,Rangers,66,44,17,27
483,Mike Keane,Canadiens,69,35,16,19
483,Mike Keane,Canadiens,74,24,9,15
483,Mike Keane,Canadiens,73,36,13,23
483,Mike Keane,Canadiens,67,41,11,30
483,Mike Keane,Canadiens,77,60,15,45
483,Mike Keane,Canadiens,80,46,16,30
483,Mike Keane,Canadiens,48,20,10,10
483,Mike Keane,Canadiens,18,7,0,7
483,Mike Keane,Avalanche,55,20,10,10
483,Mike Keane,Avalanche,81,27,10,17
483,Mike Keane,Rangers,70,18,8,10
483,Mike Keane,Stars,13,5,2,3
483,Mike Keane,Stars,81,29,6,23
483,Mike Keane,Stars,81,34,13,21
483,Mike Keane,Stars,67,24,10,14
483,Mike Keane,Blues,56,10,4,6
483,Mike Keane,Avalanche,22,7,2,5
483,Mike Keane,Avalanche,65,10,5,5
483,Mike Keane,Canucks,64,17,8,9
484,Rob Niedermayer,Panthers,65,26,9,17
484,Rob Niedermayer,Panthers,48,10,4,6
484,Rob Niedermayer,Panthers,82,61,26,35
484,Rob Niedermayer,Panthers,60,38,14,24
484,Rob Niedermayer,Panthers,33,15,8,7
484,Rob Niedermayer,Panthers,82,51,18,33
484,Rob Niedermayer,Panthers,81,33,10,23
484,Rob Niedermayer,Panthers,67,32,12,20
484,Rob Niedermayer,Flames,57,20,6,14
484,Rob Niedermayer,Flames,54,18,8,10
484,Rob Niedermayer,Ducks,12,4,2,2
484,Rob Niedermayer,Ducks,55,28,12,16
484,Rob Niedermayer,Ducks,76,39,15,24
484,Rob Niedermayer,Ducks,82,16,5,11
484,Rob Niedermayer,Ducks,78,16,8,8
484,Rob Niedermayer,Ducks,79,21,14,7
484,Rob Niedermayer,Devils,71,22,10,12
484,Rob Niedermayer,Sabres,71,19,5,14
485,Stephen Kasper,Bruins,76,56,21,35
485,Stephen Kasper,Bruins,73,51,20,31
485,Stephen Kasper,Bruins,24,8,2,6
485,Stephen Kasper,Bruins,27,14,3,11
485,Stephen Kasper,Bruins,77,40,16,24
485,Stephen Kasper,Bruins,80,40,17,23
485,Stephen Kasper,Bruins,79,50,20,30
485,Stephen Kasper,Bruins,79,70,26,44
485,Stephen Kasper,Bruins,49,26,10,16
485,Stephen Kasper,Kings,29,24,9,15
485,Stephen Kasper,Kings,77,45,17,28
485,Stephen Kasper,Kings,67,28,9,19
485,Stephen Kasper,Flyers,16,5,3,2
485,Stephen Kasper,Flyers,21,4,1,3
485,Stephen Kasper,Lightning,47,7,3,4
486,Jyrki Lumme,Canadiens,21,4,1,3
486,Jyrki Lumme,Canadiens,54,20,1,19
486,Jyrki Lumme,Canucks,11,10,3,7
486,Jyrki Lumme,Canucks,80,32,5,27
486,Jyrki Lumme,Canucks,75,44,12,32
486,Jyrki Lumme,Canucks,74,44,8,36
486,Jyrki Lumme,Canucks,83,55,13,42
486,Jyrki Lumme,Canucks,36,17,5,12
486,Jyrki Lumme,Canucks,80,54,17,37
486,Jyrki Lumme,Canucks,66,35,11,24
486,Jyrki Lumme,Canucks,74,30,9,21
486,Jyrki Lumme,Coyotes,60,28,7,21
486,Jyrki Lumme,Coyotes,74,40,8,32
486,Jyrki Lumme,Coyotes,58,25,4,21
486,Jyrki Lumme,Stars,15,1,0,1
486,Jyrki Lumme,Maple Leafs,51,12,4,8
486,Jyrki Lumme,Maple Leafs,73,17,6,11
487,Steven Payne,North Stars,70,40,23,17
487,Steven Payne,North Stars,80,85,42,43
487,Steven Payne,North Stars,76,58,30,28
487,Steven Payne,North Stars,74,78,33,45
487,Steven Payne,North Stars,80,69,30,39
487,Steven Payne,North Stars,78,59,28,31
487,Steven Payne,North Stars,76,51,29,22
487,Steven Payne,North Stars,22,12,8,4
487,Steven Payne,North Stars,48,10,4,6
487,Steven Payne,North Stars,9,4,1,3
488,Gary Leeman,Maple Leafs,52,12,4,8
488,Gary Leeman,Maple Leafs,53,31,5,26
488,Gary Leeman,Maple Leafs,53,32,9,23
488,Gary Leeman,Maple Leafs,80,52,21,31
488,Gary Leeman,Maple Leafs,80,61,30,31
488,Gary Leeman,Maple Leafs,61,75,32,43
488,Gary Leeman,Maple Leafs,80,95,51,44
488,Gary Leeman,Maple Leafs,52,29,17,12
488,Gary Leeman,Maple Leafs,34,20,7,13
488,Gary Leeman,Flames,29,9,2,7
488,Gary Leeman,Flames,30,14,9,5
488,Gary Leeman,Canadiens,20,18,6,12
488,Gary Leeman,Canadiens,31,15,4,11
488,Gary Leeman,Canucks,10,2,2,0
488,Gary Leeman,Blues,2,1,0,1
489,Eddie Shack,Rangers,67,21,7,14
489,Eddie Shack,Rangers,62,18,8,10
489,Eddie Shack,Rangers,12,3,1,2
489,Eddie Shack,Maple Leafs,55,28,14,14
489,Eddie Shack,Maple Leafs,44,21,7,14
489,Eddie Shack,Maple Leafs,63,25,16,9
489,Eddie Shack,Maple Leafs,64,21,11,10
489,Eddie Shack,Maple Leafs,67,14,5,9
489,Eddie Shack,Maple Leafs,63,43,26,17
489,Eddie Shack,Maple Leafs,63,25,11,14
489,Eddie Shack,Bruins,70,42,23,19
489,Eddie Shack,Bruins,50,22,11,11
489,Eddie Shack,Kings,73,34,22,12
489,Eddie Shack,Kings,11,4,2,2
489,Eddie Shack,Sabres,56,42,25,17
489,Eddie Shack,Sabres,50,25,11,14
489,Eddie Shack,Penguins,18,14,5,9
489,Eddie Shack,Penguins,74,45,25,20
489,Eddie Shack,Maple Leafs,59,15,7,8
489,Eddie Shack,Maple Leafs,26,3,2,1
490,Nik Antropov,Maple Leafs,66,30,12,18
490,Nik Antropov,Maple Leafs,52,17,6,11
490,Nik Antropov,Maple Leafs,11,2,1,1
490,Nik Antropov,Maple Leafs,72,45,16,29
490,Nik Antropov,Maple Leafs,62,31,13,18
490,Nik Antropov,Maple Leafs,57,31,12,19
490,Nik Antropov,Maple Leafs,54,33,18,15
490,Nik Antropov,Maple Leafs,72,56,26,30
490,Nik Antropov,Maple Leafs,63,46,21,25
490,Nik Antropov,Rangers,18,13,7,6
490,Nik Antropov,Thrashers,76,67,24,43
490,Nik Antropov,Thrashers,76,41,16,25
490,Nik Antropov,Jets,69,35,15,20
490,Nik Antropov,Jets,40,18,6,12
491,Michael Peca,Canucks,4,0,0,0
491,Michael Peca,Canucks,33,12,6,6
491,Michael Peca,Sabres,68,31,11,20
491,Michael Peca,Sabres,79,49,20,29
491,Michael Peca,Sabres,61,40,18,22
491,Michael Peca,Sabres,82,56,27,29
491,Michael Peca,Sabres,73,41,20,21
491,Michael Peca,Islanders,80,60,25,35
491,Michael Peca,Islanders,66,42,13,29
491,Michael Peca,Islanders,76,40,11,29
491,Michael Peca,Oilers,71,23,9,14
491,Michael Peca,Maple Leafs,35,15,4,11
491,Michael Peca,Blue Jackets,65,34,8,26
491,Michael Peca,Blue Jackets,71,22,4,18
492,Mikael Renberg,Flyers,83,82,38,44
492,Mikael Renberg,Flyers,47,57,26,31
492,Mikael Renberg,Flyers,51,43,23,20
492,Mikael Renberg,Flyers,77,59,22,37
492,Mikael Renberg,Lightning,68,38,16,22
492,Mikael Renberg,Lightning,20,12,4,8
492,Mikael Renberg,Flyers,46,26,11,15
492,Mikael Renberg,Flyers,62,29,8,21
492,Mikael Renberg,Coyotes,10,6,2,4
492,Mikael Renberg,Maple Leafs,71,52,14,38
492,Mikael Renberg,Maple Leafs,67,35,14,21
492,Mikael Renberg,Maple Leafs,59,25,12,13
493,Doug Crossman,Blackhawks,9,2,0,2
493,Doug Crossman,Blackhawks,70,40,12,28
493,Doug Crossman,Blackhawks,80,53,13,40
493,Doug Crossman,Flyers,78,35,7,28
493,Doug Crossman,Flyers,80,37,4,33
493,Doug Crossman,Flyers,80,43,6,37
493,Doug Crossman,Flyers,78,40,9,31
493,Doug Crossman,Flyers,76,38,9,29
493,Doug Crossman,Kings,74,25,10,15
493,Doug Crossman,Islanders,80,59,15,44
493,Doug Crossman,Islanders,16,7,1,6
493,Doug Crossman,Whalers,41,23,4,19
493,Doug Crossman,Red Wings,17,7,3,4
493,Doug Crossman,Red Wings,26,8,0,8
493,Doug Crossman,Lightning,40,29,8,21
493,Doug Crossman,Blues,19,9,2,7
493,Doug Crossman,Blues,50,9,2,7
494,Jochen Hecht,Blues,3,0,0,0
494,Jochen Hecht,Blues,63,34,13,21
494,Jochen Hecht,Blues,72,44,19,25
494,Jochen Hecht,Oilers,82,40,16,24
494,Jochen Hecht,Sabres,49,26,10,16
494,Jochen Hecht,Sabres,64,52,15,37
494,Jochen Hecht,Sabres,64,42,18,24
494,Jochen Hecht,Sabres,76,56,19,37
494,Jochen Hecht,Sabres,75,49,22,27
494,Jochen Hecht,Sabres,70,27,12,15
494,Jochen Hecht,Sabres,79,42,21,21
494,Jochen Hecht,Sabres,67,29,12,17
494,Jochen Hecht,Sabres,22,8,4,4
494,Jochen Hecht,Sabres,47,14,5,9
495,Kelly Miller,Rangers,5,2,0,2
495,Kelly Miller,Rangers,74,33,13,20
495,Kelly Miller,Rangers,38,20,6,14
495,Kelly Miller,Capitals,39,22,10,12
495,Kelly Miller,Capitals,80,32,9,23
495,Kelly Miller,Capitals,78,40,19,21
495,Kelly Miller,Capitals,80,40,18,22
495,Kelly Miller,Capitals,80,50,24,26
495,Kelly Miller,Capitals,78,52,14,38
495,Kelly Miller,Capitals,84,45,18,27
495,Kelly Miller,Capitals,84,39,14,25
495,Kelly Miller,Capitals,48,23,10,13
495,Kelly Miller,Capitals,74,20,7,13
495,Kelly Miller,Capitals,77,24,10,14
495,Kelly Miller,Capitals,76,14,7,7
495,Kelly Miller,Capitals,62,7,2,5
496,Al Iafrate,Maple Leafs,68,21,5,16
496,Al Iafrate,Maple Leafs,65,33,8,25
496,Al Iafrate,Maple Leafs,80,30,9,21
496,Al Iafrate,Maple Leafs,77,52,22,30
496,Al Iafrate,Maple Leafs,65,33,13,20
496,Al Iafrate,Maple Leafs,75,63,21,42
496,Al Iafrate,Maple Leafs,42,18,3,15
496,Al Iafrate,Capitals,30,14,6,8
496,Al Iafrate,Capitals,78,51,17,34
496,Al Iafrate,Capitals,81,66,25,41
496,Al Iafrate,Capitals,67,45,10,35
496,Al Iafrate,Bruins,12,13,5,8
496,Al Iafrate,Sharks,38,15,6,9
496,Al Iafrate,Sharks,21,9,2,7
497,Freddy Modin,Maple Leafs,76,13,6,7
497,Freddy Modin,Maple Leafs,74,32,16,16
497,Freddy Modin,Maple Leafs,67,31,16,15
497,Freddy Modin,Lightning,80,48,22,26
497,Freddy Modin,Lightning,76,56,32,24
497,Freddy Modin,Lightning,54,31,14,17
497,Freddy Modin,Lightning,76,40,17,23
497,Freddy Modin,Lightning,82,57,29,28
497,Freddy Modin,Lightning,77,54,31,23
497,Freddy Modin,Blue Jackets,79,42,22,20
497,Freddy Modin,Blue Jackets,23,12,6,6
497,Freddy Modin,Blue Jackets,50,25,9,16
497,Freddy Modin,Blue Jackets,24,6,2,4
497,Freddy Modin,Kings,20,5,3,2
497,Freddy Modin,Thrashers,36,10,7,3
497,Freddy Modin,Flames,4,0,0,0
498,Clifford Koroll,Blackhawks,73,37,18,19
498,Clifford Koroll,Blackhawks,72,50,16,34
498,Clifford Koroll,Blackhawks,76,45,22,23
498,Clifford Koroll,Blackhawks,77,57,33,24
498,Clifford Koroll,Blackhawks,78,46,21,25
498,Clifford Koroll,Blackhawks,80,59,27,32
498,Clifford Koroll,Blackhawks,80,58,25,33
498,Clifford Koroll,Blackhawks,80,41,15,26
498,Clifford Koroll,Blackhawks,73,31,16,15
498,Clifford Koroll,Blackhawks,78,31,12,19
498,Clifford Koroll,Blackhawks,47,7,3,4
499,Paul Stastny,Avalanche,82,78,28,50
499,Paul Stastny,Avalanche,66,71,24,47
499,Paul Stastny,Avalanche,45,36,11,25
499,Paul Stastny,Avalanche,81,79,20,59
499,Paul Stastny,Avalanche,74,57,22,35
499,Paul Stastny,Avalanche,79,53,21,32
499,Paul Stastny,Avalanche,40,24,9,15
499,Paul Stastny,Avalanche,71,60,25,35
499,Paul Stastny,Blues,5,4,1,3
500,Aurel Joliat,Canadiens,24,21,12,9
500,Aurel Joliat,Canadiens,24,20,15,5
500,Aurel Joliat,Canadiens,25,41,30,11
500,Aurel Joliat,Canadiens,35,26,17,9
500,Aurel Joliat,Canadiens,43,18,14,4
500,Aurel Joliat,Canadiens,44,39,28,11
500,Aurel Joliat,Canadiens,44,17,12,5
500,Aurel Joliat,Canadiens,42,31,19,12
500,Aurel Joliat,Canadiens,43,35,13,22
500,Aurel Joliat,Canadiens,48,39,15,24
500,Aurel Joliat,Canadiens,48,39,18,21
500,Aurel Joliat,Canadiens,48,37,22,15
500,Aurel Joliat,Canadiens,48,29,17,12
500,Aurel Joliat,Canadiens,48,23,15,8
500,Aurel Joliat,Canadiens,47,32,17,15
500,Aurel Joliat,Canadiens,44,13,6,7
501,Douglas Smail,Jets (1979),30,18,10,8
501,Douglas Smail,Jets (1979),72,35,17,18
501,Douglas Smail,Jets (1979),80,44,15,29
501,Douglas Smail,Jets (1979),66,37,20,17
501,Douglas Smail,Jets (1979),80,66,31,35
501,Douglas Smail,Jets (1979),73,42,16,26
501,Douglas Smail,Jets (1979),78,43,25,18
501,Douglas Smail,Jets (1979),71,31,15,16
501,Douglas Smail,Jets (1979),47,29,14,15
501,Douglas Smail,Jets (1979),79,49,25,24
501,Douglas Smail,Jets (1979),15,3,1,2
501,Douglas Smail,North Stars,57,20,7,13
501,Douglas Smail,Nordiques,46,28,10,18
501,Douglas Smail,Senators,51,14,4,10
502,Ronald Stackhouse,Seals,78,32,8,24
502,Ronald Stackhouse,Seals,5,4,1,3
502,Ronald Stackhouse,Red Wings,74,30,5,25
502,Ronald Stackhouse,Red Wings,78,34,5,29
502,Ronald Stackhouse,Red Wings,33,16,2,14
502,Ronald Stackhouse,Penguins,36,19,4,15
502,Ronald Stackhouse,Penguins,72,60,15,45
502,Ronald Stackhouse,Penguins,80,71,11,60
502,Ronald Stackhouse,Penguins,80,41,7,34
502,Ronald Stackhouse,Penguins,50,20,5,15
502,Ronald Stackhouse,Penguins,75,43,10,33
502,Ronald Stackhouse,Penguins,78,33,6,27
502,Ronald Stackhouse,Penguins,74,35,6,29
502,Ronald Stackhouse,Penguins,76,21,2,19
503,Sami Kapanen,Whalers,35,9,5,4
503,Sami Kapanen,Whalers,45,25,13,12
503,Sami Kapanen,Hurricanes,81,63,26,37
503,Sami Kapanen,Hurricanes,81,59,24,35
503,Sami Kapanen,Hurricanes,76,48,24,24
503,Sami Kapanen,Hurricanes,82,57,20,37
503,Sami Kapanen,Hurricanes,77,69,27,42
503,Sami Kapanen,Hurricanes,43,18,6,12
503,Sami Kapanen,Flyers,28,13,4,9
503,Sami Kapanen,Flyers,74,30,12,18
503,Sami Kapanen,Flyers,58,34,12,22
503,Sami Kapanen,Flyers,77,25,11,14
503,Sami Kapanen,Flyers,74,8,5,3
504,Wade Redden,Senators,82,30,6,24
504,Wade Redden,Senators,80,22,8,14
504,Wade Redden,Senators,72,29,8,21
504,Wade Redden,Senators,81,36,10,26
504,Wade Redden,Senators,78,47,10,37
504,Wade Redden,Senators,79,34,9,25
504,Wade Redden,Senators,76,45,10,35
504,Wade Redden,Senators,81,43,17,26
504,Wade Redden,Senators,65,50,10,40
504,Wade Redden,Senators,64,36,7,29
504,Wade Redden,Senators,80,38,6,32
504,Wade Redden,Rangers,81,26,3,23
504,Wade Redden,Rangers,75,14,2,12
504,Wade Redden,Blues,23,5,2,3
504,Wade Redden,Bruins,6,2,1,1
505,Pierre Mondou,Canadiens,71,49,19,30
505,Pierre Mondou,Canadiens,77,72,31,41
505,Pierre Mondou,Canadiens,75,66,30,36
505,Pierre Mondou,Canadiens,57,41,17,24
505,Pierre Mondou,Canadiens,73,68,35,33
505,Pierre Mondou,Canadiens,76,66,29,37
505,Pierre Mondou,Canadiens,52,37,15,22
505,Pierre Mondou,Canadiens,67,57,18,39
506,Wayne Merrick,Blues,50,21,10,11
506,Wayne Merrick,Blues,64,43,20,23
506,Wayne Merrick,Blues,76,65,28,37
506,Wayne Merrick,Blues,19,15,7,8
506,Wayne Merrick,Seals,56,52,25,27
506,Wayne Merrick,Barons,80,56,18,38
506,Wayne Merrick,Barons,18,7,2,5
506,Wayne Merrick,Islanders,37,24,10,14
506,Wayne Merrick,Islanders,75,41,20,21
506,Wayne Merrick,Islanders,70,35,13,22
506,Wayne Merrick,Islanders,71,31,16,15
506,Wayne Merrick,Islanders,68,39,12,27
506,Wayne Merrick,Islanders,59,16,4,12
506,Wayne Merrick,Islanders,31,11,6,5
507,Jude Drouin,Canadiens,9,1,0,1
507,Jude Drouin,Canadiens,3,0,0,0
507,Jude Drouin,North Stars,75,68,16,52
507,Jude Drouin,North Stars,63,56,13,43
507,Jude Drouin,North Stars,78,73,27,46
507,Jude Drouin,North Stars,65,43,19,24
507,Jude Drouin,North Stars,38,22,4,18
507,Jude Drouin,Islanders,40,32,14,18
507,Jude Drouin,Islanders,76,62,21,41
507,Jude Drouin,Islanders,78,53,24,29
507,Jude Drouin,Islanders,56,22,5,17
507,Jude Drouin,Jets (1979),78,24,8,16
507,Jude Drouin,Jets (1979),7,0,0,0
508,Travis Green,Islanders,61,25,7,18
508,Travis Green,Islanders,83,40,18,22
508,Travis Green,Islanders,42,12,5,7
508,Travis Green,Islanders,69,70,25,45
508,Travis Green,Islanders,79,64,23,41
508,Travis Green,Islanders,54,26,14,12
508,Travis Green,Ducks,22,16,5,11
508,Travis Green,Ducks,79,30,13,17
508,Travis Green,Coyotes,78,46,25,21
508,Travis Green,Coyotes,69,28,13,15
508,Travis Green,Maple Leafs,82,34,11,23
508,Travis Green,Maple Leafs,75,24,12,12
508,Travis Green,Bruins,64,16,11,5
508,Travis Green,Bruins,82,22,10,12
508,Travis Green,Ducks,7,2,1,1
508,Travis Green,Maple Leafs,24,0,0,0
509,Mikko Koivu,Wild,64,21,6,15
509,Mikko Koivu,Wild,82,54,20,34
509,Mikko Koivu,Wild,57,42,11,31
509,Mikko Koivu,Wild,79,67,20,47
509,Mikko Koivu,Wild,80,71,22,49
509,Mikko Koivu,Wild,71,62,17,45
509,Mikko Koivu,Wild,55,44,12,32
509,Mikko Koivu,Wild,48,37,11,26
509,Mikko Koivu,Wild,65,54,11,43
509,Mikko Koivu,Wild,12,3,2,1
510,Per-Erik Eklund,Flyers,70,66,15,51
510,Per-Erik Eklund,Flyers,72,55,14,41
510,Per-Erik Eklund,Flyers,71,42,10,32
510,Per-Erik Eklund,Flyers,79,69,18,51
510,Per-Erik Eklund,Flyers,70,62,23,39
510,Per-Erik Eklund,Flyers,73,69,19,50
510,Per-Erik Eklund,Flyers,51,23,7,16
510,Per-Erik Eklund,Flyers,55,49,11,38
510,Per-Erik Eklund,Flyers,48,17,1,16
510,Per-Erik Eklund,Stars,5,3,2,1
511,Gerald Korab,Blackhawks,46,18,4,14
511,Gerald Korab,Blackhawks,73,14,9,5
511,Gerald Korab,Blackhawks,77,27,12,15
511,Gerald Korab,Canucks,31,11,4,7
511,Gerald Korab,Sabres,45,18,6,12
511,Gerald Korab,Sabres,79,56,12,44
511,Gerald Korab,Sabres,65,41,13,28
511,Gerald Korab,Sabres,77,47,14,33
511,Gerald Korab,Sabres,77,41,7,34
511,Gerald Korab,Sabres,78,51,11,40
511,Gerald Korab,Sabres,43,11,1,10
511,Gerald Korab,Kings,11,3,1,2
511,Gerald Korab,Kings,78,52,9,43
511,Gerald Korab,Kings,50,18,5,13
511,Gerald Korab,Kings,72,29,3,26
511,Gerald Korab,Sabres,48,11,2,9
511,Gerald Korab,Sabres,25,7,1,6
512,Patrick Boutette,Maple Leafs,77,32,10,22
512,Patrick Boutette,Maple Leafs,80,36,18,18
512,Patrick Boutette,Maple Leafs,80,36,17,19
512,Patrick Boutette,Maple Leafs,80,33,14,19
512,Patrick Boutette,Maple Leafs,32,4,0,4
512,Patrick Boutette,Whalers,47,44,13,31
512,Patrick Boutette,Whalers,80,80,28,52
512,Patrick Boutette,Penguins,80,74,23,51
512,Patrick Boutette,Penguins,80,56,27,29
512,Patrick Boutette,Penguins,73,40,14,26
512,Patrick Boutette,Penguins,14,4,1,3
512,Patrick Boutette,Whalers,33,14,6,8
513,Charles Huddy,Oilers,12,7,2,5
513,Charles Huddy,Oilers,41,15,4,11
513,Charles Huddy,Oilers,76,57,20,37
513,Charles Huddy,Oilers,75,42,8,34
513,Charles Huddy,Oilers,80,51,7,44
513,Charles Huddy,Oilers,76,41,6,35
513,Charles Huddy,Oilers,58,19,4,15
513,Charles Huddy,Oilers,77,41,13,28
513,Charles Huddy,Oilers,76,44,11,33
513,Charles Huddy,Oilers,70,24,1,23
513,Charles Huddy,Oilers,53,27,5,22
513,Charles Huddy,Kings,56,23,4,19
513,Charles Huddy,Kings,82,27,2,25
513,Charles Huddy,Kings,79,18,5,13
513,Charles Huddy,Kings,9,1,0,1
513,Charles Huddy,Sabres,32,6,2,4
513,Charles Huddy,Sabres,52,10,5,5
513,Charles Huddy,Blues,12,0,0,0
513,Charles Huddy,Sabres,1,0,0,0
514,Derek Sanderson,Bruins,2,0,0,0
514,Derek Sanderson,Bruins,2,0,0,0
514,Derek Sanderson,Bruins,71,49,24,25
514,Derek Sanderson,Bruins,61,48,26,22
514,Derek Sanderson,Bruins,50,41,18,23
514,Derek Sanderson,Bruins,71,63,29,34
514,Derek Sanderson,Bruins,78,58,25,33
514,Derek Sanderson,Bruins,25,15,5,10
514,Derek Sanderson,Bruins,29,20,8,12
514,Derek Sanderson,Rangers,75,50,25,25
514,Derek Sanderson,Rangers,8,0,0,0
514,Derek Sanderson,Blues,65,67,24,43
514,Derek Sanderson,Blues,32,21,8,13
514,Derek Sanderson,Canucks,16,16,7,9
514,Derek Sanderson,Penguins,13,4,3,1
515,Jonathan Toews,Blackhawks,64,54,24,30
515,Jonathan Toews,Blackhawks,82,69,34,35
515,Jonathan Toews,Blackhawks,76,68,25,43
515,Jonathan Toews,Blackhawks,80,76,32,44
515,Jonathan Toews,Blackhawks,59,57,29,28
515,Jonathan Toews,Blackhawks,47,48,23,25
515,Jonathan Toews,Blackhawks,76,68,28,40
515,Jonathan Toews,Blackhawks,14,11,5,6
516,Daniel Maloney,Blackhawks,74,26,12,14
516,Daniel Maloney,Blackhawks,57,30,13,17
516,Daniel Maloney,Kings,14,11,4,7
516,Daniel Maloney,Kings,65,32,15,17
516,Daniel Maloney,Kings,80,66,27,39
516,Daniel Maloney,Red Wings,77,66,27,39
516,Daniel Maloney,Red Wings,34,26,13,13
516,Daniel Maloney,Red Wings,66,45,16,29
516,Daniel Maloney,Maple Leafs,13,7,3,4
516,Daniel Maloney,Maple Leafs,77,53,17,36
516,Daniel Maloney,Maple Leafs,71,33,17,16
516,Daniel Maloney,Maple Leafs,65,41,20,21
516,Daniel Maloney,Maple Leafs,44,15,8,7
517,Kristian Huselius,Panthers,79,45,23,22
517,Kristian Huselius,Panthers,78,43,20,23
517,Kristian Huselius,Panthers,76,31,10,21
517,Kristian Huselius,Panthers,24,8,5,3
517,Kristian Huselius,Flames,54,39,15,24
517,Kristian Huselius,Flames,81,77,34,43
517,Kristian Huselius,Flames,81,66,25,41
517,Kristian Huselius,Blue Jackets,74,56,21,35
517,Kristian Huselius,Blue Jackets,74,63,23,40
517,Kristian Huselius,Blue Jackets,39,23,14,9
517,Kristian Huselius,Blue Jackets,2,0,0,0
518,Randy Burridge,Bruins,52,42,17,25
518,Randy Burridge,Bruins,23,5,1,4
518,Randy Burridge,Bruins,79,55,27,28
518,Randy Burridge,Bruins,80,61,31,30
518,Randy Burridge,Bruins,63,32,17,15
518,Randy Burridge,Bruins,62,28,15,13
518,Randy Burridge,Capitals,66,67,23,44
518,Randy Burridge,Capitals,4,0,0,0
518,Randy Burridge,Capitals,78,42,25,17
518,Randy Burridge,Capitals,2,0,0,0
518,Randy Burridge,Kings,38,19,4,15
518,Randy Burridge,Sabres,74,58,25,33
518,Randy Burridge,Sabres,55,31,10,21
518,Randy Burridge,Sabres,30,10,4,6
519,Blaine Stoughton,Penguins,34,11,5,6
519,Blaine Stoughton,Maple Leafs,78,37,23,14
519,Blaine Stoughton,Maple Leafs,43,17,6,11
519,Blaine Stoughton,Whalers,80,100,56,44
519,Blaine Stoughton,Whalers,71,73,43,30
519,Blaine Stoughton,Whalers,80,91,52,39
519,Blaine Stoughton,Whalers,72,76,45,31
519,Blaine Stoughton,Whalers,54,37,23,14
519,Blaine Stoughton,Rangers,14,7,5,2
520,Brad Boyes,Sharks,1,0,0,0
520,Brad Boyes,Bruins,82,69,26,43
520,Brad Boyes,Bruins,62,34,13,21
520,Brad Boyes,Blues,19,12,4,8
520,Brad Boyes,Blues,82,65,43,22
520,Brad Boyes,Blues,82,72,33,39
520,Brad Boyes,Blues,82,42,14,28
520,Brad Boyes,Blues,62,41,12,29
520,Brad Boyes,Sabres,21,14,5,9
520,Brad Boyes,Sabres,65,23,8,15
520,Brad Boyes,Islanders,48,35,10,25
520,Brad Boyes,Panthers,78,36,21,15
520,Brad Boyes,Panthers,11,6,2,4
521,Mike Walton,Maple Leafs,6,4,1,3
521,Mike Walton,Maple Leafs,31,17,7,10
521,Mike Walton,Maple Leafs,73,59,30,29
521,Mike Walton,Maple Leafs,66,43,22,21
521,Mike Walton,Maple Leafs,58,55,21,34
521,Mike Walton,Maple Leafs,23,13,3,10
521,Mike Walton,Bruins,22,8,3,5
521,Mike Walton,Bruins,76,56,28,28
521,Mike Walton,Bruins,56,47,25,22
521,Mike Walton,Canucks,10,16,8,8
521,Mike Walton,Canucks,40,31,7,24
521,Mike Walton,Canucks,65,66,29,37
521,Mike Walton,Blues,22,18,7,11
521,Mike Walton,Bruins,14,6,4,2
521,Mike Walton,Blackhawks,26,9,6,3
522,Dean McAmmond,Blackhawks,5,2,0,2
522,Dean McAmmond,Oilers,45,27,6,21
522,Dean McAmmond,Oilers,6,0,0,0
522,Dean McAmmond,Oilers,53,30,15,15
522,Dean McAmmond,Oilers,57,29,12,17
522,Dean McAmmond,Oilers,77,50,19,31
522,Dean McAmmond,Oilers,65,25,9,16
522,Dean McAmmond,Blackhawks,12,5,1,4
522,Dean McAmmond,Blackhawks,76,32,14,18
522,Dean McAmmond,Blackhawks,61,26,10,16
522,Dean McAmmond,Flyers,10,2,1,1
522,Dean McAmmond,Flames,73,51,21,30
522,Dean McAmmond,Avalanche,41,18,10,8
522,Dean McAmmond,Flames,64,30,17,13
522,Dean McAmmond,Blues,78,37,15,22
522,Dean McAmmond,Senators,81,29,14,15
522,Dean McAmmond,Senators,68,22,9,13
522,Dean McAmmond,Senators,44,7,3,4
522,Dean McAmmond,Islanders,18,9,2,7
522,Dean McAmmond,Devils,62,17,8,9
523,Tomas Plekanec,Canadiens,2,0,0,0
523,Tomas Plekanec,Canadiens,67,29,9,20
523,Tomas Plekanec,Canadiens,81,47,20,27
523,Tomas Plekanec,Canadiens,81,69,29,40
523,Tomas Plekanec,Canadiens,80,39,20,19
523,Tomas Plekanec,Canadiens,82,70,25,45
523,Tomas Plekanec,Canadiens,77,57,22,35
523,Tomas Plekanec,Canadiens,81,52,17,35
523,Tomas Plekanec,Canadiens,47,33,14,19
523,Tomas Plekanec,Canadiens,81,43,20,23
523,Tomas Plekanec,Canadiens,14,9,5,4
524,Andrei Markov,Canadiens,63,23,6,17
524,Andrei Markov,Canadiens,56,24,5,19
524,Andrei Markov,Canadiens,79,37,13,24
524,Andrei Markov,Canadiens,69,28,6,22
524,Andrei Markov,Canadiens,67,46,10,36
524,Andrei Markov,Canadiens,77,49,6,43
524,Andrei Markov,Canadiens,82,58,16,42
524,Andrei Markov,Canadiens,78,64,12,52
524,Andrei Markov,Canadiens,45,34,6,28
524,Andrei Markov,Canadiens,7,3,1,2
524,Andrei Markov,Canadiens,13,3,0,3
524,Andrei Markov,Canadiens,48,30,10,20
524,Andrei Markov,Canadiens,81,43,7,36
524,Andrei Markov,Canadiens,14,6,1,5
525,Richard Redmond,North Stars,7,1,0,1
525,Richard Redmond,North Stars,9,2,0,2
525,Richard Redmond,Seals,11,6,2,4
525,Richard Redmond,Seals,74,45,10,35
525,Richard Redmond,Seals,24,16,3,13
525,Richard Redmond,Blackhawks,52,28,9,19
525,Richard Redmond,Blackhawks,76,59,17,42
525,Richard Redmond,Blackhawks,80,57,14,43
525,Richard Redmond,Blackhawks,53,36,9,27
525,Richard Redmond,Blackhawks,80,47,22,25
525,Richard Redmond,Blues,28,15,4,11
525,Richard Redmond,Flames,42,18,7,11
525,Richard Redmond,Bruins,64,33,7,26
525,Richard Redmond,Bruins,76,47,14,33
525,Richard Redmond,Bruins,78,35,15,20
525,Richard Redmond,Bruins,17,0,0,0
526,Harry Watson,Americans,47,18,10,8
526,Harry Watson,Red Wings,50,31,13,18
526,Harry Watson,Red Wings,44,24,14,10
526,Harry Watson,Maple Leafs,44,34,19,15
526,Harry Watson,Maple Leafs,57,41,21,20
526,Harry Watson,Maple Leafs,60,45,26,19
526,Harry Watson,Maple Leafs,60,35,19,16
526,Harry Watson,Maple Leafs,68,37,18,19
526,Harry Watson,Maple Leafs,70,39,22,17
526,Harry Watson,Maple Leafs,63,24,16,8
526,Harry Watson,Maple Leafs,70,28,21,7
526,Harry Watson,Maple Leafs,8,2,1,1
526,Harry Watson,Blackhawks,43,30,14,16
526,Harry Watson,Blackhawks,55,25,11,14
526,Harry Watson,Blackhawks,70,30,11,19
527,Shawn Burr,Red Wings,9,0,0,0
527,Shawn Burr,Red Wings,5,1,1,0
527,Shawn Burr,Red Wings,80,47,22,25
527,Shawn Burr,Red Wings,78,40,17,23
527,Shawn Burr,Red Wings,79,46,19,27
527,Shawn Burr,Red Wings,76,56,24,32
527,Shawn Burr,Red Wings,80,50,20,30
527,Shawn Burr,Red Wings,79,51,19,32
527,Shawn Burr,Red Wings,80,35,10,25
527,Shawn Burr,Red Wings,51,22,10,12
527,Shawn Burr,Red Wings,42,14,6,8
527,Shawn Burr,Lightning,81,28,13,15
527,Shawn Burr,Lightning,74,35,14,21
527,Shawn Burr,Sharks,42,12,6,6
527,Shawn Burr,Sharks,18,1,0,1
527,Shawn Burr,Lightning,4,2,0,2
528,Ian Turnbull,Maple Leafs,78,35,8,27
528,Ian Turnbull,Maple Leafs,22,13,6,7
528,Ian Turnbull,Maple Leafs,76,56,20,36
528,Ian Turnbull,Maple Leafs,80,79,22,57
528,Ian Turnbull,Maple Leafs,77,61,14,47
528,Ian Turnbull,Maple Leafs,80,63,12,51
528,Ian Turnbull,Maple Leafs,75,39,11,28
528,Ian Turnbull,Maple Leafs,80,66,19,47
528,Ian Turnbull,Maple Leafs,12,2,0,2
528,Ian Turnbull,Kings,42,26,11,15
528,Ian Turnbull,Penguins,6,0,0,0
529,Steven Stamkos,Lightning,79,46,23,23
529,Steven Stamkos,Lightning,82,95,51,44
529,Steven Stamkos,Lightning,82,91,45,46
529,Steven Stamkos,Lightning,82,97,60,37
529,Steven Stamkos,Lightning,48,57,29,28
529,Steven Stamkos,Lightning,37,40,25,15
529,Steven Stamkos,Lightning,13,13,8,5
530,Serge Savard,Canadiens,2,0,0,0
530,Serge Savard,Canadiens,67,15,2,13
530,Serge Savard,Canadiens,74,31,8,23
530,Serge Savard,Canadiens,64,31,12,19
530,Serge Savard,Canadiens,37,15,5,10
530,Serge Savard,Canadiens,23,9,1,8
530,Serge Savard,Canadiens,74,39,7,32
530,Serge Savard,Canadiens,67,18,4,14
530,Serge Savard,Canadiens,80,60,20,40
530,Serge Savard,Canadiens,71,47,8,39
530,Serge Savard,Canadiens,78,42,9,33
530,Serge Savard,Canadiens,77,42,8,34
530,Serge Savard,Canadiens,80,33,7,26
530,Serge Savard,Canadiens,46,13,5,8
530,Serge Savard,Canadiens,77,17,4,13
530,Serge Savard,Jets (1979),47,7,2,5
530,Serge Savard,Jets (1979),76,20,4,16
531,Michael O'Connell,Blackhawks,6,2,1,1
531,Michael O'Connell,Blackhawks,48,26,4,22
531,Michael O'Connell,Blackhawks,78,30,8,22
531,Michael O'Connell,Blackhawks,34,21,5,16
531,Michael O'Connell,Bruins,48,32,10,22
531,Michael O'Connell,Bruins,80,39,5,34
531,Michael O'Connell,Bruins,80,53,14,39
531,Michael O'Connell,Bruins,75,60,18,42
531,Michael O'Connell,Bruins,78,55,15,40
531,Michael O'Connell,Bruins,63,29,8,21
531,Michael O'Connell,Red Wings,13,8,1,7
531,Michael O'Connell,Red Wings,77,31,5,26
531,Michael O'Connell,Red Wings,48,19,6,13
531,Michael O'Connell,Red Wings,66,16,1,15
531,Michael O'Connell,Red Wings,66,18,4,14
532,Wayne Babych,Blues,67,63,27,36
532,Wayne Babych,Blues,59,61,26,35
532,Wayne Babych,Blues,78,96,54,42
532,Wayne Babych,Blues,51,44,19,25
532,Wayne Babych,Blues,71,39,16,23
532,Wayne Babych,Blues,70,42,13,29
532,Wayne Babych,Penguins,65,54,20,34
532,Wayne Babych,Penguins,2,0,0,0
532,Wayne Babych,Nordiques,15,11,6,5
532,Wayne Babych,Whalers,37,28,11,17
532,Wayne Babych,Whalers,4,0,0,0
533,Robert Brown,Penguins,51,44,24,20
533,Robert Brown,Penguins,68,115,49,66
533,Robert Brown,Penguins,80,80,33,47
533,Robert Brown,Penguins,25,16,6,10
533,Robert Brown,Whalers,44,42,18,24
533,Robert Brown,Whalers,42,31,16,15
533,Robert Brown,Blackhawks,25,16,5,11
533,Robert Brown,Blackhawks,15,7,1,6
533,Robert Brown,Stars,1,0,0,0
533,Robert Brown,Kings,2,0,0,0
533,Robert Brown,Penguins,82,40,15,25
533,Robert Brown,Penguins,58,24,13,11
533,Robert Brown,Penguins,50,23,10,13
534,Willi Plett,Flames,4,0,0,0
534,Willi Plett,Flames,64,56,33,23
534,Willi Plett,Flames,78,43,22,21
534,Willi Plett,Flames,74,43,23,20
534,Willi Plett,Flames,76,32,13,19
534,Willi Plett,Flames,78,68,38,30
534,Willi Plett,Flames,78,57,21,36
534,Willi Plett,North Stars,71,39,25,14
534,Willi Plett,North Stars,73,38,15,23
534,Willi Plett,North Stars,47,28,14,14
534,Willi Plett,North Stars,59,17,10,7
534,Willi Plett,North Stars,67,11,6,5
534,Willi Plett,Bruins,65,5,2,3
535,Vic Stasiuk,Blackhawks,17,2,1,1
535,Vic Stasiuk,Blackhawks,20,8,5,3
535,Vic Stasiuk,Red Wings,50,13,3,10
535,Vic Stasiuk,Red Wings,58,14,5,9
535,Vic Stasiuk,Red Wings,3,0,0,0
535,Vic Stasiuk,Red Wings,42,7,5,2
535,Vic Stasiuk,Red Wings,59,19,8,11
535,Vic Stasiuk,Bruins,59,37,19,18
535,Vic Stasiuk,Bruins,64,40,24,16
535,Vic Stasiuk,Bruins,70,56,21,35
535,Vic Stasiuk,Bruins,70,60,27,33
535,Vic Stasiuk,Bruins,69,68,29,39
535,Vic Stasiuk,Bruins,46,30,5,25
535,Vic Stasiuk,Red Wings,23,23,10,13
535,Vic Stasiuk,Red Wings,59,43,15,28
535,Vic Stasiuk,Red Wings,36,17,6,11
536,John Tucker,Sabres,21,16,12,4
536,John Tucker,Sabres,64,49,22,27
536,John Tucker,Sabres,75,65,31,34
536,John Tucker,Sabres,54,51,17,34
536,John Tucker,Sabres,45,38,19,19
536,John Tucker,Sabres,60,44,13,31
536,John Tucker,Sabres,8,3,1,2
536,John Tucker,Capitals,38,28,9,19
536,John Tucker,Sabres,18,4,1,3
536,John Tucker,Islanders,20,7,3,4
536,John Tucker,Lightning,78,56,17,39
536,John Tucker,Lightning,66,40,17,23
536,John Tucker,Lightning,46,25,12,13
536,John Tucker,Lightning,63,10,3,7
537,Mariusz Czerkawski,Bruins,4,3,2,1
537,Mariusz Czerkawski,Bruins,47,26,12,14
537,Mariusz Czerkawski,Bruins,33,11,5,6
537,Mariusz Czerkawski,Oilers,37,29,12,17
537,Mariusz Czerkawski,Oilers,76,47,26,21
537,Mariusz Czerkawski,Islanders,68,25,12,13
537,Mariusz Czerkawski,Islanders,78,38,21,17
537,Mariusz Czerkawski,Islanders,79,70,35,35
537,Mariusz Czerkawski,Islanders,82,62,30,32
537,Mariusz Czerkawski,Islanders,82,51,22,29
537,Mariusz Czerkawski,Canadiens,43,14,5,9
537,Mariusz Czerkawski,Islanders,81,49,25,24
537,Mariusz Czerkawski,Maple Leafs,19,5,4,1
537,Mariusz Czerkawski,Bruins,16,5,4,1
538,Chico Maki,Blackhawks,16,10,4,6
538,Chico Maki,Blackhawks,65,24,7,17
538,Chico Maki,Blackhawks,68,22,8,14
538,Chico Maki,Blackhawks,65,40,16,24
538,Chico Maki,Blackhawks,68,48,17,31
538,Chico Maki,Blackhawks,56,38,9,29
538,Chico Maki,Blackhawks,60,24,8,16
538,Chico Maki,Blackhawks,66,28,7,21
538,Chico Maki,Blackhawks,75,34,10,24
538,Chico Maki,Blackhawks,72,48,22,26
538,Chico Maki,Blackhawks,62,47,13,34
538,Chico Maki,Blackhawks,77,32,13,19
538,Chico Maki,Blackhawks,69,34,9,25
538,Chico Maki,Blackhawks,22,6,0,6
539,Sylvain Cote,Whalers,67,12,3,9
539,Sylvain Cote,Whalers,2,0,0,0
539,Sylvain Cote,Whalers,67,10,2,8
539,Sylvain Cote,Whalers,67,28,7,21
539,Sylvain Cote,Whalers,78,17,8,9
539,Sylvain Cote,Whalers,28,6,4,2
539,Sylvain Cote,Whalers,73,19,7,12
539,Sylvain Cote,Capitals,78,40,11,29
539,Sylvain Cote,Capitals,77,50,21,29
539,Sylvain Cote,Capitals,84,51,16,35
539,Sylvain Cote,Capitals,47,19,5,14
539,Sylvain Cote,Capitals,81,38,5,33
539,Sylvain Cote,Capitals,57,24,6,18
539,Sylvain Cote,Capitals,59,16,1,15
539,Sylvain Cote,Maple Leafs,12,9,3,6
539,Sylvain Cote,Maple Leafs,79,29,5,24
539,Sylvain Cote,Maple Leafs,3,1,0,1
539,Sylvain Cote,Blackhawks,45,24,6,18
539,Sylvain Cote,Stars,28,10,2,8
539,Sylvain Cote,Capitals,68,18,7,11
539,Sylvain Cote,Capitals,70,14,3,11
539,Sylvain Cote,Capitals,1,0,0,0
540,Curt Fraser,Canucks,78,35,16,19
540,Curt Fraser,Canucks,78,42,17,25
540,Curt Fraser,Canucks,77,49,25,24
540,Curt Fraser,Canucks,79,67,28,39
540,Curt Fraser,Canucks,36,13,6,7
540,Curt Fraser,Blackhawks,38,19,6,13
540,Curt Fraser,Blackhawks,29,17,5,12
540,Curt Fraser,Blackhawks,73,50,25,25
540,Curt Fraser,Blackhawks,61,68,29,39
540,Curt Fraser,Blackhawks,75,50,25,25
540,Curt Fraser,Blackhawks,27,10,4,6
540,Curt Fraser,North Stars,10,2,1,1
540,Curt Fraser,North Stars,35,10,5,5
540,Curt Fraser,North Stars,8,1,1,0
541,Gaetan Duchesne,Capitals,74,23,9,14
541,Gaetan Duchesne,Capitals,77,37,18,19
541,Gaetan Duchesne,Capitals,79,36,17,19
541,Gaetan Duchesne,Capitals,67,38,15,23
541,Gaetan Duchesne,Capitals,80,39,11,28
541,Gaetan Duchesne,Capitals,74,52,17,35
541,Gaetan Duchesne,Nordiques,80,47,24,23
541,Gaetan Duchesne,Nordiques,70,29,8,21
541,Gaetan Duchesne,North Stars,72,20,12,8
541,Gaetan Duchesne,North Stars,68,18,9,9
541,Gaetan Duchesne,North Stars,73,23,8,15
541,Gaetan Duchesne,North Stars,84,29,16,13
541,Gaetan Duchesne,Sharks,84,30,12,18
541,Gaetan Duchesne,Sharks,33,9,2,7
541,Gaetan Duchesne,Panthers,13,3,1,2
542,Allan Stanley,Rangers,40,10,2,8
542,Allan Stanley,Rangers,55,8,4,4
542,Allan Stanley,Rangers,70,21,7,14
542,Allan Stanley,Rangers,50,19,5,14
542,Allan Stanley,Rangers,70,17,5,12
542,Allan Stanley,Rangers,10,2,0,2
542,Allan Stanley,Rangers,12,1,0,1
542,Allan Stanley,Blackhawks,52,25,10,15
542,Allan Stanley,Blackhawks,59,18,4,14
542,Allan Stanley,Bruins,60,31,6,25
542,Allan Stanley,Bruins,69,31,6,25
542,Allan Stanley,Maple Leafs,70,23,1,22
542,Allan Stanley,Maple Leafs,64,33,10,23
542,Allan Stanley,Maple Leafs,68,34,9,25
542,Allan Stanley,Maple Leafs,60,35,9,26
542,Allan Stanley,Maple Leafs,61,19,4,15
542,Allan Stanley,Maple Leafs,70,27,6,21
542,Allan Stanley,Maple Leafs,64,17,2,15
542,Allan Stanley,Maple Leafs,59,18,4,14
542,Allan Stanley,Maple Leafs,53,13,1,12
542,Allan Stanley,Maple Leafs,64,14,1,13
542,Allan Stanley,Flyers,64,17,4,13
543,Mario Marois,Rangers,8,2,1,1
543,Mario Marois,Rangers,71,31,5,26
543,Mario Marois,Rangers,79,31,8,23
543,Mario Marois,Rangers,8,3,1,2
543,Mario Marois,Canucks,50,16,4,12
543,Mario Marois,Nordiques,11,7,0,7
543,Mario Marois,Nordiques,71,43,11,32
543,Mario Marois,Nordiques,36,14,2,12
543,Mario Marois,Nordiques,80,49,13,36
543,Mario Marois,Nordiques,76,43,6,37
543,Mario Marois,Nordiques,20,13,1,12
543,Mario Marois,Jets (1979),56,32,4,28
543,Mario Marois,Jets (1979),79,44,4,40
543,Mario Marois,Jets (1979),79,51,7,44
543,Mario Marois,Jets (1979),7,2,1,1
543,Mario Marois,Nordiques,42,13,2,11
543,Mario Marois,Nordiques,67,18,3,15
543,Mario Marois,Blues,64,16,2,14
543,Mario Marois,Blues,17,1,0,1
543,Mario Marois,Jets (1979),34,4,1,3
544,Syl Apps,Maple Leafs,48,45,16,29
544,Syl Apps,Maple Leafs,47,50,21,29
544,Syl Apps,Maple Leafs,44,40,15,25
544,Syl Apps,Maple Leafs,27,30,13,17
544,Syl Apps,Maple Leafs,41,44,20,24
544,Syl Apps,Maple Leafs,38,41,18,23
544,Syl Apps,Maple Leafs,29,40,23,17
544,Syl Apps,Maple Leafs,40,40,24,16
544,Syl Apps,Maple Leafs,54,49,25,24
544,Syl Apps,Maple Leafs,55,53,26,27
545,Christian Ruuttu,Sabres,76,65,22,43
545,Christian Ruuttu,Sabres,73,71,26,45
545,Christian Ruuttu,Sabres,67,60,14,46
545,Christian Ruuttu,Sabres,75,60,19,41
545,Christian Ruuttu,Sabres,77,50,16,34
545,Christian Ruuttu,Sabres,70,25,4,21
545,Christian Ruuttu,Blackhawks,84,54,17,37
545,Christian Ruuttu,Blackhawks,54,29,9,20
545,Christian Ruuttu,Blackhawks,20,7,2,5
545,Christian Ruuttu,Canucks,25,11,5,6
546,Brian Campbell,Sabres,12,5,1,4
546,Brian Campbell,Sabres,8,0,0,0
546,Brian Campbell,Sabres,29,6,3,3
546,Brian Campbell,Sabres,65,19,2,17
546,Brian Campbell,Sabres,53,11,3,8
546,Brian Campbell,Sabres,79,44,12,32
546,Brian Campbell,Sabres,82,48,6,42
546,Brian Campbell,Sabres,63,43,5,38
546,Brian Campbell,Sharks,20,19,3,16
546,Brian Campbell,Blackhawks,82,52,7,45
546,Brian Campbell,Blackhawks,68,38,7,31
546,Brian Campbell,Blackhawks,65,27,5,22
546,Brian Campbell,Panthers,82,53,4,49
546,Brian Campbell,Panthers,48,27,8,19
546,Brian Campbell,Panthers,82,37,7,30
546,Brian Campbell,Panthers,11,3,0,3
547,Tim Connolly,Islanders,81,34,14,20
547,Tim Connolly,Islanders,82,41,10,31
547,Tim Connolly,Sabres,82,45,10,35
547,Tim Connolly,Sabres,80,25,12,13
547,Tim Connolly,Sabres,63,55,16,39
547,Tim Connolly,Sabres,2,1,1,0
547,Tim Connolly,Sabres,48,40,7,33
547,Tim Connolly,Sabres,48,47,18,29
547,Tim Connolly,Sabres,73,65,17,48
547,Tim Connolly,Sabres,68,42,13,29
547,Tim Connolly,Maple Leafs,70,36,13,23
548,Kevin Lowe,Oilers,64,21,2,19
548,Kevin Lowe,Oilers,79,34,10,24
548,Kevin Lowe,Oilers,80,40,9,31
548,Kevin Lowe,Oilers,80,40,6,34
548,Kevin Lowe,Oilers,80,46,4,42
548,Kevin Lowe,Oilers,80,25,4,21
548,Kevin Lowe,Oilers,74,18,2,16
548,Kevin Lowe,Oilers,77,37,8,29
548,Kevin Lowe,Oilers,70,24,9,15
548,Kevin Lowe,Oilers,76,25,7,18
548,Kevin Lowe,Oilers,78,33,7,26
548,Kevin Lowe,Oilers,73,16,3,13
548,Kevin Lowe,Oilers,55,10,2,8
548,Kevin Lowe,Rangers,49,15,3,12
548,Kevin Lowe,Rangers,71,19,5,14
548,Kevin Lowe,Rangers,44,8,1,7
548,Kevin Lowe,Rangers,53,6,1,5
548,Kevin Lowe,Oilers,64,14,1,13
548,Kevin Lowe,Oilers,7,0,0,0
549,Ab McDonald,Canadiens,69,36,13,23
549,Ab McDonald,Canadiens,68,22,9,13
549,Ab McDonald,Blackhawks,61,33,17,16
549,Ab McDonald,Blackhawks,65,40,22,18
549,Ab McDonald,Blackhawks,69,61,20,41
549,Ab McDonald,Blackhawks,70,46,14,32
549,Ab McDonald,Bruins,60,18,9,9
549,Ab McDonald,Red Wings,43,22,6,16
549,Ab McDonald,Red Wings,12,2,2,0
549,Ab McDonald,Penguins,74,43,22,21
549,Ab McDonald,Blues,68,42,21,21
549,Ab McDonald,Blues,64,55,25,30
549,Ab McDonald,Blues,20,5,0,5
549,Ab McDonald,Red Wings,19,5,2,3
550,Tommy Williams,Bruins,26,12,6,6
550,Tommy Williams,Bruins,69,43,23,20
550,Tommy Williams,Bruins,37,23,8,15
550,Tommy Williams,Bruins,65,34,13,21
550,Tommy Williams,Bruins,70,38,16,22
550,Tommy Williams,Bruins,29,21,8,13
550,Tommy Williams,Bruins,68,50,18,32
550,Tommy Williams,Bruins,26,11,4,7
550,Tommy Williams,North Stars,75,67,15,52
550,Tommy Williams,North Stars,41,23,10,13
550,Tommy Williams,Seals,18,17,7,10
550,Tommy Williams,Seals,32,12,3,9
550,Tommy Williams,Capitals,73,58,22,36
550,Tommy Williams,Capitals,34,21,8,13
551,Woody Dumart,Bruins,1,0,0,0
551,Woody Dumart,Bruins,17,8,4,4
551,Woody Dumart,Bruins,48,27,13,14
551,Woody Dumart,Bruins,46,29,14,15
551,Woody Dumart,Bruins,48,43,22,21
551,Woody Dumart,Bruins,40,33,18,15
551,Woody Dumart,Bruins,35,29,14,15
551,Woody Dumart,Bruins,50,34,22,12
551,Woody Dumart,Bruins,60,52,24,28
551,Woody Dumart,Bruins,59,37,21,16
551,Woody Dumart,Bruins,59,23,11,12
551,Woody Dumart,Bruins,69,39,14,25
551,Woody Dumart,Bruins,70,41,20,21
551,Woody Dumart,Bruins,39,13,5,8
551,Woody Dumart,Bruins,62,14,5,9
551,Woody Dumart,Bruins,69,7,4,3
552,Hakan Loob,Flames,77,55,30,25
552,Hakan Loob,Flames,78,72,37,35
552,Hakan Loob,Flames,68,67,31,36
552,Hakan Loob,Flames,68,44,18,26
552,Hakan Loob,Flames,80,106,50,56
552,Hakan Loob,Flames,79,85,27,58
553,Michael Redmond,Canadiens,41,11,6,5
553,Michael Redmond,Canadiens,65,24,9,15
553,Michael Redmond,Canadiens,75,54,27,27
553,Michael Redmond,Canadiens,40,29,14,15
553,Michael Redmond,Red Wings,21,14,6,8
553,Michael Redmond,Red Wings,78,71,42,29
553,Michael Redmond,Red Wings,76,93,52,41
553,Michael Redmond,Red Wings,76,77,51,26
553,Michael Redmond,Red Wings,29,27,15,12
553,Michael Redmond,Red Wings,37,28,11,17
554,Joe Pavelski,Sharks,46,28,14,14
554,Joe Pavelski,Sharks,82,40,19,21
554,Joe Pavelski,Sharks,80,59,25,34
554,Joe Pavelski,Sharks,67,51,25,26
554,Joe Pavelski,Sharks,74,66,20,46
554,Joe Pavelski,Sharks,82,61,31,30
554,Joe Pavelski,Sharks,48,31,16,15
554,Joe Pavelski,Sharks,82,79,41,38
554,Joe Pavelski,Sharks,14,12,5,7
555,Carey Wilson,Flames,15,7,2,5
555,Carey Wilson,Flames,74,72,24,48
555,Carey Wilson,Flames,76,58,29,29
555,Carey Wilson,Flames,80,56,20,36
555,Carey Wilson,Flames,34,30,9,21
555,Carey Wilson,Whalers,36,38,18,20
555,Carey Wilson,Whalers,34,22,11,11
555,Carey Wilson,Rangers,41,55,21,34
555,Carey Wilson,Rangers,41,26,9,17
555,Carey Wilson,Whalers,45,23,8,15
555,Carey Wilson,Flames,12,6,3,3
555,Carey Wilson,Flames,42,23,11,12
555,Carey Wilson,Flames,22,11,4,7
556,Roy Conacher,Bruins,47,37,26,11
556,Roy Conacher,Bruins,31,30,18,12
556,Roy Conacher,Bruins,41,38,24,14
556,Roy Conacher,Bruins,43,37,24,13
556,Roy Conacher,Bruins,4,3,2,1
556,Roy Conacher,Red Wings,60,54,30,24
556,Roy Conacher,Blackhawks,52,49,22,27
556,Roy Conacher,Blackhawks,60,68,26,42
556,Roy Conacher,Blackhawks,70,56,25,31
556,Roy Conacher,Blackhawks,70,50,26,24
556,Roy Conacher,Blackhawks,12,4,3,1
557,Ilkka Sinisalo,Flyers,66,37,15,22
557,Ilkka Sinisalo,Flyers,61,50,21,29
557,Ilkka Sinisalo,Flyers,73,46,29,17
557,Ilkka Sinisalo,Flyers,70,73,36,37
557,Ilkka Sinisalo,Flyers,74,76,39,37
557,Ilkka Sinisalo,Flyers,42,31,10,21
557,Ilkka Sinisalo,Flyers,68,42,25,17
557,Ilkka Sinisalo,Flyers,13,7,1,6
557,Ilkka Sinisalo,Flyers,59,46,23,23
557,Ilkka Sinisalo,North Stars,46,17,5,12
557,Ilkka Sinisalo,Kings,7,0,0,0
557,Ilkka Sinisalo,Kings,3,1,0,1
558,Lorne Carr,Rangers,14,0,0,0
558,Lorne Carr,Americans,48,31,17,14
558,Lorne Carr,Americans,44,18,8,10
558,Lorne Carr,Americans,48,34,18,16
558,Lorne Carr,Americans,48,23,16,7
558,Lorne Carr,Americans,46,37,19,18
558,Lorne Carr,Americans,48,25,8,17
558,Lorne Carr,Americans,48,32,13,19
558,Lorne Carr,Maple Leafs,47,33,16,17
558,Lorne Carr,Maple Leafs,50,60,27,33
558,Lorne Carr,Maple Leafs,50,74,36,38
558,Lorne Carr,Maple Leafs,47,46,21,25
558,Lorne Carr,Maple Leafs,42,13,5,8
559,Terry Ruskowski,Blackhawks,74,70,15,55
559,Terry Ruskowski,Blackhawks,72,59,8,51
559,Terry Ruskowski,Blackhawks,60,37,7,30
559,Terry Ruskowski,Blackhawks,5,2,0,2
559,Terry Ruskowski,Kings,71,44,14,30
559,Terry Ruskowski,Kings,77,32,7,25
559,Terry Ruskowski,Kings,78,49,16,33
559,Terry Ruskowski,Penguins,73,63,26,37
559,Terry Ruskowski,Penguins,70,51,14,37
559,Terry Ruskowski,North Stars,47,17,5,12
559,Terry Ruskowski,North Stars,3,2,1,1
560,Hooley Smith,Senators (1917),30,23,10,13
560,Hooley Smith,Senators (1917),28,25,16,9
560,Hooley Smith,Senators (1917),43,15,9,6
560,Hooley Smith,Maroons,34,19,14,5
560,Hooley Smith,Maroons,41,19,10,9
560,Hooley Smith,Maroons,42,30,21,9
560,Hooley Smith,Maroons,39,26,12,14
560,Hooley Smith,Maroons,43,44,11,33
560,Hooley Smith,Maroons,48,41,20,21
560,Hooley Smith,Maroons,47,37,18,19
560,Hooley Smith,Maroons,46,27,5,22
560,Hooley Smith,Maroons,47,38,19,19
560,Hooley Smith,Bruins,44,18,8,10
560,Hooley Smith,Americans,47,20,10,10
560,Hooley Smith,Americans,48,19,8,11
560,Hooley Smith,Americans,47,15,7,8
560,Hooley Smith,Americans,41,9,2,7
561,Frank St. Marseille,Blues,57,32,16,16
561,Frank St. Marseille,Blues,72,38,12,26
561,Frank St. Marseille,Blues,74,59,16,43
561,Frank St. Marseille,Blues,77,51,19,32
561,Frank St. Marseille,Blues,78,52,16,36
561,Frank St. Marseille,Blues,45,25,7,18
561,Frank St. Marseille,Kings,29,11,7,4
561,Frank St. Marseille,Kings,78,50,14,36
561,Frank St. Marseille,Kings,80,53,17,36
561,Frank St. Marseille,Kings,68,26,10,16
561,Frank St. Marseille,Kings,49,28,6,22
562,James Peplinski,Flames,80,38,13,25
562,James Peplinski,Flames,74,67,30,37
562,James Peplinski,Flames,80,41,15,26
562,James Peplinski,Flames,74,33,11,22
562,James Peplinski,Flames,80,45,16,29
562,James Peplinski,Flames,77,59,24,35
562,James Peplinski,Flames,80,50,18,32
562,James Peplinski,Flames,75,51,20,31
562,James Peplinski,Flames,79,38,13,25
562,James Peplinski,Flames,6,1,1,0
562,James Peplinski,Flames,6,1,0,1
563,Philip Russell,Blackhawks,76,25,6,19
563,Philip Russell,Blackhawks,75,35,10,25
563,Philip Russell,Blackhawks,80,29,5,24
563,Philip Russell,Blackhawks,74,38,9,29
563,Philip Russell,Blackhawks,76,45,9,36
563,Philip Russell,Blackhawks,57,26,6,20
563,Philip Russell,Blackhawks,66,31,8,23
563,Philip Russell,Flames,13,7,1,6
563,Philip Russell,Flames,80,36,5,31
563,Philip Russell,Flames,80,29,6,23
563,Philip Russell,Flames,71,29,4,25
563,Philip Russell,Flames,78,31,13,18
563,Philip Russell,Devils,76,31,9,22
563,Philip Russell,Devils,66,20,4,16
563,Philip Russell,Devils,30,5,2,3
563,Philip Russell,Sabres,12,5,2,3
563,Philip Russell,Sabres,6,2,0,2
564,Derek Morris,Flames,82,29,9,20
564,Derek Morris,Flames,71,34,7,27
564,Derek Morris,Flames,78,38,9,29
564,Derek Morris,Flames,51,28,5,23
564,Derek Morris,Flames,61,34,4,30
564,Derek Morris,Avalanche,75,48,11,37
564,Derek Morris,Avalanche,69,28,6,22
564,Derek Morris,Coyotes,14,4,0,4
564,Derek Morris,Coyotes,53,27,6,21
564,Derek Morris,Coyotes,82,25,6,19
564,Derek Morris,Coyotes,82,25,8,17
564,Derek Morris,Coyotes,57,12,5,7
564,Derek Morris,Rangers,18,8,0,8
564,Derek Morris,Bruins,58,25,3,22
564,Derek Morris,Coyotes,18,4,1,3
564,Derek Morris,Coyotes,77,16,5,11
564,Derek Morris,Coyotes,59,11,2,9
564,Derek Morris,Coyotes,39,11,0,11
564,Derek Morris,Coyotes,63,17,5,12
565,Gerry Meehan,Maple Leafs,25,2,0,2
565,Gerry Meehan,Flyers,12,3,0,3
565,Gerry Meehan,Sabres,77,55,24,31
565,Gerry Meehan,Sabres,77,46,19,27
565,Gerry Meehan,Sabres,77,60,31,29
565,Gerry Meehan,Sabres,72,46,20,26
565,Gerry Meehan,Sabres,3,1,0,1
565,Gerry Meehan,Canucks,57,25,10,15
565,Gerry Meehan,Flames,14,14,4,10
565,Gerry Meehan,Flames,48,27,7,20
565,Gerry Meehan,Capitals,32,31,16,15
565,Gerry Meehan,Capitals,80,64,28,36
565,Gerry Meehan,Capitals,78,43,19,24
565,Gerry Meehan,Capitals,18,6,2,4
566,Bill Fairbairn,Rangers,1,0,0,0
566,Bill Fairbairn,Rangers,76,56,23,33
566,Bill Fairbairn,Rangers,56,30,7,23
566,Bill Fairbairn,Rangers,78,59,22,37
566,Bill Fairbairn,Rangers,78,63,30,33
566,Bill Fairbairn,Rangers,78,62,18,44
566,Bill Fairbairn,Rangers,80,61,24,37
566,Bill Fairbairn,Rangers,80,28,13,15
566,Bill Fairbairn,Rangers,9,3,1,2
566,Bill Fairbairn,North Stars,51,29,9,20
566,Bill Fairbairn,North Stars,6,1,0,1
566,Bill Fairbairn,Blues,60,30,14,16
566,Bill Fairbairn,Blues,5,1,1,0
567,Frank Boucher,Senators (1917),24,10,8,2
567,Frank Boucher,Rangers,44,28,13,15
567,Frank Boucher,Rangers,44,35,23,12
567,Frank Boucher,Rangers,44,26,10,16
567,Frank Boucher,Rangers,42,62,26,36
567,Frank Boucher,Rangers,44,39,12,27
567,Frank Boucher,Rangers,48,35,12,23
567,Frank Boucher,Rangers,46,35,7,28
567,Frank Boucher,Rangers,48,44,14,30
567,Frank Boucher,Rangers,48,45,13,32
567,Frank Boucher,Rangers,48,29,11,18
567,Frank Boucher,Rangers,44,20,7,13
567,Frank Boucher,Rangers,18,1,0,1
567,Frank Boucher,Rangers,15,14,4,10
568,Robert Picard,Capitals,75,37,10,27
568,Robert Picard,Capitals,77,65,21,44
568,Robert Picard,Capitals,78,54,11,43
568,Robert Picard,Maple Leafs,59,25,6,19
568,Robert Picard,Canadiens,8,4,2,2
568,Robert Picard,Canadiens,62,28,2,26
568,Robert Picard,Canadiens,64,38,7,31
568,Robert Picard,Canadiens,7,2,0,2
568,Robert Picard,Jets (1979),62,22,6,16
568,Robert Picard,Jets (1979),78,34,12,22
568,Robert Picard,Jets (1979),20,7,2,5
568,Robert Picard,Nordiques,48,34,7,27
568,Robert Picard,Nordiques,78,28,8,20
568,Robert Picard,Nordiques,65,16,3,13
568,Robert Picard,Nordiques,74,21,7,14
568,Robert Picard,Nordiques,24,5,0,5
568,Robert Picard,Red Wings,20,3,0,3
569,Walt Poddubny,Oilers,4,0,0,0
569,Walt Poddubny,Maple Leafs,11,7,3,4
569,Walt Poddubny,Maple Leafs,72,59,28,31
569,Walt Poddubny,Maple Leafs,38,25,11,14
569,Walt Poddubny,Maple Leafs,32,20,5,15
569,Walt Poddubny,Maple Leafs,33,34,12,22
569,Walt Poddubny,Rangers,75,87,40,47
569,Walt Poddubny,Rangers,77,88,38,50
569,Walt Poddubny,Nordiques,72,75,38,37
569,Walt Poddubny,Devils,33,14,4,10
569,Walt Poddubny,Devils,14,10,4,6
569,Walt Poddubny,Devils,7,3,1,2