id,name,team,gamesPlayed,points,goals,assists
0,Wayne Gretzky,Oilers,79,137,51,86
0,Wayne Gretzky,Oilers,80,164,55,109
0,Wayne Gretzky,Oilers,80,212,92,120
0,Wayne Gretzky,Oilers,80,196,71,125
0,Wayne Gretzky,Oilers,74,205,87,118
0,Wayne Gretzky,Oilers,80,208,73,135
0,Wayne Gretzky,Oilers,80,215,52,163
0,Wayne Gretzky,Oilers,79,183,62,121
0,Wayne Gretzky,Oilers,64,149,40,109
0,Wayne Gretzky,Kings,78,168,54,114
0,Wayne Gretzky,Kings,73,142,40,102
0,Wayne Gretzky,Kings,78,163,41,122
0,Wayne Gretzky,Kings,74,121,31,90
0,Wayne Gretzky,Kings,45,65,16,49
0,Wayne Gretzky,Kings,81,130,38,92
0,Wayne Gretzky,Kings,48,48,11,37
0,Wayne Gretzky,Kings,62,81,15,66
0,Wayne Gretzky,Blues,18,21,8,13
0,Wayne Gretzky,Rangers,82,97,25,72
0,Wayne Gretzky,Rangers,82,90,23,67
0,Wayne Gretzky,Rangers,70,62,9,53
1,Gordie Howe,Red Wings,58,22,7,15
1,Gordie Howe,Red Wings,60,44,16,28
1,Gordie Howe,Red Wings,40,37,12,25
1,Gordie Howe,Red Wings,70,68,35,33
1,Gordie Howe,Red Wings,70,86,43,43
1,Gordie Howe,Red Wings,70,86,47,39
1,Gordie Howe,Red Wings,70,95,49,46
1,Gordie Howe,Red Wings,70,81,33,48
1,Gordie Howe,Red Wings,64,62,29,33
1,Gordie Howe,Red Wings,70,79,38,41
1,Gordie Howe,Red Wings,70,89,44,45
1,Gordie Howe,Red Wings,64,77,33,44
1,Gordie Howe,Red Wings,70,78,32,46
1,Gordie Howe,Red Wings,70,73,28,45
1,Gordie Howe,Red Wings,64,72,23,49
1,Gordie Howe,Red Wings,70,77,33,44
1,Gordie Howe,Red Wings,70,86,38,48
1,Gordie Howe,Red Wings,69,73,26,47
1,Gordie Howe,Red Wings,70,76,29,47
1,Gordie Howe,Red Wings,70,75,29,46
1,Gordie Howe,Red Wings,69,65,25,40
1,Gordie Howe,Red Wings,74,82,39,43
1,Gordie Howe,Red Wings,76,103,44,59
1,Gordie Howe,Red Wings,76,71,31,40
1,Gordie Howe,Red Wings,63,52,23,29
1,Gordie Howe,Whalers,80,41,15,26
2,Brett Hull,Flames,5,1,1,0
2,Brett Hull,Flames,52,50,26,24
2,Brett Hull,Blues,13,14,6,8
2,Brett Hull,Blues,78,84,41,43
2,Brett Hull,Blues,80,113,72,41
2,Brett Hull,Blues,78,131,86,45
2,Brett Hull,Blues,73,109,70,39
2,Brett Hull,Blues,80,101,54,47
2,Brett Hull,Blues,81,97,57,40
2,Brett Hull,Blues,48,50,29,21
2,Brett Hull,Blues,70,83,43,40
2,Brett Hull,Blues,77,82,42,40
2,Brett Hull,Blues,66,72,27,45
2,Brett Hull,Stars,60,58,32,26
2,Brett Hull,Stars,79,59,24,35
2,Brett Hull,Stars,79,79,39,40
2,Brett Hull,Red Wings,82,63,30,33
2,Brett Hull,Red Wings,82,76,37,39
2,Brett Hull,Red Wings,81,68,25,43
2,Brett Hull,Coyotes,5,1,0,1
3,Marcel Dionne,Red Wings,78,77,28,49
3,Marcel Dionne,Red Wings,77,90,40,50
3,Marcel Dionne,Red Wings,74,78,24,54
3,Marcel Dionne,Red Wings,80,121,47,74
3,Marcel Dionne,Kings,80,94,40,54
3,Marcel Dionne,Kings,80,122,53,69
3,Marcel Dionne,Kings,70,79,36,43
3,Marcel Dionne,Kings,80,130,59,71
3,Marcel Dionne,Kings,80,137,53,84
3,Marcel Dionne,Kings,80,135,58,77
3,Marcel Dionne,Kings,78,117,50,67
3,Marcel Dionne,Kings,80,107,56,51
3,Marcel Dionne,Kings,66,92,39,53
3,Marcel Dionne,Kings,80,126,46,80
3,Marcel Dionne,Kings,80,94,36,58
3,Marcel Dionne,Kings,67,74,24,50
3,Marcel Dionne,Rangers,14,10,4,6
3,Marcel Dionne,Rangers,67,65,31,34
3,Marcel Dionne,Rangers,37,23,7,16
4,Phil Esposito,Blackhawks,27,5,3,2
4,Phil Esposito,Blackhawks,70,55,23,32
4,Phil Esposito,Blackhawks,69,53,27,26
4,Phil Esposito,Blackhawks,69,61,21,40
4,Phil Esposito,Bruins,74,84,35,49
4,Phil Esposito,Bruins,74,126,49,77
4,Phil Esposito,Bruins,76,99,43,56
4,Phil Esposito,Bruins,78,152,76,76
4,Phil Esposito,Bruins,76,133,66,67
4,Phil Esposito,Bruins,78,130,55,75
4,Phil Esposito,Bruins,78,145,68,77
4,Phil Esposito,Bruins,79,127,61,66
4,Phil Esposito,Bruins,12,16,6,10
4,Phil Esposito,Rangers,62,67,29,38
4,Phil Esposito,Rangers,80,80,34,46
4,Phil Esposito,Rangers,79,81,38,43
4,Phil Esposito,Rangers,80,78,42,36
4,Phil Esposito,Rangers,80,78,34,44
4,Phil Esposito,Rangers,41,20,7,13
5,Jaromir Jagr,Penguins,80,57,27,30
5,Jaromir Jagr,Penguins,70,69,32,37
5,Jaromir Jagr,Penguins,81,94,34,60
5,Jaromir Jagr,Penguins,80,99,32,67
5,Jaromir Jagr,Penguins,48,70,32,38
5,Jaromir Jagr,Penguins,82,149,62,87
5,Jaromir Jagr,Penguins,63,95,47,48
5,Jaromir Jagr,Penguins,77,102,35,67
5,Jaromir Jagr,Penguins,81,127,44,83
5,Jaromir Jagr,Penguins,63,96,42,54
5,Jaromir Jagr,Penguins,81,121,52,69
5,Jaromir Jagr,Capitals,69,79,31,48
5,Jaromir Jagr,Capitals,75,77,36,41
5,Jaromir Jagr,Capitals,46,45,16,29
5,Jaromir Jagr,Rangers,31,29,15,14
5,Jaromir Jagr,Rangers,82,123,54,69
5,Jaromir Jagr,Rangers,82,96,30,66
5,Jaromir Jagr,Rangers,82,71,25,46
5,Jaromir Jagr,Flyers,73,54,19,35
5,Jaromir Jagr,Stars,34,26,14,12
5,Jaromir Jagr,Bruins,11,9,2,7
5,Jaromir Jagr,Devils,82,67,24,43
5,Jaromir Jagr,Devils,23,15,4,11
6,Mike Gartner,Capitals,77,68,36,32
6,Mike Gartner,Capitals,80,94,48,46
6,Mike Gartner,Capitals,80,80,35,45
6,Mike Gartner,Capitals,73,76,38,38
6,Mike Gartner,Capitals,80,85,40,45
6,Mike Gartner,Capitals,80,102,50,52
6,Mike Gartner,Capitals,74,75,35,40
6,Mike Gartner,Capitals,78,73,41,32
6,Mike Gartner,Capitals,80,81,48,33
6,Mike Gartner,Capitals,56,55,26,29
6,Mike Gartner,North Stars,13,14,7,7
6,Mike Gartner,North Stars,67,70,34,36
6,Mike Gartner,Rangers,12,16,11,5
6,Mike Gartner,Rangers,79,69,49,20
6,Mike Gartner,Rangers,76,81,40,41
6,Mike Gartner,Rangers,84,68,45,23
6,Mike Gartner,Rangers,71,52,28,24
6,Mike Gartner,Maple Leafs,10,12,6,6
6,Mike Gartner,Maple Leafs,38,20,12,8
6,Mike Gartner,Maple Leafs,82,54,35,19
6,Mike Gartner,Coyotes,82,63,32,31
6,Mike Gartner,Coyotes,60,27,12,15
7,Mark Messier,Oilers,75,33,12,21
7,Mark Messier,Oilers,72,63,23,40
7,Mark Messier,Oilers,78,88,50,38
7,Mark Messier,Oilers,77,106,48,58
7,Mark Messier,Oilers,73,101,37,64
7,Mark Messier,Oilers,55,54,23,31
7,Mark Messier,Oilers,63,84,35,49
7,Mark Messier,Oilers,77,107,37,70
7,Mark Messier,Oilers,77,111,37,74
7,Mark Messier,Oilers,72,94,33,61
7,Mark Messier,Oilers,79,129,45,84
7,Mark Messier,Oilers,53,64,12,52
7,Mark Messier,Rangers,79,107,35,72
7,Mark Messier,Rangers,75,91,25,66
7,Mark Messier,Rangers,76,84,26,58
7,Mark Messier,Rangers,46,53,14,39
7,Mark Messier,Rangers,74,99,47,52
7,Mark Messier,Rangers,71,84,36,48
7,Mark Messier,Canucks,82,60,22,38
7,Mark Messier,Canucks,59,48,13,35
7,Mark Messier,Canucks,66,54,17,37
7,Mark Messier,Rangers,82,67,24,43
7,Mark Messier,Rangers,41,23,7,16
7,Mark Messier,Rangers,78,40,18,22
7,Mark Messier,Rangers,76,43,18,25
8,Steve Yzerman,Red Wings,80,87,39,48
8,Steve Yzerman,Red Wings,80,89,30,59
8,Steve Yzerman,Red Wings,51,42,14,28
8,Steve Yzerman,Red Wings,80,90,31,59
8,Steve Yzerman,Red Wings,64,102,50,52
8,Steve Yzerman,Red Wings,80,155,65,90
8,Steve Yzerman,Red Wings,79,127,62,65
8,Steve Yzerman,Red Wings,80,108,51,57
8,Steve Yzerman,Red Wings,79,103,45,58
8,Steve Yzerman,Red Wings,84,137,58,79
8,Steve Yzerman,Red Wings,58,82,24,58
8,Steve Yzerman,Red Wings,47,38,12,26
8,Steve Yzerman,Red Wings,80,95,36,59
8,Steve Yzerman,Red Wings,81,85,22,63
8,Steve Yzerman,Red Wings,75,69,24,45
8,Steve Yzerman,Red Wings,80,74,29,45
8,Steve Yzerman,Red Wings,78,79,35,44
8,Steve Yzerman,Red Wings,54,52,18,34
8,Steve Yzerman,Red Wings,52,48,13,35
8,Steve Yzerman,Red Wings,16,8,2,6
8,Steve Yzerman,Red Wings,75,51,18,33
8,Steve Yzerman,Red Wings,61,34,14,20
9,Mario Lemieux,Penguins,73,100,43,57
9,Mario Lemieux,Penguins,79,141,48,93
9,Mario Lemieux,Penguins,63,107,54,53
9,Mario Lemieux,Penguins,77,168,70,98
9,Mario Lemieux,Penguins,76,199,85,114
9,Mario Lemieux,Penguins,59,123,45,78
9,Mario Lemieux,Penguins,26,45,19,26
9,Mario Lemieux,Penguins,64,131,44,87
9,Mario Lemieux,Penguins,60,160,69,91
9,Mario Lemieux,Penguins,22,37,17,20
9,Mario Lemieux,Penguins,70,161,69,92
9,Mario Lemieux,Penguins,76,122,50,72
9,Mario Lemieux,Penguins,43,76,35,41
9,Mario Lemieux,Penguins,24,31,6,25
9,Mario Lemieux,Penguins,67,91,28,63
9,Mario Lemieux,Penguins,10,9,1,8
9,Mario Lemieux,Penguins,26,22,7,15
10,Teemu Selanne,Jets (1979),84,132,76,56
10,Teemu Selanne,Jets (1979),51,54,25,29
10,Teemu Selanne,Jets (1979),45,48,22,26
10,Teemu Selanne,Jets (1979),51,72,24,48
10,Teemu Selanne,Ducks,28,36,16,20
10,Teemu Selanne,Ducks,78,109,51,58
10,Teemu Selanne,Ducks,73,86,52,34
10,Teemu Selanne,Ducks,75,107,47,60
10,Teemu Selanne,Ducks,79,85,33,52
10,Teemu Selanne,Ducks,61,59,26,33
10,Teemu Selanne,Sharks,12,13,7,6
10,Teemu Selanne,Sharks,82,54,29,25
10,Teemu Selanne,Sharks,82,64,28,36
10,Teemu Selanne,Avalanche,78,32,16,16
10,Teemu Selanne,Ducks,80,90,40,50
10,Teemu Selanne,Ducks,82,94,48,46
10,Teemu Selanne,Ducks,26,23,12,11
10,Teemu Selanne,Ducks,65,54,27,27
10,Teemu Selanne,Ducks,54,48,27,21
10,Teemu Selanne,Ducks,73,80,31,49
10,Teemu Selanne,Ducks,82,66,26,40
10,Teemu Selanne,Ducks,46,24,12,12
10,Teemu Selanne,Ducks,64,27,9,18
11,Luc Robitaille,Kings,79,84,45,39
11,Luc Robitaille,Kings,80,111,53,58
11,Luc Robitaille,Kings,78,98,46,52
11,Luc Robitaille,Kings,80,101,52,49
11,Luc Robitaille,Kings,76,91,45,46
11,Luc Robitaille,Kings,80,107,44,63
11,Luc Robitaille,Kings,84,125,63,62
11,Luc Robitaille,Kings,83,86,44,42
11,Luc Robitaille,Penguins,46,42,23,19
11,Luc Robitaille,Rangers,77,69,23,46
11,Luc Robitaille,Rangers,69,48,24,24
11,Luc Robitaille,Kings,57,40,16,24
11,Luc Robitaille,Kings,82,74,39,35
11,Luc Robitaille,Kings,71,74,36,38
11,Luc Robitaille,Kings,82,88,37,51
11,Luc Robitaille,Red Wings,81,50,30,20
11,Luc Robitaille,Red Wings,81,31,11,20
11,Luc Robitaille,Kings,80,51,22,29
11,Luc Robitaille,Kings,65,24,15,9
12,Brendan Shanahan,Devils,65,26,7,19
12,Brendan Shanahan,Devils,68,50,22,28
12,Brendan Shanahan,Devils,73,72,30,42
12,Brendan Shanahan,Devils,75,66,29,37
12,Brendan Shanahan,Blues,80,69,33,36
12,Brendan Shanahan,Blues,71,94,51,43
12,Brendan Shanahan,Blues,81,102,52,50
12,Brendan Shanahan,Blues,45,41,20,21
12,Brendan Shanahan,Whalers,74,78,44,34
12,Brendan Shanahan,Whalers,2,1,1,0
12,Brendan Shanahan,Red Wings,79,87,46,41
12,Brendan Shanahan,Red Wings,75,57,28,29
12,Brendan Shanahan,Red Wings,81,58,31,27
12,Brendan Shanahan,Red Wings,78,78,41,37
12,Brendan Shanahan,Red Wings,81,76,31,45
12,Brendan Shanahan,Red Wings,80,75,37,38
12,Brendan Shanahan,Red Wings,78,68,30,38
12,Brendan Shanahan,Red Wings,82,53,25,28
12,Brendan Shanahan,Red Wings,82,81,40,41
12,Brendan Shanahan,Rangers,67,62,29,33
12,Brendan Shanahan,Rangers,73,46,23,23
12,Brendan Shanahan,Devils,34,14,6,8
13,Dave Andreychuk,Sabres,43,37,14,23
13,Dave Andreychuk,Sabres,78,80,38,42
13,Dave Andreychuk,Sabres,64,61,31,30
13,Dave Andreychuk,Sabres,80,87,36,51
13,Dave Andreychuk,Sabres,77,73,25,48
13,Dave Andreychuk,Sabres,80,78,30,48
13,Dave Andreychuk,Sabres,56,52,28,24
13,Dave Andreychuk,Sabres,73,82,40,42
13,Dave Andreychuk,Sabres,80,69,36,33
13,Dave Andreychuk,Sabres,80,91,41,50
13,Dave Andreychuk,Sabres,52,61,29,32
13,Dave Andreychuk,Maple Leafs,31,38,25,13
13,Dave Andreychuk,Maple Leafs,83,99,53,46
13,Dave Andreychuk,Maple Leafs,48,38,22,16
13,Dave Andreychuk,Maple Leafs,61,44,20,24
13,Dave Andreychuk,Devils,15,13,8,5
13,Dave Andreychuk,Devils,82,61,27,34
13,Dave Andreychuk,Devils,75,48,14,34
13,Dave Andreychuk,Devils,52,28,15,13
13,Dave Andreychuk,Bruins,63,33,19,14
13,Dave Andreychuk,Avalanche,14,3,1,2
13,Dave Andreychuk,Sabres,74,33,20,13
13,Dave Andreychuk,Lightning,82,38,21,17
13,Dave Andreychuk,Lightning,72,34,20,14
13,Dave Andreychuk,Lightning,82,39,21,18
13,Dave Andreychuk,Lightning,42,18,6,12
14,Joe Sakic,Nordiques,70,62,23,39
14,Joe Sakic,Nordiques,80,102,39,63
14,Joe Sakic,Nordiques,80,109,48,61
14,Joe Sakic,Nordiques,69,94,29,65
14,Joe Sakic,Nordiques,78,105,48,57
14,Joe Sakic,Nordiques,84,92,28,64
14,Joe Sakic,Nordiques,47,62,19,43
14,Joe Sakic,Avalanche,82,120,51,69
14,Joe Sakic,Avalanche,65,74,22,52
14,Joe Sakic,Avalanche,64,63,27,36
14,Joe Sakic,Avalanche,73,96,41,55
14,Joe Sakic,Avalanche,60,81,28,53
14,Joe Sakic,Avalanche,82,118,54,64
14,Joe Sakic,Avalanche,82,79,26,53
14,Joe Sakic,Avalanche,58,58,26,32
14,Joe Sakic,Avalanche,81,87,33,54
14,Joe Sakic,Avalanche,82,87,32,55
14,Joe Sakic,Avalanche,82,100,36,64
14,Joe Sakic,Avalanche,44,40,13,27
14,Joe Sakic,Avalanche,15,12,2,10
15,Bobby Hull,Blackhawks,70,47,13,34
15,Bobby Hull,Blackhawks,70,50,18,32
15,Bobby Hull,Blackhawks,70,81,39,42
15,Bobby Hull,Blackhawks,67,56,31,25
15,Bobby Hull,Blackhawks,70,84,50,34
15,Bobby Hull,Blackhawks,65,62,31,31
15,Bobby Hull,Blackhawks,70,87,43,44
15,Bobby Hull,Blackhawks,61,71,39,32
15,Bobby Hull,Blackhawks,65,97,54,43
15,Bobby Hull,Blackhawks,66,80,52,28
15,Bobby Hull,Blackhawks,71,75,44,31
15,Bobby Hull,Blackhawks,74,107,58,49
15,Bobby Hull,Blackhawks,61,67,38,29
15,Bobby Hull,Blackhawks,78,96,44,52
15,Bobby Hull,Blackhawks,78,93,50,43
15,Bobby Hull,Jets (1979),18,10,4,6
15,Bobby Hull,Whalers,9,7,2,5
16,Dino Ciccarelli,North Stars,32,30,18,12
16,Dino Ciccarelli,North Stars,76,106,55,51
16,Dino Ciccarelli,North Stars,77,75,37,38
16,Dino Ciccarelli,North Stars,79,71,38,33
16,Dino Ciccarelli,North Stars,51,32,15,17
16,Dino Ciccarelli,North Stars,75,89,44,45
16,Dino Ciccarelli,North Stars,80,103,52,51
16,Dino Ciccarelli,North Stars,67,86,41,45
16,Dino Ciccarelli,North Stars,65,59,32,27
16,Dino Ciccarelli,Capitals,11,15,12,3
16,Dino Ciccarelli,Capitals,80,79,41,38
16,Dino Ciccarelli,Capitals,54,39,21,18
16,Dino Ciccarelli,Capitals,78,76,38,38
16,Dino Ciccarelli,Red Wings,82,97,41,56
16,Dino Ciccarelli,Red Wings,66,57,28,29
16,Dino Ciccarelli,Red Wings,42,43,16,27
16,Dino Ciccarelli,Red Wings,64,43,22,21
16,Dino Ciccarelli,Lightning,77,60,35,25
16,Dino Ciccarelli,Lightning,34,17,11,6
16,Dino Ciccarelli,Panthers,28,16,5,11
16,Dino Ciccarelli,Panthers,14,7,6,1
17,Jari Kurri,Oilers,75,75,32,43
17,Jari Kurri,Oilers,71,86,32,54
17,Jari Kurri,Oilers,80,104,45,59
17,Jari Kurri,Oilers,64,113,52,61
17,Jari Kurri,Oilers,73,135,71,64
17,Jari Kurri,Oilers,78,131,68,63
17,Jari Kurri,Oilers,79,108,54,54
17,Jari Kurri,Oilers,80,96,43,53
17,Jari Kurri,Oilers,76,102,44,58
17,Jari Kurri,Oilers,78,93,33,60
17,Jari Kurri,Kings,73,60,23,37
17,Jari Kurri,Kings,82,87,27,60
17,Jari Kurri,Kings,81,77,31,46
17,Jari Kurri,Kings,38,29,10,19
17,Jari Kurri,Kings,57,40,17,23
17,Jari Kurri,Rangers,14,5,1,4
17,Jari Kurri,Ducks,82,35,13,22
17,Jari Kurri,Avalanche,70,22,5,17
18,Mark Recchi,Penguins,15,2,1,1
18,Mark Recchi,Penguins,74,67,30,37
18,Mark Recchi,Penguins,78,113,40,73
18,Mark Recchi,Penguins,58,70,33,37
18,Mark Recchi,Flyers,22,27,10,17
18,Mark Recchi,Flyers,84,123,53,70
18,Mark Recchi,Flyers,84,107,40,67
18,Mark Recchi,Flyers,10,5,2,3
18,Mark Recchi,Canadiens,39,43,14,29
18,Mark Recchi,Canadiens,82,78,28,50
18,Mark Recchi,Canadiens,82,80,34,46
18,Mark Recchi,Canadiens,82,74,32,42
18,Mark Recchi,Canadiens,61,47,12,35
18,Mark Recchi,Flyers,10,6,4,2
18,Mark Recchi,Flyers,82,91,28,63
18,Mark Recchi,Flyers,69,77,27,50
18,Mark Recchi,Flyers,80,64,22,42
18,Mark Recchi,Flyers,79,52,20,32
18,Mark Recchi,Flyers,82,75,26,49
18,Mark Recchi,Penguins,63,57,24,33
18,Mark Recchi,Hurricanes,20,7,4,3
18,Mark Recchi,Penguins,82,68,24,44
18,Mark Recchi,Penguins,19,8,2,6
18,Mark Recchi,Thrashers,53,40,12,28
18,Mark Recchi,Lightning,62,45,13,32
18,Mark Recchi,Bruins,18,16,10,6
18,Mark Recchi,Bruins,81,43,18,25
18,Mark Recchi,Bruins,81,48,14,34
19,Mike Bossy,Islanders,73,91,53,38
19,Mike Bossy,Islanders,80,126,69,57
19,Mike Bossy,Islanders,75,92,51,41
19,Mike Bossy,Islanders,79,119,68,51
19,Mike Bossy,Islanders,80,147,64,83
19,Mike Bossy,Islanders,79,118,60,58
19,Mike Bossy,Islanders,67,118,51,67
19,Mike Bossy,Islanders,76,117,58,59
19,Mike Bossy,Islanders,80,123,61,62
19,Mike Bossy,Islanders,63,75,38,37
20,Mats Sundin,Nordiques,80,59,23,36
20,Mats Sundin,Nordiques,80,76,33,43
20,Mats Sundin,Nordiques,80,114,47,67
20,Mats Sundin,Nordiques,84,85,32,53
20,Mats Sundin,Maple Leafs,47,47,23,24
20,Mats Sundin,Maple Leafs,76,83,33,50
20,Mats Sundin,Maple Leafs,82,94,41,53
20,Mats Sundin,Maple Leafs,82,74,33,41
20,Mats Sundin,Maple Leafs,82,83,31,52
20,Mats Sundin,Maple Leafs,73,73,32,41
20,Mats Sundin,Maple Leafs,82,74,28,46
20,Mats Sundin,Maple Leafs,82,80,41,39
20,Mats Sundin,Maple Leafs,75,72,37,35
20,Mats Sundin,Maple Leafs,81,75,31,44
20,Mats Sundin,Maple Leafs,70,78,31,47
20,Mats Sundin,Maple Leafs,75,76,27,49
20,Mats Sundin,Maple Leafs,74,78,32,46
20,Mats Sundin,Canucks,41,28,9,19
21,Joe Nieuwendyk,Flames,9,6,5,1
21,Joe Nieuwendyk,Flames,75,92,51,41
21,Joe Nieuwendyk,Flames,77,82,51,31
21,Joe Nieuwendyk,Flames,79,95,45,50
21,Joe Nieuwendyk,Flames,79,85,45,40
21,Joe Nieuwendyk,Flames,69,56,22,34
21,Joe Nieuwendyk,Flames,79,75,38,37
21,Joe Nieuwendyk,Flames,64,75,36,39
21,Joe Nieuwendyk,Flames,46,50,21,29
21,Joe Nieuwendyk,Stars,52,32,14,18
21,Joe Nieuwendyk,Stars,66,51,30,21
21,Joe Nieuwendyk,Stars,73,69,39,30
21,Joe Nieuwendyk,Stars,67,55,28,27
21,Joe Nieuwendyk,Stars,48,34,15,19
21,Joe Nieuwendyk,Stars,69,52,29,23
21,Joe Nieuwendyk,Stars,67,47,23,24
21,Joe Nieuwendyk,Devils,14,11,2,9
21,Joe Nieuwendyk,Devils,80,45,17,28
21,Joe Nieuwendyk,Maple Leafs,64,50,22,28
21,Joe Nieuwendyk,Panthers,65,56,26,30
21,Joe Nieuwendyk,Panthers,15,8,5,3
22,Jarome Iginla,Flames,82,50,21,29
22,Jarome Iginla,Flames,70,32,13,19
22,Jarome Iginla,Flames,82,51,28,23
22,Jarome Iginla,Flames,77,63,29,34
22,Jarome Iginla,Flames,77,71,31,40
22,Jarome Iginla,Flames,82,96,52,44
22,Jarome Iginla,Flames,75,67,35,32
22,Jarome Iginla,Flames,81,73,41,32
22,Jarome Iginla,Flames,82,67,35,32
22,Jarome Iginla,Flames,70,94,39,55
22,Jarome Iginla,Flames,82,98,50,48
22,Jarome Iginla,Flames,82,89,35,54
22,Jarome Iginla,Flames,82,69,32,37
22,Jarome Iginla,Flames,82,86,43,43
22,Jarome Iginla,Flames,82,67,32,35
22,Jarome Iginla,Flames,31,22,9,13
22,Jarome Iginla,Penguins,13,11,5,6
22,Jarome Iginla,Bruins,78,61,30,31
22,Jarome Iginla,Avalanche,23,14,3,11
23,Mike Modano,North Stars,80,75,29,46
23,Mike Modano,North Stars,79,64,28,36
23,Mike Modano,North Stars,76,77,33,44
23,Mike Modano,North Stars,82,93,33,60
23,Mike Modano,Stars,76,93,50,43
23,Mike Modano,Stars,30,29,12,17
23,Mike Modano,Stars,78,81,36,45
23,Mike Modano,Stars,80,83,35,48
23,Mike Modano,Stars,52,59,21,38
23,Mike Modano,Stars,77,81,34,47
23,Mike Modano,Stars,77,81,38,43
23,Mike Modano,Stars,81,84,33,51
23,Mike Modano,Stars,78,77,34,43
23,Mike Modano,Stars,79,85,28,57
23,Mike Modano,Stars,76,44,14,30
23,Mike Modano,Stars,78,77,27,50
23,Mike Modano,Stars,59,43,22,21
23,Mike Modano,Stars,82,57,21,36
23,Mike Modano,Stars,80,46,15,31
23,Mike Modano,Stars,59,30,14,16
23,Mike Modano,Red Wings,40,15,4,11
24,Guy Lafleur,Canadiens,73,64,29,35
24,Guy Lafleur,Canadiens,69,55,28,27
24,Guy Lafleur,Canadiens,73,56,21,35
24,Guy Lafleur,Canadiens,70,119,53,66
24,Guy Lafleur,Canadiens,80,125,56,69
24,Guy Lafleur,Canadiens,80,136,56,80
24,Guy Lafleur,Canadiens,78,132,60,72
24,Guy Lafleur,Canadiens,80,129,52,77
24,Guy Lafleur,Canadiens,74,125,50,75
24,Guy Lafleur,Canadiens,51,70,27,43
24,Guy Lafleur,Canadiens,66,84,27,57
24,Guy Lafleur,Canadiens,68,76,27,49
24,Guy Lafleur,Canadiens,80,70,30,40
24,Guy Lafleur,Canadiens,19,5,2,3
24,Guy Lafleur,Rangers,67,45,18,27
24,Guy Lafleur,Nordiques,39,34,12,22
24,Guy Lafleur,Nordiques,59,28,12,16
25,John Bucyk,Red Wings,38,9,1,8
25,John Bucyk,Red Wings,66,21,10,11
25,John Bucyk,Bruins,68,52,21,31
25,John Bucyk,Bruins,69,60,24,36
25,John Bucyk,Bruins,56,52,16,36
25,John Bucyk,Bruins,70,39,19,20
25,John Bucyk,Bruins,67,60,20,40
25,John Bucyk,Bruins,69,66,27,39
25,John Bucyk,Bruins,62,54,18,36
25,John Bucyk,Bruins,68,55,26,29
25,John Bucyk,Bruins,63,57,27,30
25,John Bucyk,Bruins,59,48,18,30
25,John Bucyk,Bruins,72,69,30,39
25,John Bucyk,Bruins,70,66,24,42
25,John Bucyk,Bruins,76,69,31,38
25,John Bucyk,Bruins,78,116,51,65
25,John Bucyk,Bruins,78,83,32,51
25,John Bucyk,Bruins,78,93,40,53
25,John Bucyk,Bruins,76,75,31,44
25,John Bucyk,Bruins,78,81,29,52
25,John Bucyk,Bruins,77,83,36,47
25,John Bucyk,Bruins,49,43,20,23
25,John Bucyk,Bruins,53,18,5,13
26,Ron Francis,Whalers,59,68,25,43
26,Ron Francis,Whalers,79,90,31,59
26,Ron Francis,Whalers,72,83,23,60
26,Ron Francis,Whalers,80,81,24,57
26,Ron Francis,Whalers,53,77,24,53
26,Ron Francis,Whalers,75,93,30,63
26,Ron Francis,Whalers,80,75,25,50
26,Ron Francis,Whalers,69,77,29,48
26,Ron Francis,Whalers,80,101,32,69
26,Ron Francis,Whalers,67,76,21,55
26,Ron Francis,Penguins,14,11,2,9
26,Ron Francis,Penguins,70,54,21,33
26,Ron Francis,Penguins,84,100,24,76
26,Ron Francis,Penguins,82,93,27,66
26,Ron Francis,Penguins,44,59,11,48
26,Ron Francis,Penguins,77,119,27,92
26,Ron Francis,Penguins,81,90,27,63
26,Ron Francis,Penguins,81,87,25,62
26,Ron Francis,Hurricanes,82,52,21,31
26,Ron Francis,Hurricanes,78,73,23,50
26,Ron Francis,Hurricanes,82,65,15,50
26,Ron Francis,Hurricanes,80,77,27,50
26,Ron Francis,Hurricanes,82,57,22,35
26,Ron Francis,Hurricanes,68,30,10,20
26,Ron Francis,Maple Leafs,12,10,3,7
27,Michel Goulet,Nordiques,77,54,22,32
27,Michel Goulet,Nordiques,76,71,32,39
27,Michel Goulet,Nordiques,80,84,42,42
27,Michel Goulet,Nordiques,80,105,57,48
27,Michel Goulet,Nordiques,75,121,56,65
27,Michel Goulet,Nordiques,69,95,55,40
27,Michel Goulet,Nordiques,75,104,53,51
27,Michel Goulet,Nordiques,75,96,49,47
27,Michel Goulet,Nordiques,80,106,48,58
27,Michel Goulet,Nordiques,69,64,26,38
27,Michel Goulet,Nordiques,57,45,16,29
27,Michel Goulet,Blackhawks,8,5,4,1
27,Michel Goulet,Blackhawks,74,65,27,38
27,Michel Goulet,Blackhawks,75,63,22,41
27,Michel Goulet,Blackhawks,63,44,23,21
27,Michel Goulet,Blackhawks,56,30,16,14
28,Maurice Richard,Canadiens,16,11,5,6
28,Maurice Richard,Canadiens,46,54,32,22
28,Maurice Richard,Canadiens,50,73,50,23
28,Maurice Richard,Canadiens,50,48,27,21
28,Maurice Richard,Canadiens,60,71,45,26
28,Maurice Richard,Canadiens,53,53,28,25
28,Maurice Richard,Canadiens,59,38,20,18
28,Maurice Richard,Canadiens,70,65,43,22
28,Maurice Richard,Canadiens,65,66,42,24
28,Maurice Richard,Canadiens,48,44,27,17
28,Maurice Richard,Canadiens,70,61,28,33
28,Maurice Richard,Canadiens,70,67,37,30
28,Maurice Richard,Canadiens,67,74,38,36
28,Maurice Richard,Canadiens,70,71,38,33
28,Maurice Richard,Canadiens,63,62,33,29
28,Maurice Richard,Canadiens,28,34,15,19
28,Maurice Richard,Canadiens,42,38,17,21
28,Maurice Richard,Canadiens,51,35,19,16
29,Stan Mikita,Blackhawks,3,1,0,1
29,Stan Mikita,Blackhawks,67,26,8,18
29,Stan Mikita,Blackhawks,66,53,19,34
29,Stan Mikita,Blackhawks,70,77,25,52
29,Stan Mikita,Blackhawks,65,76,31,45
29,Stan Mikita,Blackhawks,70,89,39,50
29,Stan Mikita,Blackhawks,70,87,28,59
29,Stan Mikita,Blackhawks,68,78,30,48
29,Stan Mikita,Blackhawks,70,97,35,62
29,Stan Mikita,Blackhawks,72,87,40,47
29,Stan Mikita,Blackhawks,74,97,30,67
29,Stan Mikita,Blackhawks,76,86,39,47
29,Stan Mikita,Blackhawks,74,72,24,48
29,Stan Mikita,Blackhawks,74,65,26,39
29,Stan Mikita,Blackhawks,57,83,27,56
29,Stan Mikita,Blackhawks,76,80,30,50
29,Stan Mikita,Blackhawks,79,86,36,50
29,Stan Mikita,Blackhawks,48,57,16,41
29,Stan Mikita,Blackhawks,57,49,19,30
29,Stan Mikita,Blackhawks,76,59,18,41
29,Stan Mikita,Blackhawks,65,55,19,36
29,Stan Mikita,Blackhawks,17,7,2,5
30,Keith Tkachuk,Jets (1979),17,8,3,5
30,Keith Tkachuk,Jets (1979),83,51,28,23
30,Keith Tkachuk,Jets (1979),84,81,41,40
30,Keith Tkachuk,Jets (1979),48,51,22,29
30,Keith Tkachuk,Jets (1979),76,98,50,48
30,Keith Tkachuk,Coyotes,81,86,52,34
30,Keith Tkachuk,Coyotes,69,66,40,26
30,Keith Tkachuk,Coyotes,68,68,36,32
30,Keith Tkachuk,Coyotes,50,43,22,21
30,Keith Tkachuk,Coyotes,64,71,29,42
30,Keith Tkachuk,Blues,12,8,6,2
30,Keith Tkachuk,Blues,73,75,38,37
30,Keith Tkachuk,Blues,56,55,31,24
30,Keith Tkachuk,Blues,75,71,33,38
30,Keith Tkachuk,Blues,41,36,15,21
30,Keith Tkachuk,Blues,61,43,20,23
30,Keith Tkachuk,Thrashers,18,15,7,8
30,Keith Tkachuk,Blues,79,58,27,31
30,Keith Tkachuk,Blues,79,49,25,24
30,Keith Tkachuk,Blues,67,32,13,19
31,Francis Mahovlich,Maple Leafs,3,1,1,0
31,Francis Mahovlich,Maple Leafs,67,36,20,16
31,Francis Mahovlich,Maple Leafs,63,49,22,27
31,Francis Mahovlich,Maple Leafs,70,39,18,21
31,Francis Mahovlich,Maple Leafs,70,84,48,36
31,Francis Mahovlich,Maple Leafs,70,71,33,38
31,Francis Mahovlich,Maple Leafs,67,73,36,37
31,Francis Mahovlich,Maple Leafs,70,55,26,29
31,Francis Mahovlich,Maple Leafs,59,51,23,28
31,Francis Mahovlich,Maple Leafs,68,56,32,24
31,Francis Mahovlich,Maple Leafs,63,46,18,28
31,Francis Mahovlich,Maple Leafs,50,36,19,17
31,Francis Mahovlich,Red Wings,13,16,7,9
31,Francis Mahovlich,Red Wings,76,78,49,29
31,Francis Mahovlich,Red Wings,74,70,38,32
31,Francis Mahovlich,Red Wings,35,32,14,18
31,Francis Mahovlich,Canadiens,38,41,17,24
31,Francis Mahovlich,Canadiens,76,96,43,53
31,Francis Mahovlich,Canadiens,78,93,38,55
31,Francis Mahovlich,Canadiens,71,80,31,49
32,Bryan Trottier,Islanders,80,95,32,63
32,Bryan Trottier,Islanders,76,72,30,42
32,Bryan Trottier,Islanders,77,123,46,77
32,Bryan Trottier,Islanders,76,134,47,87
32,Bryan Trottier,Islanders,78,104,42,62
32,Bryan Trottier,Islanders,73,103,31,72
32,Bryan Trottier,Islanders,80,129,50,79
32,Bryan Trottier,Islanders,80,89,34,55
32,Bryan Trottier,Islanders,68,111,40,71
32,Bryan Trottier,Islanders,68,59,28,31
32,Bryan Trottier,Islanders,78,96,37,59
32,Bryan Trottier,Islanders,80,87,23,64
32,Bryan Trottier,Islanders,77,82,30,52
32,Bryan Trottier,Islanders,73,45,17,28
32,Bryan Trottier,Islanders,59,24,13,11
32,Bryan Trottier,Penguins,52,28,9,19
32,Bryan Trottier,Penguins,63,29,11,18
32,Bryan Trottier,Penguins,41,15,4,11
33,Pat Verbeek,Devils,6,5,3,2
33,Pat Verbeek,Devils,79,47,20,27
33,Pat Verbeek,Devils,78,33,15,18
33,Pat Verbeek,Devils,76,53,25,28
33,Pat Verbeek,Devils,74,59,35,24
33,Pat Verbeek,Devils,73,77,46,31
33,Pat Verbeek,Devils,77,47,26,21
33,Pat Verbeek,Whalers,80,89,44,45
33,Pat Verbeek,Whalers,80,82,43,39
33,Pat Verbeek,Whalers,76,57,22,35
33,Pat Verbeek,Whalers,84,82,39,43
33,Pat Verbeek,Whalers,84,75,37,38
33,Pat Verbeek,Whalers,29,18,7,11
33,Pat Verbeek,Rangers,19,15,10,5
33,Pat Verbeek,Rangers,69,82,41,41
33,Pat Verbeek,Stars,81,53,17,36
33,Pat Verbeek,Stars,82,57,31,26
33,Pat Verbeek,Stars,78,34,17,17
33,Pat Verbeek,Red Wings,68,48,22,26
33,Pat Verbeek,Red Wings,67,30,15,15
33,Pat Verbeek,Stars,64,20,7,13
34,Dale Hawerchuk,Jets (1979),80,103,45,58
34,Dale Hawerchuk,Jets (1979),79,91,40,51
34,Dale Hawerchuk,Jets (1979),80,102,37,65
34,Dale Hawerchuk,Jets (1979),80,130,53,77
34,Dale Hawerchuk,Jets (1979),80,105,46,59
34,Dale Hawerchuk,Jets (1979),80,100,47,53
34,Dale Hawerchuk,Jets (1979),80,121,44,77
34,Dale Hawerchuk,Jets (1979),75,96,41,55
34,Dale Hawerchuk,Jets (1979),79,81,26,55
34,Dale Hawerchuk,Sabres,80,89,31,58
34,Dale Hawerchuk,Sabres,77,98,23,75
34,Dale Hawerchuk,Sabres,81,96,16,80
34,Dale Hawerchuk,Sabres,81,86,35,51
34,Dale Hawerchuk,Sabres,23,16,5,11
34,Dale Hawerchuk,Blues,66,41,13,28
34,Dale Hawerchuk,Flyers,16,20,4,16
34,Dale Hawerchuk,Flyers,51,34,12,22
35,Pierre Turgeon,Sabres,76,42,14,28
35,Pierre Turgeon,Sabres,80,88,34,54
35,Pierre Turgeon,Sabres,80,106,40,66
35,Pierre Turgeon,Sabres,78,79,32,47
35,Pierre Turgeon,Sabres,8,8,2,6
35,Pierre Turgeon,Islanders,69,87,38,49
35,Pierre Turgeon,Islanders,83,132,58,74
35,Pierre Turgeon,Islanders,69,94,38,56
35,Pierre Turgeon,Islanders,34,27,13,14
35,Pierre Turgeon,Canadiens,15,20,11,9
35,Pierre Turgeon,Canadiens,80,96,38,58
35,Pierre Turgeon,Canadiens,9,11,1,10
35,Pierre Turgeon,Blues,69,74,25,49
35,Pierre Turgeon,Blues,60,68,22,46
35,Pierre Turgeon,Blues,67,65,31,34
35,Pierre Turgeon,Blues,52,66,26,40
35,Pierre Turgeon,Blues,79,82,30,52
35,Pierre Turgeon,Stars,66,47,15,32
35,Pierre Turgeon,Stars,65,42,12,30
35,Pierre Turgeon,Stars,76,40,15,25
35,Pierre Turgeon,Avalanche,62,46,16,30
35,Pierre Turgeon,Avalanche,17,7,4,3
36,Jeremy Roenick,Blackhawks,20,18,9,9
36,Jeremy Roenick,Blackhawks,78,66,26,40
36,Jeremy Roenick,Blackhawks,79,94,41,53
36,Jeremy Roenick,Blackhawks,80,103,53,50
36,Jeremy Roenick,Blackhawks,84,107,50,57
36,Jeremy Roenick,Blackhawks,84,107,46,61
36,Jeremy Roenick,Blackhawks,33,34,10,24
36,Jeremy Roenick,Blackhawks,66,67,32,35
36,Jeremy Roenick,Coyotes,72,69,29,40
36,Jeremy Roenick,Coyotes,79,56,24,32
36,Jeremy Roenick,Coyotes,78,72,24,48
36,Jeremy Roenick,Coyotes,75,78,34,44
36,Jeremy Roenick,Coyotes,80,76,30,46
36,Jeremy Roenick,Flyers,75,67,21,46
36,Jeremy Roenick,Flyers,79,59,27,32
36,Jeremy Roenick,Flyers,62,47,19,28
36,Jeremy Roenick,Kings,58,22,9,13
36,Jeremy Roenick,Coyotes,70,28,11,17
36,Jeremy Roenick,Sharks,69,33,14,19
36,Jeremy Roenick,Sharks,42,13,4,9
37,Gilbert Perreault,Sabres,78,72,38,34
37,Gilbert Perreault,Sabres,76,74,26,48
37,Gilbert Perreault,Sabres,78,88,28,60
37,Gilbert Perreault,Sabres,55,51,18,33
37,Gilbert Perreault,Sabres,68,96,39,57
37,Gilbert Perreault,Sabres,80,113,44,69
37,Gilbert Perreault,Sabres,80,95,39,56
37,Gilbert Perreault,Sabres,79,89,41,48
37,Gilbert Perreault,Sabres,79,85,27,58
37,Gilbert Perreault,Sabres,80,106,40,66
37,Gilbert Perreault,Sabres,56,59,20,39
37,Gilbert Perreault,Sabres,62,73,31,42
37,Gilbert Perreault,Sabres,77,76,30,46
37,Gilbert Perreault,Sabres,73,90,31,59
37,Gilbert Perreault,Sabres,78,83,30,53
37,Gilbert Perreault,Sabres,72,60,21,39
37,Gilbert Perreault,Sabres,20,16,9,7
38,Jean Beliveau,Canadiens,2,2,1,1
38,Jean Beliveau,Canadiens,3,5,5,0
38,Jean Beliveau,Canadiens,44,34,13,21
38,Jean Beliveau,Canadiens,70,73,37,36
38,Jean Beliveau,Canadiens,70,88,47,41
38,Jean Beliveau,Canadiens,69,84,33,51
38,Jean Beliveau,Canadiens,55,59,27,32
38,Jean Beliveau,Canadiens,64,91,45,46
38,Jean Beliveau,Canadiens,60,74,34,40
38,Jean Beliveau,Canadiens,69,90,32,58
38,Jean Beliveau,Canadiens,43,41,18,23
38,Jean Beliveau,Canadiens,69,67,18,49
38,Jean Beliveau,Canadiens,68,78,28,50
38,Jean Beliveau,Canadiens,58,43,20,23
38,Jean Beliveau,Canadiens,67,77,29,48
38,Jean Beliveau,Canadiens,53,38,12,26
38,Jean Beliveau,Canadiens,59,68,31,37
38,Jean Beliveau,Canadiens,69,82,33,49
38,Jean Beliveau,Canadiens,63,49,19,30
38,Jean Beliveau,Canadiens,70,76,25,51
39,Peter Bondra,Capitals,54,28,12,16
39,Peter Bondra,Capitals,71,56,28,28
39,Peter Bondra,Capitals,83,85,37,48
39,Peter Bondra,Capitals,69,43,24,19
39,Peter Bondra,Capitals,47,43,34,9
39,Peter Bondra,Capitals,67,80,52,28
39,Peter Bondra,Capitals,77,77,46,31
39,Peter Bondra,Capitals,76,78,52,26
39,Peter Bondra,Capitals,66,55,31,24
39,Peter Bondra,Capitals,62,38,21,17
39,Peter Bondra,Capitals,82,81,45,36
39,Peter Bondra,Capitals,77,70,39,31
39,Peter Bondra,Capitals,76,56,30,26
39,Peter Bondra,Capitals,54,35,21,14
39,Peter Bondra,Senators,23,14,5,9
39,Peter Bondra,Thrashers,60,39,21,18
39,Peter Bondra,Blackhawks,37,14,5,9
40,Joe Mullen,Blues,45,59,25,34
40,Joe Mullen,Blues,49,47,17,30
40,Joe Mullen,Blues,80,85,41,44
40,Joe Mullen,Blues,79,92,40,52
40,Joe Mullen,Blues,48,52,28,24
40,Joe Mullen,Flames,29,38,16,22
40,Joe Mullen,Flames,79,87,47,40
40,Joe Mullen,Flames,80,84,40,44
40,Joe Mullen,Flames,79,110,51,59
40,Joe Mullen,Flames,78,69,36,33
40,Joe Mullen,Penguins,47,39,17,22
40,Joe Mullen,Penguins,77,87,42,45
40,Joe Mullen,Penguins,72,70,33,37
40,Joe Mullen,Penguins,84,70,38,32
40,Joe Mullen,Penguins,45,37,16,21
40,Joe Mullen,Bruins,37,15,8,7
40,Joe Mullen,Penguins,54,22,7,15
41,Lanny McDonald,Maple Leafs,70,30,14,16
41,Lanny McDonald,Maple Leafs,64,44,17,27
41,Lanny McDonald,Maple Leafs,75,93,37,56
41,Lanny McDonald,Maple Leafs,80,90,46,44
41,Lanny McDonald,Maple Leafs,74,87,47,40
41,Lanny McDonald,Maple Leafs,79,85,43,42
41,Lanny McDonald,Maple Leafs,35,30,15,15
41,Lanny McDonald,Rockies,46,45,25,20
41,Lanny McDonald,Rockies,80,81,35,46
41,Lanny McDonald,Rockies,16,15,6,9
41,Lanny McDonald,Flames,55,67,34,33
41,Lanny McDonald,Flames,80,98,66,32
41,Lanny McDonald,Flames,65,66,33,33
41,Lanny McDonald,Flames,43,37,19,18
41,Lanny McDonald,Flames,80,71,28,43
41,Lanny McDonald,Flames,58,26,14,12
41,Lanny McDonald,Flames,60,23,10,13
41,Lanny McDonald,Flames,51,18,11,7
42,Glenn Anderson,Oilers,58,53,30,23
42,Glenn Anderson,Oilers,80,105,38,67
42,Glenn Anderson,Oilers,72,104,48,56
42,Glenn Anderson,Oilers,80,99,54,45
42,Glenn Anderson,Oilers,80,81,42,39
42,Glenn Anderson,Oilers,72,102,54,48
42,Glenn Anderson,Oilers,80,73,35,38
42,Glenn Anderson,Oilers,80,88,38,50
42,Glenn Anderson,Oilers,79,64,16,48
42,Glenn Anderson,Oilers,73,72,34,38
42,Glenn Anderson,Oilers,74,55,24,31
42,Glenn Anderson,Maple Leafs,72,57,24,33
42,Glenn Anderson,Maple Leafs,76,65,22,43
42,Glenn Anderson,Maple Leafs,73,35,17,18
42,Glenn Anderson,Rangers,12,6,4,2
42,Glenn Anderson,Blues,36,26,12,14
42,Glenn Anderson,Oilers,17,10,4,6
42,Glenn Anderson,Blues,15,4,2,2
43,Jean Ratelle,Rangers,3,3,2,1
43,Jean Ratelle,Rangers,31,12,4,8
43,Jean Ratelle,Rangers,48,20,11,9
43,Jean Ratelle,Rangers,15,7,0,7
43,Jean Ratelle,Rangers,54,35,14,21
43,Jean Ratelle,Rangers,67,51,21,30
43,Jean Ratelle,Rangers,41,11,6,5
43,Jean Ratelle,Rangers,74,78,32,46
43,Jean Ratelle,Rangers,75,78,32,46
43,Jean Ratelle,Rangers,75,74,32,42
43,Jean Ratelle,Rangers,78,72,26,46
43,Jean Ratelle,Rangers,63,109,46,63
43,Jean Ratelle,Rangers,78,94,41,53
43,Jean Ratelle,Rangers,68,67,28,39
43,Jean Ratelle,Rangers,79,91,36,55
43,Jean Ratelle,Rangers,13,15,5,10
43,Jean Ratelle,Bruins,67,90,31,59
43,Jean Ratelle,Bruins,78,94,33,61
43,Jean Ratelle,Bruins,80,84,25,59
43,Jean Ratelle,Bruins,80,72,27,45
43,Jean Ratelle,Bruins,67,73,28,45
43,Jean Ratelle,Bruins,47,37,11,26
44,Norm Ullman,Red Wings,66,18,9,9
44,Norm Ullman,Red Wings,64,52,16,36
44,Norm Ullman,Red Wings,69,51,23,28
44,Norm Ullman,Red Wings,69,58,22,36
44,Norm Ullman,Red Wings,70,58,24,34
44,Norm Ullman,Red Wings,70,70,28,42
44,Norm Ullman,Red Wings,70,64,26,38
44,Norm Ullman,Red Wings,70,56,26,30
44,Norm Ullman,Red Wings,61,51,21,30
44,Norm Ullman,Red Wings,70,83,42,41
44,Norm Ullman,Red Wings,70,72,31,41
44,Norm Ullman,Red Wings,68,70,26,44
44,Norm Ullman,Red Wings,58,55,30,25
44,Norm Ullman,Maple Leafs,13,17,5,12
44,Norm Ullman,Maple Leafs,75,77,35,42
44,Norm Ullman,Maple Leafs,74,60,18,42
44,Norm Ullman,Maple Leafs,73,85,34,51
44,Norm Ullman,Maple Leafs,77,73,23,50
44,Norm Ullman,Maple Leafs,65,55,20,35
44,Norm Ullman,Maple Leafs,78,69,22,47
44,Norm Ullman,Maple Leafs,80,35,9,26
45,Brian Bellows,North Stars,78,65,35,30
45,Brian Bellows,North Stars,78,83,41,42
45,Brian Bellows,North Stars,78,62,26,36
45,Brian Bellows,North Stars,77,79,31,48
45,Brian Bellows,North Stars,65,53,26,27
45,Brian Bellows,North Stars,77,81,40,41
45,Brian Bellows,North Stars,60,50,23,27
45,Brian Bellows,North Stars,80,99,55,44
45,Brian Bellows,North Stars,80,75,35,40
45,Brian Bellows,North Stars,80,75,30,45
45,Brian Bellows,Canadiens,82,88,40,48
45,Brian Bellows,Canadiens,77,71,33,38
45,Brian Bellows,Canadiens,41,16,8,8
45,Brian Bellows,Lightning,79,49,23,26
45,Brian Bellows,Lightning,7,3,1,2
45,Brian Bellows,Ducks,62,28,15,13
45,Brian Bellows,Capitals,11,9,6,3
45,Brian Bellows,Capitals,76,36,17,19
46,Darryl Sittler,Maple Leafs,49,18,10,8
46,Darryl Sittler,Maple Leafs,74,32,15,17
46,Darryl Sittler,Maple Leafs,78,77,29,48
46,Darryl Sittler,Maple Leafs,78,84,38,46
46,Darryl Sittler,Maple Leafs,72,80,36,44
46,Darryl Sittler,Maple Leafs,79,100,41,59
46,Darryl Sittler,Maple Leafs,73,90,38,52
46,Darryl Sittler,Maple Leafs,80,117,45,72
46,Darryl Sittler,Maple Leafs,70,87,36,51
46,Darryl Sittler,Maple Leafs,73,97,40,57
46,Darryl Sittler,Maple Leafs,80,96,43,53
46,Darryl Sittler,Maple Leafs,38,38,18,20
46,Darryl Sittler,Flyers,35,32,14,18
46,Darryl Sittler,Flyers,80,83,43,40
46,Darryl Sittler,Flyers,76,63,27,36
46,Darryl Sittler,Red Wings,61,27,11,16
47,Sergei Fedorov,Red Wings,77,79,31,48
47,Sergei Fedorov,Red Wings,80,86,32,54
47,Sergei Fedorov,Red Wings,73,87,34,53
47,Sergei Fedorov,Red Wings,82,120,56,64
47,Sergei Fedorov,Red Wings,42,50,20,30
47,Sergei Fedorov,Red Wings,78,107,39,68
47,Sergei Fedorov,Red Wings,74,63,30,33
47,Sergei Fedorov,Red Wings,21,17,6,11
47,Sergei Fedorov,Red Wings,77,63,26,37
47,Sergei Fedorov,Red Wings,68,62,27,35
47,Sergei Fedorov,Red Wings,75,69,32,37
47,Sergei Fedorov,Red Wings,81,68,31,37
47,Sergei Fedorov,Red Wings,80,83,36,47
47,Sergei Fedorov,Ducks,80,65,31,34
47,Sergei Fedorov,Ducks,5,1,0,1
47,Sergei Fedorov,Blue Jackets,62,43,12,31
47,Sergei Fedorov,Blue Jackets,73,42,18,24
47,Sergei Fedorov,Blue Jackets,50,28,9,19
47,Sergei Fedorov,Capitals,18,13,2,11
47,Sergei Fedorov,Capitals,52,33,11,22
48,Bernie Nicholls,Kings,22,32,14,18
48,Bernie Nicholls,Kings,71,50,28,22
48,Bernie Nicholls,Kings,78,95,41,54
48,Bernie Nicholls,Kings,80,100,46,54
48,Bernie Nicholls,Kings,80,97,36,61
48,Bernie Nicholls,Kings,80,81,33,48
48,Bernie Nicholls,Kings,65,78,32,46
48,Bernie Nicholls,Kings,79,150,70,80
48,Bernie Nicholls,Kings,47,75,27,48
48,Bernie Nicholls,Rangers,32,37,12,25
48,Bernie Nicholls,Rangers,71,73,25,48
48,Bernie Nicholls,Rangers,1,0,0,0
48,Bernie Nicholls,Oilers,49,49,20,29
48,Bernie Nicholls,Oilers,46,40,8,32
48,Bernie Nicholls,Devils,23,20,5,15
48,Bernie Nicholls,Devils,61,46,19,27
48,Bernie Nicholls,Blackhawks,48,51,22,29
48,Bernie Nicholls,Blackhawks,59,60,19,41
48,Bernie Nicholls,Sharks,65,45,12,33
48,Bernie Nicholls,Sharks,60,28,6,22
48,Bernie Nicholls,Sharks,10,2,0,2
49,Denis Savard,Blackhawks,76,75,28,47
49,Denis Savard,Blackhawks,80,119,32,87
49,Denis Savard,Blackhawks,78,121,35,86
49,Denis Savard,Blackhawks,75,94,37,57
49,Denis Savard,Blackhawks,79,105,38,67
49,Denis Savard,Blackhawks,80,116,47,69
49,Denis Savard,Blackhawks,70,90,40,50
49,Denis Savard,Blackhawks,80,131,44,87
49,Denis Savard,Blackhawks,58,82,23,59
49,Denis Savard,Blackhawks,60,80,27,53
49,Denis Savard,Canadiens,70,59,28,31
49,Denis Savard,Canadiens,77,70,28,42
49,Denis Savard,Canadiens,63,50,16,34
49,Denis Savard,Lightning,74,46,18,28
49,Denis Savard,Lightning,31,17,6,11
49,Denis Savard,Blackhawks,12,8,4,4
49,Denis Savard,Blackhawks,69,48,13,35
49,Denis Savard,Blackhawks,64,27,9,18
50,Alexander Mogilny,Sabres,65,43,15,28
50,Alexander Mogilny,Sabres,62,64,30,34
50,Alexander Mogilny,Sabres,67,84,39,45
50,Alexander Mogilny,Sabres,77,127,76,51
50,Alexander Mogilny,Sabres,66,79,32,47
50,Alexander Mogilny,Sabres,44,47,19,28
50,Alexander Mogilny,Canucks,79,107,55,52
50,Alexander Mogilny,Canucks,76,73,31,42
50,Alexander Mogilny,Canucks,51,45,18,27
50,Alexander Mogilny,Canucks,59,45,14,31
50,Alexander Mogilny,Canucks,47,38,21,17
50,Alexander Mogilny,Devils,12,6,3,3
50,Alexander Mogilny,Devils,75,83,43,40
50,Alexander Mogilny,Maple Leafs,66,57,24,33
50,Alexander Mogilny,Maple Leafs,73,79,33,46
50,Alexander Mogilny,Maple Leafs,37,30,8,22
50,Alexander Mogilny,Devils,34,25,12,13
51,Pat LaFontaine,Islanders,15,19,13,6
51,Pat LaFontaine,Islanders,67,54,19,35
51,Pat LaFontaine,Islanders,65,53,30,23
51,Pat LaFontaine,Islanders,80,70,38,32
51,Pat LaFontaine,Islanders,75,92,47,45
51,Pat LaFontaine,Islanders,79,88,45,43
51,Pat LaFontaine,Islanders,74,105,54,51
51,Pat LaFontaine,Islanders,75,85,41,44
51,Pat LaFontaine,Sabres,57,93,46,47
51,Pat LaFontaine,Sabres,84,148,53,95
51,Pat LaFontaine,Sabres,16,18,5,13
51,Pat LaFontaine,Sabres,22,27,12,15
51,Pat LaFontaine,Sabres,76,91,40,51
51,Pat LaFontaine,Sabres,13,8,2,6
51,Pat LaFontaine,Rangers,67,62,23,39
52,Marian Hossa,Senators,7,1,0,1
52,Marian Hossa,Senators,60,30,15,15
52,Marian Hossa,Senators,78,56,29,27
52,Marian Hossa,Senators,81,75,32,43
52,Marian Hossa,Senators,80,66,31,35
52,Marian Hossa,Senators,80,80,45,35
52,Marian Hossa,Senators,81,82,36,46
52,Marian Hossa,Thrashers,80,92,39,53
52,Marian Hossa,Thrashers,82,100,43,57
52,Marian Hossa,Thrashers,60,56,26,30
52,Marian Hossa,Penguins,12,10,3,7
52,Marian Hossa,Red Wings,74,71,40,31
52,Marian Hossa,Blackhawks,57,51,24,27
52,Marian Hossa,Blackhawks,65,57,25,32
52,Marian Hossa,Blackhawks,81,77,29,48
52,Marian Hossa,Blackhawks,40,31,17,14
52,Marian Hossa,Blackhawks,72,60,30,30
52,Marian Hossa,Blackhawks,23,16,3,13
53,Alex Delvecchio,Red Wings,1,0,0,0
53,Alex Delvecchio,Red Wings,65,37,15,22
53,Alex Delvecchio,Red Wings,70,59,16,43
53,Alex Delvecchio,Red Wings,69,29,11,18
53,Alex Delvecchio,Red Wings,69,48,17,31
53,Alex Delvecchio,Red Wings,70,51,25,26
53,Alex Delvecchio,Red Wings,48,41,16,25
53,Alex Delvecchio,Red Wings,70,59,21,38
53,Alex Delvecchio,Red Wings,70,54,19,35
53,Alex Delvecchio,Red Wings,70,47,19,28
53,Alex Delvecchio,Red Wings,70,62,27,35
53,Alex Delvecchio,Red Wings,70,69,26,43
53,Alex Delvecchio,Red Wings,70,64,20,44
53,Alex Delvecchio,Red Wings,70,53,23,30
53,Alex Delvecchio,Red Wings,68,67,25,42
53,Alex Delvecchio,Red Wings,70,69,31,38
53,Alex Delvecchio,Red Wings,70,55,17,38
53,Alex Delvecchio,Red Wings,74,70,22,48
53,Alex Delvecchio,Red Wings,72,83,25,58
53,Alex Delvecchio,Red Wings,73,68,21,47
53,Alex Delvecchio,Red Wings,77,55,21,34
53,Alex Delvecchio,Red Wings,75,65,20,45
53,Alex Delvecchio,Red Wings,77,71,18,53
53,Alex Delvecchio,Red Wings,11,5,1,4
54,Theo Fleury,Flames,36,34,14,20
54,Theo Fleury,Flames,80,66,31,35
54,Theo Fleury,Flames,79,104,51,53
54,Theo Fleury,Flames,80,73,33,40
54,Theo Fleury,Flames,83,100,34,66
54,Theo Fleury,Flames,83,85,40,45
54,Theo Fleury,Flames,47,58,29,29
54,Theo Fleury,Flames,80,96,46,50
54,Theo Fleury,Flames,81,67,29,38
54,Theo Fleury,Flames,82,78,27,51
54,Theo Fleury,Flames,60,69,30,39
54,Theo Fleury,Avalanche,15,24,10,14
54,Theo Fleury,Rangers,80,64,15,49
54,Theo Fleury,Rangers,62,74,30,44
54,Theo Fleury,Rangers,82,63,24,39
54,Theo Fleury,Blackhawks,54,33,12,21
55,Rod Brind'Amour,Blues,79,61,26,35
55,Rod Brind'Amour,Blues,78,49,17,32
55,Rod Brind'Amour,Flyers,80,77,33,44
55,Rod Brind'Amour,Flyers,81,86,37,49
55,Rod Brind'Amour,Flyers,84,97,35,62
55,Rod Brind'Amour,Flyers,48,39,12,27
55,Rod Brind'Amour,Flyers,82,87,26,61
55,Rod Brind'Amour,Flyers,82,59,27,32
55,Rod Brind'Amour,Flyers,82,74,36,38
55,Rod Brind'Amour,Flyers,82,74,24,50
55,Rod Brind'Amour,Flyers,12,8,5,3
55,Rod Brind'Amour,Hurricanes,33,14,4,10
55,Rod Brind'Amour,Hurricanes,79,56,20,36
55,Rod Brind'Amour,Hurricanes,81,55,23,32
55,Rod Brind'Amour,Hurricanes,48,37,14,23
55,Rod Brind'Amour,Hurricanes,78,38,12,26
55,Rod Brind'Amour,Hurricanes,78,70,31,39
55,Rod Brind'Amour,Hurricanes,78,82,26,56
55,Rod Brind'Amour,Hurricanes,59,51,19,32
55,Rod Brind'Amour,Hurricanes,80,51,16,35
55,Rod Brind'Amour,Hurricanes,80,19,9,10
56,Doug Gilmour,Blues,80,53,25,28
56,Doug Gilmour,Blues,78,57,21,36
56,Doug Gilmour,Blues,74,53,25,28
56,Doug Gilmour,Blues,80,105,42,63
56,Doug Gilmour,Blues,72,86,36,50
56,Doug Gilmour,Flames,72,85,26,59
56,Doug Gilmour,Flames,78,91,24,67
56,Doug Gilmour,Flames,78,81,20,61
56,Doug Gilmour,Flames,38,38,11,27
56,Doug Gilmour,Maple Leafs,40,49,15,34
56,Doug Gilmour,Maple Leafs,83,127,32,95
56,Doug Gilmour,Maple Leafs,83,111,27,84
56,Doug Gilmour,Maple Leafs,44,33,10,23
56,Doug Gilmour,Maple Leafs,81,72,32,40
56,Doug Gilmour,Maple Leafs,61,60,15,45
56,Doug Gilmour,Devils,20,22,7,15
56,Doug Gilmour,Devils,63,53,13,40
56,Doug Gilmour,Blackhawks,72,56,16,40
56,Doug Gilmour,Blackhawks,63,56,22,34
56,Doug Gilmour,Sabres,11,17,3,14
56,Doug Gilmour,Sabres,71,38,7,31
56,Doug Gilmour,Canadiens,70,41,10,31
56,Doug Gilmour,Canadiens,61,30,11,19
56,Doug Gilmour,Maple Leafs,1,0,0,0
57,Peter Stastny,Nordiques,77,109,39,70
57,Peter Stastny,Nordiques,80,139,46,93
57,Peter Stastny,Nordiques,75,124,47,77
57,Peter Stastny,Nordiques,80,119,46,73
57,Peter Stastny,Nordiques,75,100,32,68
57,Peter Stastny,Nordiques,76,122,41,81
57,Peter Stastny,Nordiques,64,77,24,53
57,Peter Stastny,Nordiques,76,111,46,65
57,Peter Stastny,Nordiques,72,85,35,50
57,Peter Stastny,Nordiques,62,62,24,38
57,Peter Stastny,Devils,12,11,5,6
57,Peter Stastny,Devils,77,60,18,42
57,Peter Stastny,Devils,66,62,24,38
57,Peter Stastny,Devils,62,40,17,23
57,Peter Stastny,Blues,17,16,5,11
57,Peter Stastny,Blues,6,2,1,1
58,Rick Middleton,Rangers,47,40,22,18
58,Rick Middleton,Rangers,77,50,24,26
58,Rick Middleton,Bruins,72,42,20,22
58,Rick Middleton,Bruins,79,60,25,35
58,Rick Middleton,Bruins,71,86,38,48
58,Rick Middleton,Bruins,80,92,40,52
58,Rick Middleton,Bruins,80,103,44,59
58,Rick Middleton,Bruins,75,94,51,43
58,Rick Middleton,Bruins,80,96,49,47
58,Rick Middleton,Bruins,80,105,47,58
58,Rick Middleton,Bruins,80,76,30,46
58,Rick Middleton,Bruins,49,44,14,30
58,Rick Middleton,Bruins,76,68,31,37
58,Rick Middleton,Bruins,59,32,13,19
59,Daniel Alfredsson,Senators,82,61,26,35
59,Daniel Alfredsson,Senators,76,71,24,47
59,Daniel Alfredsson,Senators,55,45,17,28
59,Daniel Alfredsson,Senators,58,33,11,22
59,Daniel Alfredsson,Senators,57,59,21,38
59,Daniel Alfredsson,Senators,68,70,24,46
59,Daniel Alfredsson,Senators,78,71,37,34
59,Daniel Alfredsson,Senators,78,78,27,51
59,Daniel Alfredsson,Senators,77,80,32,48
59,Daniel Alfredsson,Senators,77,103,43,60
59,Daniel Alfredsson,Senators,77,87,29,58
59,Daniel Alfredsson,Senators,70,89,40,49
59,Daniel Alfredsson,Senators,79,74,24,50
59,Daniel Alfredsson,Senators,70,71,20,51
59,Daniel Alfredsson,Senators,54,31,14,17
59,Daniel Alfredsson,Senators,75,59,27,32
59,Daniel Alfredsson,Senators,47,26,10,16
59,Daniel Alfredsson,Red Wings,68,49,18,31
60,Patrick Marleau,Sharks,74,32,13,19
60,Patrick Marleau,Sharks,81,45,21,24
60,Patrick Marleau,Sharks,81,40,17,23
60,Patrick Marleau,Sharks,81,52,25,27
60,Patrick Marleau,Sharks,79,44,21,23
60,Patrick Marleau,Sharks,82,57,28,29
60,Patrick Marleau,Sharks,80,57,28,29
60,Patrick Marleau,Sharks,82,86,34,52
60,Patrick Marleau,Sharks,77,78,32,46
60,Patrick Marleau,Sharks,78,48,19,29
60,Patrick Marleau,Sharks,76,71,38,33
60,Patrick Marleau,Sharks,82,83,44,39
60,Patrick Marleau,Sharks,82,73,37,36
60,Patrick Marleau,Sharks,82,64,30,34
60,Patrick Marleau,Sharks,48,31,17,14
60,Patrick Marleau,Sharks,82,70,33,37
60,Patrick Marleau,Sharks,24,18,6,12
61,Steve Larmer,Blackhawks,4,1,0,1
61,Steve Larmer,Blackhawks,3,0,0,0
61,Steve Larmer,Blackhawks,80,90,43,47
61,Steve Larmer,Blackhawks,80,75,35,40
61,Steve Larmer,Blackhawks,80,86,46,40
61,Steve Larmer,Blackhawks,80,76,31,45
61,Steve Larmer,Blackhawks,80,84,28,56
61,Steve Larmer,Blackhawks,80,89,41,48
61,Steve Larmer,Blackhawks,80,87,43,44
61,Steve Larmer,Blackhawks,80,90,31,59
61,Steve Larmer,Blackhawks,80,101,44,57
61,Steve Larmer,Blackhawks,80,74,29,45
61,Steve Larmer,Blackhawks,84,70,35,35
61,Steve Larmer,Rangers,68,60,21,39
61,Steve Larmer,Rangers,47,29,14,15
62,Richard Vaive,Canucks,47,21,13,8
62,Richard Vaive,Maple Leafs,22,16,9,7
62,Richard Vaive,Maple Leafs,75,62,33,29
62,Richard Vaive,Maple Leafs,77,89,54,35
62,Richard Vaive,Maple Leafs,78,79,51,28
62,Richard Vaive,Maple Leafs,76,93,52,41
62,Richard Vaive,Maple Leafs,72,68,35,33
62,Richard Vaive,Maple Leafs,61,64,33,31
62,Richard Vaive,Maple Leafs,73,66,32,34
62,Richard Vaive,Blackhawks,76,69,43,26
62,Richard Vaive,Blackhawks,30,25,12,13
62,Richard Vaive,Sabres,28,32,19,13
62,Richard Vaive,Sabres,70,48,29,19
62,Richard Vaive,Sabres,71,52,25,27
62,Richard Vaive,Sabres,20,4,1,3
63,Rick Tocchet,Flyers,75,39,14,25
63,Rick Tocchet,Flyers,69,35,14,21
63,Rick Tocchet,Flyers,69,49,21,28
63,Rick Tocchet,Flyers,65,64,31,33
63,Rick Tocchet,Flyers,66,81,45,36
63,Rick Tocchet,Flyers,75,96,37,59
63,Rick Tocchet,Flyers,70,71,40,31
63,Rick Tocchet,Flyers,42,29,13,16
63,Rick Tocchet,Penguins,19,30,14,16
63,Rick Tocchet,Penguins,80,109,48,61
63,Rick Tocchet,Penguins,51,40,14,26
63,Rick Tocchet,Kings,36,35,18,17
63,Rick Tocchet,Kings,44,36,13,23
63,Rick Tocchet,Bruins,27,24,16,8
63,Rick Tocchet,Bruins,40,30,16,14
63,Rick Tocchet,Capitals,13,10,5,5
63,Rick Tocchet,Coyotes,68,45,26,19
63,Rick Tocchet,Coyotes,81,56,26,30
63,Rick Tocchet,Coyotes,64,29,12,17
63,Rick Tocchet,Flyers,16,6,3,3
63,Rick Tocchet,Flyers,60,36,14,22
63,Rick Tocchet,Flyers,14,2,0,2
64,Gary Roberts,Flames,32,15,5,10
64,Gary Roberts,Flames,74,28,13,15
64,Gary Roberts,Flames,71,38,22,16
64,Gary Roberts,Flames,78,72,39,33
64,Gary Roberts,Flames,80,53,22,31
64,Gary Roberts,Flames,76,90,53,37
64,Gary Roberts,Flames,58,79,38,41
64,Gary Roberts,Flames,73,84,41,43
64,Gary Roberts,Flames,8,4,2,2
64,Gary Roberts,Flames,35,42,22,20
64,Gary Roberts,Hurricanes,61,49,20,29
64,Gary Roberts,Hurricanes,77,42,14,28
64,Gary Roberts,Hurricanes,69,53,23,30
64,Gary Roberts,Maple Leafs,82,53,29,24
64,Gary Roberts,Maple Leafs,69,48,21,27
64,Gary Roberts,Maple Leafs,14,8,5,3
64,Gary Roberts,Maple Leafs,72,48,28,20
64,Gary Roberts,Panthers,58,40,14,26
64,Gary Roberts,Panthers,50,29,13,16
64,Gary Roberts,Penguins,19,13,7,6
64,Gary Roberts,Penguins,38,15,3,12
64,Gary Roberts,Lightning,30,7,4,3
65,Pavel Bure,Canucks,65,60,34,26
65,Pavel Bure,Canucks,83,110,60,50
65,Pavel Bure,Canucks,76,107,60,47
65,Pavel Bure,Canucks,44,43,20,23
65,Pavel Bure,Canucks,15,13,6,7
65,Pavel Bure,Canucks,63,55,23,32
65,Pavel Bure,Canucks,82,90,51,39
65,Pavel Bure,Panthers,11,16,13,3
65,Pavel Bure,Panthers,74,94,58,36
65,Pavel Bure,Panthers,82,92,59,33
65,Pavel Bure,Panthers,56,49,22,27
65,Pavel Bure,Rangers,12,20,12,8
65,Pavel Bure,Rangers,39,30,19,11
66,Alex Ovechkin,Capitals,81,106,52,54
66,Alex Ovechkin,Capitals,82,92,46,46
66,Alex Ovechkin,Capitals,82,112,65,47
66,Alex Ovechkin,Capitals,79,110,56,54
66,Alex Ovechkin,Capitals,72,109,50,59
66,Alex Ovechkin,Capitals,79,85,32,53
66,Alex Ovechkin,Capitals,78,65,38,27
66,Alex Ovechkin,Capitals,48,56,32,24
66,Alex Ovechkin,Capitals,78,79,51,28
66,Alex Ovechkin,Capitals,22,21,12,9
67,Vincent Damphousse,Maple Leafs,80,46,21,25
67,Vincent Damphousse,Maple Leafs,75,48,12,36
67,Vincent Damphousse,Maple Leafs,80,68,26,42
67,Vincent Damphousse,Maple Leafs,80,94,33,61
67,Vincent Damphousse,Maple Leafs,79,73,26,47
67,Vincent Damphousse,Oilers,80,89,38,51
67,Vincent Damphousse,Canadiens,84,97,39,58
67,Vincent Damphousse,Canadiens,84,91,40,51
67,Vincent Damphousse,Canadiens,48,40,10,30
67,Vincent Damphousse,Canadiens,80,94,38,56
67,Vincent Damphousse,Canadiens,82,81,27,54
67,Vincent Damphousse,Canadiens,76,59,18,41
67,Vincent Damphousse,Canadiens,65,36,12,24
67,Vincent Damphousse,Sharks,12,13,7,6
67,Vincent Damphousse,Sharks,82,70,21,49
67,Vincent Damphousse,Sharks,45,46,9,37
67,Vincent Damphousse,Sharks,82,58,20,38
67,Vincent Damphousse,Sharks,82,61,23,38
67,Vincent Damphousse,Sharks,82,41,12,29
68,Dave Taylor,Kings,64,43,22,21
68,Dave Taylor,Kings,78,91,43,48
68,Dave Taylor,Kings,61,90,37,53
68,Dave Taylor,Kings,72,112,47,65
68,Dave Taylor,Kings,78,106,39,67
68,Dave Taylor,Kings,46,58,21,37
68,Dave Taylor,Kings,63,69,20,49
68,Dave Taylor,Kings,79,92,41,51
68,Dave Taylor,Kings,76,71,33,38
68,Dave Taylor,Kings,67,62,18,44
68,Dave Taylor,Kings,68,67,26,41
68,Dave Taylor,Kings,70,63,26,37
68,Dave Taylor,Kings,58,41,15,26
68,Dave Taylor,Kings,73,53,23,30
68,Dave Taylor,Kings,77,29,10,19
68,Dave Taylor,Kings,48,15,6,9
68,Dave Taylor,Kings,33,7,4,3
69,Alex Kovalev,Rangers,65,38,20,18
69,Alex Kovalev,Rangers,76,56,23,33
69,Alex Kovalev,Rangers,48,28,13,15
69,Alex Kovalev,Rangers,81,58,24,34
69,Alex Kovalev,Rangers,45,35,13,22
69,Alex Kovalev,Rangers,73,53,23,30
69,Alex Kovalev,Rangers,14,7,3,4
69,Alex Kovalev,Penguins,63,46,20,26
69,Alex Kovalev,Penguins,82,66,26,40
69,Alex Kovalev,Penguins,79,95,44,51
69,Alex Kovalev,Penguins,67,76,32,44
69,Alex Kovalev,Penguins,54,64,27,37
69,Alex Kovalev,Rangers,24,13,10,3
69,Alex Kovalev,Rangers,66,42,13,29
69,Alex Kovalev,Canadiens,12,3,1,2
69,Alex Kovalev,Canadiens,69,65,23,42
69,Alex Kovalev,Canadiens,73,47,18,29
69,Alex Kovalev,Canadiens,82,84,35,49
69,Alex Kovalev,Canadiens,78,65,26,39
69,Alex Kovalev,Senators,77,49,18,31
69,Alex Kovalev,Senators,54,27,14,13
69,Alex Kovalev,Penguins,20,7,2,5
69,Alex Kovalev,Panthers,14,5,2,3
70,Bill Guerin,Devils,5,1,0,1
70,Bill Guerin,Devils,65,34,14,20
70,Bill Guerin,Devils,81,44,25,19
70,Bill Guerin,Devils,48,25,12,13
70,Bill Guerin,Devils,80,53,23,30
70,Bill Guerin,Devils,82,47,29,18
70,Bill Guerin,Devils,19,10,5,5
70,Bill Guerin,Oilers,40,29,13,16
70,Bill Guerin,Oilers,80,64,30,34
70,Bill Guerin,Oilers,70,46,24,22
70,Bill Guerin,Oilers,21,22,12,10
70,Bill Guerin,Bruins,64,63,28,35
70,Bill Guerin,Bruins,78,66,41,25
70,Bill Guerin,Stars,64,50,25,25
70,Bill Guerin,Stars,82,69,34,35
70,Bill Guerin,Stars,70,40,13,27
70,Bill Guerin,Blues,61,47,28,19
70,Bill Guerin,Sharks,16,9,8,1
70,Bill Guerin,Islanders,81,44,23,21
70,Bill Guerin,Islanders,61,36,16,20
70,Bill Guerin,Penguins,17,12,5,7
70,Bill Guerin,Penguins,78,45,21,24
71,Yvan Cournoyer,Canadiens,5,4,4,0
71,Yvan Cournoyer,Canadiens,55,17,7,10
71,Yvan Cournoyer,Canadiens,65,29,18,11
71,Yvan Cournoyer,Canadiens,69,40,25,15
71,Yvan Cournoyer,Canadiens,64,60,28,32
71,Yvan Cournoyer,Canadiens,76,87,43,44
71,Yvan Cournoyer,Canadiens,72,63,27,36
71,Yvan Cournoyer,Canadiens,65,73,37,36
71,Yvan Cournoyer,Canadiens,73,83,47,36
71,Yvan Cournoyer,Canadiens,67,79,40,39
71,Yvan Cournoyer,Canadiens,67,73,40,33
71,Yvan Cournoyer,Canadiens,76,74,29,45
71,Yvan Cournoyer,Canadiens,71,68,32,36
71,Yvan Cournoyer,Canadiens,60,53,25,28
71,Yvan Cournoyer,Canadiens,68,53,24,29
71,Yvan Cournoyer,Canadiens,15,7,2,5
72,Brian Propp,Flyers,80,75,34,41
72,Brian Propp,Flyers,79,66,26,40
72,Brian Propp,Flyers,80,91,44,47
72,Brian Propp,Flyers,80,82,40,42
72,Brian Propp,Flyers,79,92,39,53
72,Brian Propp,Flyers,76,97,43,54
72,Brian Propp,Flyers,72,97,40,57
72,Brian Propp,Flyers,53,67,31,36
72,Brian Propp,Flyers,74,76,27,49
72,Brian Propp,Flyers,77,78,32,46
72,Brian Propp,Flyers,40,28,13,15
72,Brian Propp,Bruins,14,12,3,9
72,Brian Propp,North Stars,79,73,26,47
72,Brian Propp,North Stars,51,35,12,23
72,Brian Propp,North Stars,17,6,3,3
72,Brian Propp,Whalers,65,29,12,17
73,Stephen Shutt,Canadiens,50,16,8,8
73,Stephen Shutt,Canadiens,70,35,15,20
73,Stephen Shutt,Canadiens,77,65,30,35
73,Stephen Shutt,Canadiens,80,79,45,34
73,Stephen Shutt,Canadiens,80,105,60,45
73,Stephen Shutt,Canadiens,80,86,49,37
73,Stephen Shutt,Canadiens,72,77,37,40
73,Stephen Shutt,Canadiens,77,89,47,42
73,Stephen Shutt,Canadiens,77,73,35,38
73,Stephen Shutt,Canadiens,57,55,31,24
73,Stephen Shutt,Canadiens,78,57,35,22
73,Stephen Shutt,Canadiens,63,37,14,23
73,Stephen Shutt,Canadiens,10,2,2,0
73,Stephen Shutt,Kings,59,41,16,25
74,Owen Nolan,Nordiques,59,13,3,10
74,Owen Nolan,Nordiques,75,73,42,31
74,Owen Nolan,Nordiques,73,77,36,41
74,Owen Nolan,Nordiques,6,4,2,2
74,Owen Nolan,Nordiques,46,49,30,19
74,Owen Nolan,Avalanche,9,8,4,4
74,Owen Nolan,Sharks,72,61,29,32
74,Owen Nolan,Sharks,72,63,31,32
74,Owen Nolan,Sharks,75,41,14,27
74,Owen Nolan,Sharks,78,45,19,26
74,Owen Nolan,Sharks,78,84,44,40
74,Owen Nolan,Sharks,57,49,24,25
74,Owen Nolan,Sharks,75,66,23,43
74,Owen Nolan,Sharks,61,42,22,20
74,Owen Nolan,Maple Leafs,14,12,7,5
74,Owen Nolan,Maple Leafs,65,48,19,29
74,Owen Nolan,Coyotes,76,40,16,24
74,Owen Nolan,Flames,77,32,16,16
74,Owen Nolan,Wild,59,45,25,20
74,Owen Nolan,Wild,73,33,16,17
75,Steve Thomas,Maple Leafs,18,2,1,1
75,Steve Thomas,Maple Leafs,65,57,20,37
75,Steve Thomas,Maple Leafs,78,62,35,27
75,Steve Thomas,Blackhawks,30,26,13,13
75,Steve Thomas,Blackhawks,45,40,21,19
75,Steve Thomas,Blackhawks,76,70,40,30
75,Steve Thomas,Blackhawks,69,54,19,35
75,Steve Thomas,Blackhawks,11,8,2,6
75,Steve Thomas,Islanders,71,70,28,42
75,Steve Thomas,Islanders,79,87,37,50
75,Steve Thomas,Islanders,78,75,42,33
75,Steve Thomas,Islanders,47,26,11,15
75,Steve Thomas,Devils,81,61,26,35
75,Steve Thomas,Devils,57,34,15,19
75,Steve Thomas,Devils,55,24,14,10
75,Steve Thomas,Maple Leafs,78,73,28,45
75,Steve Thomas,Maple Leafs,81,63,26,37
75,Steve Thomas,Maple Leafs,57,34,8,26
75,Steve Thomas,Blackhawks,34,15,11,4
75,Steve Thomas,Blackhawks,69,17,4,13
75,Steve Thomas,Ducks,12,13,10,3
75,Steve Thomas,Red Wings,44,22,10,12
76,Stephane Richer,Canadiens,1,0,0,0
76,Stephane Richer,Canadiens,65,37,21,16
76,Stephane Richer,Canadiens,57,39,20,19
76,Stephane Richer,Canadiens,72,78,50,28
76,Stephane Richer,Canadiens,68,60,25,35
76,Stephane Richer,Canadiens,75,91,51,40
76,Stephane Richer,Canadiens,75,61,31,30
76,Stephane Richer,Devils,74,64,29,35
76,Stephane Richer,Devils,78,73,38,35
76,Stephane Richer,Devils,80,72,36,36
76,Stephane Richer,Devils,45,39,23,16
76,Stephane Richer,Devils,73,32,20,12
76,Stephane Richer,Canadiens,63,46,22,24
76,Stephane Richer,Canadiens,14,9,5,4
76,Stephane Richer,Lightning,26,20,9,11
76,Stephane Richer,Lightning,64,33,12,21
76,Stephane Richer,Lightning,20,12,7,5
76,Stephane Richer,Blues,36,25,8,17
76,Stephane Richer,Penguins,58,25,13,12
76,Stephane Richer,Devils,10,3,1,2
77,Bill Barber,Flyers,69,64,30,34
77,Bill Barber,Flyers,75,69,34,35
77,Bill Barber,Flyers,79,71,34,37
77,Bill Barber,Flyers,80,112,50,62
77,Bill Barber,Flyers,73,55,20,35
77,Bill Barber,Flyers,80,72,41,31
77,Bill Barber,Flyers,79,80,34,46
77,Bill Barber,Flyers,79,72,40,32
77,Bill Barber,Flyers,80,85,43,42
77,Bill Barber,Flyers,80,89,45,44
77,Bill Barber,Flyers,66,60,27,33
77,Bill Barber,Flyers,63,54,22,32
78,Jason Arnott,Oilers,78,68,33,35
78,Jason Arnott,Oilers,42,37,15,22
78,Jason Arnott,Oilers,64,59,28,31
78,Jason Arnott,Oilers,67,57,19,38
78,Jason Arnott,Oilers,35,18,5,13
78,Jason Arnott,Devils,35,15,5,10
78,Jason Arnott,Devils,74,54,27,27
78,Jason Arnott,Devils,76,56,22,34
78,Jason Arnott,Devils,54,55,21,34
78,Jason Arnott,Devils,63,41,22,19
78,Jason Arnott,Stars,10,4,3,1
78,Jason Arnott,Stars,72,47,23,24
78,Jason Arnott,Stars,73,57,21,36
78,Jason Arnott,Stars,81,76,32,44
78,Jason Arnott,Predators,68,54,27,27
78,Jason Arnott,Predators,79,72,28,44
78,Jason Arnott,Predators,65,57,33,24
78,Jason Arnott,Predators,63,46,19,27
78,Jason Arnott,Devils,62,24,13,11
78,Jason Arnott,Capitals,11,7,4,3
78,Jason Arnott,Blues,72,34,17,17
79,Ilya Kovalchuk,Thrashers,65,51,29,22
79,Ilya Kovalchuk,Thrashers,81,67,38,29
79,Ilya Kovalchuk,Thrashers,81,87,41,46
79,Ilya Kovalchuk,Thrashers,78,98,52,46
79,Ilya Kovalchuk,Thrashers,82,76,42,34
79,Ilya Kovalchuk,Thrashers,79,87,52,35
79,Ilya Kovalchuk,Thrashers,79,91,43,48
79,Ilya Kovalchuk,Thrashers,49,58,31,27
79,Ilya Kovalchuk,Devils,27,27,10,17
79,Ilya Kovalchuk,Devils,81,60,31,29
79,Ilya Kovalchuk,Devils,77,83,37,46
79,Ilya Kovalchuk,Devils,37,31,11,20
80,Tony Amonte,Rangers,79,69,35,34
80,Tony Amonte,Rangers,83,76,33,43
80,Tony Amonte,Rangers,72,38,16,22
80,Tony Amonte,Blackhawks,7,4,1,3
80,Tony Amonte,Blackhawks,48,35,15,20
80,Tony Amonte,Blackhawks,81,63,31,32
80,Tony Amonte,Blackhawks,81,77,41,36
80,Tony Amonte,Blackhawks,82,73,31,42
80,Tony Amonte,Blackhawks,82,75,44,31
80,Tony Amonte,Blackhawks,82,84,43,41
80,Tony Amonte,Blackhawks,82,64,35,29
80,Tony Amonte,Blackhawks,82,66,27,39
80,Tony Amonte,Coyotes,59,36,13,23
80,Tony Amonte,Flyers,13,15,7,8
80,Tony Amonte,Flyers,80,53,20,33
80,Tony Amonte,Flames,80,42,14,28
80,Tony Amonte,Flames,81,30,10,20
81,John MacLean,Devils,23,1,1,0
81,John MacLean,Devils,61,33,13,20
81,John MacLean,Devils,74,57,21,36
81,John MacLean,Devils,80,67,31,36
81,John MacLean,Devils,76,39,23,16
81,John MacLean,Devils,74,87,42,45
81,John MacLean,Devils,80,79,41,38
81,John MacLean,Devils,78,78,45,33
81,John MacLean,Devils,80,48,24,24
81,John MacLean,Devils,80,70,37,33
81,John MacLean,Devils,46,29,17,12
81,John MacLean,Devils,76,48,20,28
81,John MacLean,Devils,80,54,29,25
81,John MacLean,Devils,26,11,3,8
81,John MacLean,Sharks,51,32,13,19
81,John MacLean,Rangers,82,55,28,27
81,John MacLean,Rangers,77,42,18,24
81,John MacLean,Rangers,2,0,0,0
81,John MacLean,Stars,28,6,4,2
81,John MacLean,Stars,20,6,3,3
82,Garry Unger,Maple Leafs,15,2,1,1
82,Garry Unger,Red Wings,13,15,5,10
82,Garry Unger,Red Wings,76,44,24,20
82,Garry Unger,Red Wings,76,66,42,24
82,Garry Unger,Red Wings,51,27,13,14
82,Garry Unger,Blues,28,29,15,14
82,Garry Unger,Blues,78,70,36,34
82,Garry Unger,Blues,78,80,41,39
82,Garry Unger,Blues,78,68,33,35
82,Garry Unger,Blues,80,80,36,44
82,Garry Unger,Blues,80,83,39,44
82,Garry Unger,Blues,80,57,30,27
82,Garry Unger,Blues,80,52,32,20
82,Garry Unger,Blues,80,56,30,26
82,Garry Unger,Flames,79,33,17,16
82,Garry Unger,Kings,58,20,10,10
82,Garry Unger,Oilers,13,0,0,0
82,Garry Unger,Oilers,46,20,7,13
82,Garry Unger,Oilers,16,2,2,0
83,Ray Bourque,Bruins,80,65,17,48
83,Ray Bourque,Bruins,67,56,27,29
83,Ray Bourque,Bruins,65,66,17,49
83,Ray Bourque,Bruins,65,73,22,51
83,Ray Bourque,Bruins,78,96,31,65
83,Ray Bourque,Bruins,73,86,20,66
83,Ray Bourque,Bruins,74,77,19,58
83,Ray Bourque,Bruins,78,95,23,72
83,Ray Bourque,Bruins,78,81,17,64
83,Ray Bourque,Bruins,60,61,18,43
83,Ray Bourque,Bruins,76,84,19,65
83,Ray Bourque,Bruins,76,94,21,73
83,Ray Bourque,Bruins,80,81,21,60
83,Ray Bourque,Bruins,78,82,19,63
83,Ray Bourque,Bruins,72,91,20,71
83,Ray Bourque,Bruins,46,43,12,31
83,Ray Bourque,Bruins,82,82,20,62
83,Ray Bourque,Bruins,62,50,19,31
83,Ray Bourque,Bruins,82,48,13,35
83,Ray Bourque,Bruins,81,57,10,47
83,Ray Bourque,Bruins,65,38,10,28
83,Ray Bourque,Avalanche,14,14,8,6
83,Ray Bourque,Avalanche,80,59,7,52
84,Ray Ferraro,Whalers,44,28,11,17
84,Ray Ferraro,Whalers,76,77,30,47
84,Ray Ferraro,Whalers,80,59,27,32
84,Ray Ferraro,Whalers,68,50,21,29
84,Ray Ferraro,Whalers,80,76,41,35
84,Ray Ferraro,Whalers,79,54,25,29
84,Ray Ferraro,Whalers,15,7,2,5
84,Ray Ferraro,Islanders,61,35,19,16
84,Ray Ferraro,Islanders,80,80,40,40
84,Ray Ferraro,Islanders,46,27,14,13
84,Ray Ferraro,Islanders,82,53,21,32
84,Ray Ferraro,Islanders,47,43,22,21
84,Ray Ferraro,Rangers,65,54,25,29
84,Ray Ferraro,Kings,11,6,4,2
84,Ray Ferraro,Kings,81,46,25,21
84,Ray Ferraro,Kings,40,15,6,9
84,Ray Ferraro,Kings,65,31,13,18
84,Ray Ferraro,Thrashers,81,44,19,25
84,Ray Ferraro,Thrashers,81,76,29,47
84,Ray Ferraro,Thrashers,61,27,8,19
84,Ray Ferraro,Blues,15,10,6,4
85,Rod Gilbert,Rangers,1,1,0,1
85,Rod Gilbert,Rangers,1,0,0,0
85,Rod Gilbert,Rangers,70,31,11,20
85,Rod Gilbert,Rangers,70,64,24,40
85,Rod Gilbert,Rangers,70,61,25,36
85,Rod Gilbert,Rangers,34,25,10,15
85,Rod Gilbert,Rangers,64,46,28,18
85,Rod Gilbert,Rangers,73,77,29,48
85,Rod Gilbert,Rangers,66,77,28,49
85,Rod Gilbert,Rangers,72,53,16,37
85,Rod Gilbert,Rangers,78,61,30,31
85,Rod Gilbert,Rangers,73,97,43,54
85,Rod Gilbert,Rangers,76,84,25,59
85,Rod Gilbert,Rangers,75,77,36,41
85,Rod Gilbert,Rangers,76,97,36,61
85,Rod Gilbert,Rangers,70,86,36,50
85,Rod Gilbert,Rangers,77,75,27,48
85,Rod Gilbert,Rangers,19,9,2,7
86,John LeClair,Canadiens,10,7,2,5
86,John LeClair,Canadiens,59,19,8,11
86,John LeClair,Canadiens,72,44,19,25
86,John LeClair,Canadiens,74,43,19,24
86,John LeClair,Canadiens,9,5,1,4
86,John LeClair,Flyers,37,49,25,24
86,John LeClair,Flyers,82,97,51,46
86,John LeClair,Flyers,82,97,50,47
86,John LeClair,Flyers,82,87,51,36
86,John LeClair,Flyers,76,90,43,47
86,John LeClair,Flyers,82,77,40,37
86,John LeClair,Flyers,16,12,7,5
86,John LeClair,Flyers,82,51,25,26
86,John LeClair,Flyers,35,28,18,10
86,John LeClair,Flyers,75,55,23,32
86,John LeClair,Penguins,73,51,22,29
86,John LeClair,Penguins,21,7,2,5
87,Vincent Lecavalier,Lightning,82,28,13,15
87,Vincent Lecavalier,Lightning,80,67,25,42
87,Vincent Lecavalier,Lightning,68,51,23,28
87,Vincent Lecavalier,Lightning,76,37,20,17
87,Vincent Lecavalier,Lightning,80,78,33,45
87,Vincent Lecavalier,Lightning,81,66,32,34
87,Vincent Lecavalier,Lightning,80,75,35,40
87,Vincent Lecavalier,Lightning,82,108,52,56
87,Vincent Lecavalier,Lightning,81,92,40,52
87,Vincent Lecavalier,Lightning,77,67,29,38
87,Vincent Lecavalier,Lightning,82,70,24,46
87,Vincent Lecavalier,Lightning,65,54,25,29
87,Vincent Lecavalier,Lightning,64,49,22,27
87,Vincent Lecavalier,Lightning,39,32,10,22
87,Vincent Lecavalier,Flyers,69,37,20,17
87,Vincent Lecavalier,Flyers,15,6,2,4
88,Paul Kariya,Ducks,47,39,18,21
88,Paul Kariya,Ducks,82,108,50,58
88,Paul Kariya,Ducks,69,99,44,55
88,Paul Kariya,Ducks,22,31,17,14
88,Paul Kariya,Ducks,82,101,39,62
88,Paul Kariya,Ducks,74,86,42,44
88,Paul Kariya,Ducks,66,67,33,34
88,Paul Kariya,Ducks,82,57,32,25
88,Paul Kariya,Ducks,82,81,25,56
88,Paul Kariya,Avalanche,51,36,11,25
88,Paul Kariya,Predators,82,85,31,54
88,Paul Kariya,Predators,82,76,24,52
88,Paul Kariya,Blues,82,65,16,49
88,Paul Kariya,Blues,11,15,2,13
88,Paul Kariya,Blues,75,43,18,25
89,John Ogrodnick,Red Wings,41,32,8,24
89,John Ogrodnick,Red Wings,80,70,35,35
89,John Ogrodnick,Red Wings,80,54,28,26
89,John Ogrodnick,Red Wings,80,85,41,44
89,John Ogrodnick,Red Wings,64,78,42,36
89,John Ogrodnick,Red Wings,79,105,55,50
89,John Ogrodnick,Red Wings,76,70,38,32
89,John Ogrodnick,Red Wings,39,40,12,28
89,John Ogrodnick,Nordiques,32,27,11,16
89,John Ogrodnick,Rangers,64,54,22,32
89,John Ogrodnick,Rangers,60,42,13,29
89,John Ogrodnick,Rangers,80,74,43,31
89,John Ogrodnick,Rangers,79,54,31,23
89,John Ogrodnick,Rangers,55,30,17,13
89,John Ogrodnick,Red Wings,19,12,6,6
90,Paul Coffey,Oilers,74,32,9,23
90,Paul Coffey,Oilers,80,89,29,60
90,Paul Coffey,Oilers,80,96,29,67
90,Paul Coffey,Oilers,80,126,40,86
90,Paul Coffey,Oilers,80,121,37,84
90,Paul Coffey,Oilers,79,138,48,90
90,Paul Coffey,Oilers,59,67,17,50
90,Paul Coffey,Penguins,46,67,15,52
90,Paul Coffey,Penguins,75,113,30,83
90,Paul Coffey,Penguins,80,103,29,74
90,Paul Coffey,Penguins,76,93,24,69
90,Paul Coffey,Penguins,54,64,10,54
90,Paul Coffey,Kings,10,5,1,4
90,Paul Coffey,Kings,50,57,8,49
90,Paul Coffey,Red Wings,30,30,4,26
90,Paul Coffey,Red Wings,80,77,14,63
90,Paul Coffey,Red Wings,45,58,14,44
90,Paul Coffey,Red Wings,76,74,14,60
90,Paul Coffey,Whalers,20,8,3,5
90,Paul Coffey,Flyers,37,26,6,20
90,Paul Coffey,Flyers,57,29,2,27
90,Paul Coffey,Blackhawks,10,4,0,4
90,Paul Coffey,Hurricanes,44,10,2,8
90,Paul Coffey,Hurricanes,69,40,11,29
90,Paul Coffey,Bruins,18,4,0,4
91,David Keon,Maple Leafs,70,45,20,25
91,David Keon,Maple Leafs,64,61,26,35
91,David Keon,Maple Leafs,68,56,28,28
91,David Keon,Maple Leafs,70,60,23,37
91,David Keon,Maple Leafs,65,50,21,29
91,David Keon,Maple Leafs,69,54,24,30
91,David Keon,Maple Leafs,66,52,19,33
91,David Keon,Maple Leafs,67,48,11,37
91,David Keon,Maple Leafs,75,61,27,34
91,David Keon,Maple Leafs,72,62,32,30
91,David Keon,Maple Leafs,76,76,38,38
91,David Keon,Maple Leafs,72,48,18,30
91,David Keon,Maple Leafs,76,73,37,36
91,David Keon,Maple Leafs,74,53,25,28
91,David Keon,Maple Leafs,78,59,16,43
91,David Keon,Whalers,76,62,10,52
91,David Keon,Whalers,80,47,13,34
91,David Keon,Whalers,78,19,8,11
92,Patrik Elias,Devils,1,0,0,0
92,Patrik Elias,Devils,17,5,2,3
92,Patrik Elias,Devils,74,37,18,19
92,Patrik Elias,Devils,74,50,17,33
92,Patrik Elias,Devils,72,72,35,37
92,Patrik Elias,Devils,82,96,40,56
92,Patrik Elias,Devils,75,61,29,32
92,Patrik Elias,Devils,81,57,28,29
92,Patrik Elias,Devils,82,81,38,43
92,Patrik Elias,Devils,38,45,16,29
92,Patrik Elias,Devils,75,69,21,48
92,Patrik Elias,Devils,74,55,20,35
92,Patrik Elias,Devils,77,78,31,47
92,Patrik Elias,Devils,58,48,19,29
92,Patrik Elias,Devils,81,62,21,41
92,Patrik Elias,Devils,81,78,26,52
92,Patrik Elias,Devils,48,36,14,22
92,Patrik Elias,Devils,65,53,18,35
92,Patrik Elias,Devils,23,11,2,9
93,Markus Naslund,Penguins,71,11,4,7
93,Markus Naslund,Penguins,14,4,2,2
93,Markus Naslund,Penguins,66,52,19,33
93,Markus Naslund,Canucks,10,3,3,0
93,Markus Naslund,Canucks,78,41,21,20
93,Markus Naslund,Canucks,76,34,14,20
93,Markus Naslund,Canucks,80,66,36,30
93,Markus Naslund,Canucks,82,65,27,38
93,Markus Naslund,Canucks,72,75,41,34
93,Markus Naslund,Canucks,81,90,40,50
93,Markus Naslund,Canucks,82,104,48,56
93,Markus Naslund,Canucks,78,84,35,49
93,Markus Naslund,Canucks,81,79,32,47
93,Markus Naslund,Canucks,82,60,24,36
93,Markus Naslund,Canucks,82,55,25,30
93,Markus Naslund,Rangers,82,46,24,22
94,Pierre Larouche,Penguins,79,68,31,37
94,Pierre Larouche,Penguins,76,111,53,58
94,Pierre Larouche,Penguins,65,63,29,34
94,Pierre Larouche,Penguins,20,11,6,5
94,Pierre Larouche,Canadiens,44,49,17,32
94,Pierre Larouche,Canadiens,36,22,9,13
94,Pierre Larouche,Canadiens,73,91,50,41
94,Pierre Larouche,Canadiens,61,53,25,28
94,Pierre Larouche,Canadiens,22,21,9,12
94,Pierre Larouche,Whalers,45,50,25,25
94,Pierre Larouche,Whalers,38,40,18,22
94,Pierre Larouche,Rangers,77,81,48,33
94,Pierre Larouche,Rangers,65,60,24,36
94,Pierre Larouche,Rangers,28,27,20,7
94,Pierre Larouche,Rangers,73,63,28,35
94,Pierre Larouche,Rangers,10,12,3,9
95,Cam Neely,Canucks,56,31,16,15
95,Cam Neely,Canucks,72,39,21,18
95,Cam Neely,Canucks,73,34,14,20
95,Cam Neely,Bruins,75,72,36,36
95,Cam Neely,Bruins,69,69,42,27
95,Cam Neely,Bruins,74,75,37,38
95,Cam Neely,Bruins,76,92,55,37
95,Cam Neely,Bruins,69,91,51,40
95,Cam Neely,Bruins,9,12,9,3
95,Cam Neely,Bruins,13,18,11,7
95,Cam Neely,Bruins,49,74,50,24
95,Cam Neely,Bruins,42,41,27,14
95,Cam Neely,Bruins,49,46,26,20
96,Tomas Sandstrom,Rangers,74,58,29,29
96,Tomas Sandstrom,Rangers,73,54,25,29
96,Tomas Sandstrom,Rangers,64,74,40,34
96,Tomas Sandstrom,Rangers,69,68,28,40
96,Tomas Sandstrom,Rangers,79,88,32,56
96,Tomas Sandstrom,Rangers,48,38,19,19
96,Tomas Sandstrom,Kings,28,33,13,20
96,Tomas Sandstrom,Kings,68,89,45,44
96,Tomas Sandstrom,Kings,49,39,17,22
96,Tomas Sandstrom,Kings,39,52,25,27
96,Tomas Sandstrom,Kings,51,41,17,24
96,Tomas Sandstrom,Penguins,27,17,6,11
96,Tomas Sandstrom,Penguins,47,44,21,23
96,Tomas Sandstrom,Penguins,58,70,35,35
96,Tomas Sandstrom,Penguins,40,24,9,15
96,Tomas Sandstrom,Red Wings,34,18,9,9
96,Tomas Sandstrom,Ducks,77,17,9,8
96,Tomas Sandstrom,Ducks,58,32,15,17
97,Bernie Geoffrion,Canadiens,18,14,8,6
97,Bernie Geoffrion,Canadiens,67,54,30,24
97,Bernie Geoffrion,Canadiens,65,39,22,17
97,Bernie Geoffrion,Canadiens,54,54,29,25
97,Bernie Geoffrion,Canadiens,70,75,38,37
97,Bernie Geoffrion,Canadiens,59,62,29,33
97,Bernie Geoffrion,Canadiens,41,40,19,21
97,Bernie Geoffrion,Canadiens,42,50,27,23
97,Bernie Geoffrion,Canadiens,59,66,22,44
97,Bernie Geoffrion,Canadiens,59,71,30,41
97,Bernie Geoffrion,Canadiens,64,95,50,45
97,Bernie Geoffrion,Canadiens,62,59,23,36
97,Bernie Geoffrion,Canadiens,51,41,23,18
97,Bernie Geoffrion,Canadiens,55,39,21,18
97,Bernie Geoffrion,Rangers,58,42,17,25
97,Bernie Geoffrion,Rangers,59,21,5,16
98,Dean Prentice,Rangers,55,9,6,3
98,Dean Prentice,Rangers,52,17,4,13
98,Dean Prentice,Rangers,70,31,16,15
98,Dean Prentice,Rangers,70,42,24,18
98,Dean Prentice,Rangers,68,42,19,23
98,Dean Prentice,Rangers,38,22,13,9
98,Dean Prentice,Rangers,70,50,17,33
98,Dean Prentice,Rangers,70,66,32,34
98,Dean Prentice,Rangers,56,45,20,25
98,Dean Prentice,Rangers,68,60,22,38
98,Dean Prentice,Rangers,49,38,13,25
98,Dean Prentice,Bruins,19,15,6,9
98,Dean Prentice,Bruins,70,39,23,16
98,Dean Prentice,Bruins,31,23,14,9
98,Dean Prentice,Bruins,50,29,7,22
98,Dean Prentice,Red Wings,19,15,6,9
98,Dean Prentice,Red Wings,68,45,23,22
98,Dean Prentice,Red Wings,69,55,17,38
98,Dean Prentice,Red Wings,74,34,14,20
98,Dean Prentice,Penguins,75,51,26,25
98,Dean Prentice,Penguins,69,38,21,17
98,Dean Prentice,North Stars,71,47,20,27
98,Dean Prentice,North Stars,73,42,26,16
98,Dean Prentice,North Stars,24,5,2,3
99,Joseph Pronovost,Penguins,76,41,16,25
99,Joseph Pronovost,Penguins,72,41,20,21
99,Joseph Pronovost,Penguins,78,45,21,24
99,Joseph Pronovost,Penguins,68,53,30,23
99,Joseph Pronovost,Penguins,66,43,21,22
99,Joseph Pronovost,Penguins,77,72,40,32
99,Joseph Pronovost,Penguins,78,75,43,32
99,Joseph Pronovost,Penguins,80,104,52,52
99,Joseph Pronovost,Penguins,79,64,33,31
99,Joseph Pronovost,Penguins,79,65,40,25
99,Joseph Pronovost,Flames,75,67,28,39
99,Joseph Pronovost,Flames,80,43,24,19
99,Joseph Pronovost,Capitals,80,58,22,36
99,Joseph Pronovost,Capitals,10,3,1,2
100,Ryan Smyth,Oilers,3,0,0,0
100,Ryan Smyth,Oilers,48,11,2,9
100,Ryan Smyth,Oilers,82,61,39,22
100,Ryan Smyth,Oilers,65,33,20,13
100,Ryan Smyth,Oilers,71,31,13,18
100,Ryan Smyth,Oilers,82,54,28,26
100,Ryan Smyth,Oilers,82,70,31,39
100,Ryan Smyth,Oilers,61,50,15,35
100,Ryan Smyth,Oilers,66,61,27,34
100,Ryan Smyth,Oilers,82,59,23,36
100,Ryan Smyth,Oilers,75,66,36,30
100,Ryan Smyth,Oilers,53,53,31,22
100,Ryan Smyth,Islanders,18,15,5,10
100,Ryan Smyth,Avalanche,55,37,14,23
100,Ryan Smyth,Avalanche,77,59,26,33
100,Ryan Smyth,Kings,67,53,22,31
100,Ryan Smyth,Kings,82,47,23,24
100,Ryan Smyth,Oilers,82,46,19,27
100,Ryan Smyth,Oilers,47,13,2,11
100,Ryan Smyth,Oilers,72,23,10,13
101,Ray Whitney,Sharks,2,3,0,3
101,Ray Whitney,Sharks,26,10,4,6
101,Ray Whitney,Sharks,61,40,14,26
101,Ray Whitney,Sharks,39,25,13,12
101,Ray Whitney,Sharks,60,41,17,24
101,Ray Whitney,Sharks,12,2,0,2
101,Ray Whitney,Oilers,9,4,1,3
101,Ray Whitney,Panthers,68,61,32,29
101,Ray Whitney,Panthers,81,64,26,38
101,Ray Whitney,Panthers,81,71,29,42
101,Ray Whitney,Panthers,43,31,10,21
101,Ray Whitney,Blue Jackets,3,3,0,3
101,Ray Whitney,Blue Jackets,67,61,21,40
101,Ray Whitney,Blue Jackets,81,76,24,52
101,Ray Whitney,Red Wings,67,43,14,29
101,Ray Whitney,Hurricanes,63,55,17,38
101,Ray Whitney,Hurricanes,81,83,32,51
101,Ray Whitney,Hurricanes,66,61,25,36
101,Ray Whitney,Hurricanes,82,77,24,53
101,Ray Whitney,Hurricanes,80,58,21,37
101,Ray Whitney,Coyotes,75,57,17,40
101,Ray Whitney,Coyotes,82,77,24,53
101,Ray Whitney,Stars,32,29,11,18
101,Ray Whitney,Stars,69,32,9,23
102,Richard Martin,Sabres,73,74,44,30
102,Richard Martin,Sabres,75,73,37,36
102,Richard Martin,Sabres,78,86,52,34
102,Richard Martin,Sabres,68,95,52,43
102,Richard Martin,Sabres,80,86,49,37
102,Richard Martin,Sabres,66,65,36,29
102,Richard Martin,Sabres,65,63,28,35
102,Richard Martin,Sabres,73,53,32,21
102,Richard Martin,Sabres,80,79,45,34
102,Richard Martin,Sabres,23,21,7,14
102,Richard Martin,Kings,1,2,1,1
102,Richard Martin,Kings,3,4,1,3
103,Reginald Leach,Bruins,23,6,2,4
103,Reginald Leach,Bruins,56,20,7,13
103,Reginald Leach,Seals,17,13,6,7
103,Reginald Leach,Seals,76,35,23,12
103,Reginald Leach,Seals,78,46,22,24
103,Reginald Leach,Flyers,80,78,45,33
103,Reginald Leach,Flyers,80,91,61,30
103,Reginald Leach,Flyers,77,46,32,14
103,Reginald Leach,Flyers,72,52,24,28
103,Reginald Leach,Flyers,76,54,34,20
103,Reginald Leach,Flyers,76,76,50,26
103,Reginald Leach,Flyers,79,70,34,36
103,Reginald Leach,Flyers,66,47,26,21
103,Reginald Leach,Red Wings,78,32,15,17
104,Martin St. Louis,Flames,13,2,1,1
104,Martin St. Louis,Flames,56,18,3,15
104,Martin St. Louis,Lightning,78,40,18,22
104,Martin St. Louis,Lightning,53,35,16,19
104,Martin St. Louis,Lightning,82,70,33,37
104,Martin St. Louis,Lightning,82,94,38,56
104,Martin St. Louis,Lightning,80,61,31,30
104,Martin St. Louis,Lightning,82,102,43,59
104,Martin St. Louis,Lightning,82,83,25,58
104,Martin St. Louis,Lightning,82,80,30,50
104,Martin St. Louis,Lightning,82,94,29,65
104,Martin St. Louis,Lightning,82,99,31,68
104,Martin St. Louis,Lightning,77,74,25,49
104,Martin St. Louis,Lightning,48,60,17,43
104,Martin St. Louis,Lightning,62,61,29,32
104,Martin St. Louis,Rangers,19,8,1,7
104,Martin St. Louis,Rangers,22,19,9,10
105,Ted Lindsay,Red Wings,45,23,17,6
105,Ted Lindsay,Red Wings,47,17,7,10
105,Ted Lindsay,Red Wings,59,42,27,15
105,Ted Lindsay,Red Wings,60,52,33,19
105,Ted Lindsay,Red Wings,50,54,26,28
105,Ted Lindsay,Red Wings,69,78,23,55
105,Ted Lindsay,Red Wings,67,59,24,35
105,Ted Lindsay,Red Wings,70,69,30,39
105,Ted Lindsay,Red Wings,70,71,32,39
105,Ted Lindsay,Red Wings,70,62,26,36
105,Ted Lindsay,Red Wings,49,38,19,19
105,Ted Lindsay,Red Wings,67,50,27,23
105,Ted Lindsay,Red Wings,70,85,30,55
105,Ted Lindsay,Blackhawks,68,39,15,24
105,Ted Lindsay,Blackhawks,70,58,22,36
105,Ted Lindsay,Blackhawks,68,26,7,19
105,Ted Lindsay,Red Wings,69,28,14,14
106,Claude Lemieux,Canadiens,8,2,1,1
106,Claude Lemieux,Canadiens,1,1,0,1
106,Claude Lemieux,Canadiens,10,3,1,2
106,Claude Lemieux,Canadiens,76,53,27,26
106,Claude Lemieux,Canadiens,78,61,31,30
106,Claude Lemieux,Canadiens,69,51,29,22
106,Claude Lemieux,Canadiens,39,18,8,10
106,Claude Lemieux,Devils,78,47,30,17
106,Claude Lemieux,Devils,74,68,41,27
106,Claude Lemieux,Devils,77,81,30,51
106,Claude Lemieux,Devils,79,44,18,26
106,Claude Lemieux,Devils,45,19,6,13
106,Claude Lemieux,Avalanche,79,71,39,32
106,Claude Lemieux,Avalanche,45,28,11,17
106,Claude Lemieux,Avalanche,78,53,26,27
106,Claude Lemieux,Avalanche,82,51,27,24
106,Claude Lemieux,Avalanche,13,9,3,6
106,Claude Lemieux,Devils,70,38,17,21
106,Claude Lemieux,Coyotes,46,26,10,16
106,Claude Lemieux,Coyotes,82,41,16,25
106,Claude Lemieux,Coyotes,36,14,6,8
106,Claude Lemieux,Stars,32,6,2,4
106,Claude Lemieux,Sharks,18,1,0,1
107,Robert Goring,Kings,59,36,13,23
107,Robert Goring,Kings,19,7,2,5
107,Robert Goring,Kings,74,50,21,29
107,Robert Goring,Kings,67,59,28,31
107,Robert Goring,Kings,70,61,28,33
107,Robert Goring,Kings,60,60,27,33
107,Robert Goring,Kings,80,73,33,40
107,Robert Goring,Kings,78,85,30,55
107,Robert Goring,Kings,80,73,37,36
107,Robert Goring,Kings,80,87,36,51
107,Robert Goring,Kings,69,68,20,48
107,Robert Goring,Islanders,12,11,6,5
107,Robert Goring,Islanders,78,60,23,37
107,Robert Goring,Islanders,67,32,15,17
107,Robert Goring,Islanders,75,39,19,20
107,Robert Goring,Islanders,71,46,22,24
107,Robert Goring,Islanders,29,7,2,5
107,Robert Goring,Bruins,39,34,13,21
108,Trevor Linden,Canucks,80,59,30,29
108,Trevor Linden,Canucks,73,51,21,30
108,Trevor Linden,Canucks,80,70,33,37
108,Trevor Linden,Canucks,80,75,31,44
108,Trevor Linden,Canucks,84,72,33,39
108,Trevor Linden,Canucks,84,61,32,29
108,Trevor Linden,Canucks,48,40,18,22
108,Trevor Linden,Canucks,82,80,33,47
108,Trevor Linden,Canucks,49,40,9,31
108,Trevor Linden,Canucks,42,21,7,14
108,Trevor Linden,Islanders,25,17,10,7
108,Trevor Linden,Islanders,82,47,18,29
108,Trevor Linden,Canadiens,50,30,13,17
108,Trevor Linden,Canadiens,57,33,12,21
108,Trevor Linden,Capitals,12,4,3,1
108,Trevor Linden,Capitals,16,3,1,2
108,Trevor Linden,Canucks,64,34,12,22
108,Trevor Linden,Canucks,71,41,19,22
108,Trevor Linden,Canucks,82,36,14,22
108,Trevor Linden,Canucks,82,16,7,9
108,Trevor Linden,Canucks,80,25,12,13
108,Trevor Linden,Canucks,59,12,7,5
109,Milan Hejduk,Avalanche,82,48,14,34
109,Milan Hejduk,Avalanche,82,72,36,36
109,Milan Hejduk,Avalanche,80,79,41,38
109,Milan Hejduk,Avalanche,62,44,21,23
109,Milan Hejduk,Avalanche,82,98,50,48
109,Milan Hejduk,Avalanche,82,75,35,40
109,Milan Hejduk,Avalanche,74,58,24,34
109,Milan Hejduk,Avalanche,80,70,35,35
109,Milan Hejduk,Avalanche,77,54,29,25
109,Milan Hejduk,Avalanche,82,59,27,32
109,Milan Hejduk,Avalanche,56,44,23,21
109,Milan Hejduk,Avalanche,71,56,22,34
109,Milan Hejduk,Avalanche,81,37,14,23
109,Milan Hejduk,Avalanche,29,11,4,7
110,Eric Lindros,Flyers,61,75,41,34
110,Eric Lindros,Flyers,65,97,44,53
110,Eric Lindros,Flyers,46,70,29,41
110,Eric Lindros,Flyers,73,115,47,68
110,Eric Lindros,Flyers,52,79,32,47
110,Eric Lindros,Flyers,63,71,30,41
110,Eric Lindros,Flyers,71,93,40,53
110,Eric Lindros,Flyers,55,59,27,32
110,Eric Lindros,Rangers,72,73,37,36
110,Eric Lindros,Rangers,81,53,19,34
110,Eric Lindros,Rangers,39,32,10,22
110,Eric Lindros,Maple Leafs,33,22,11,11
110,Eric Lindros,Stars,49,26,5,21
111,Dany Heatley,Thrashers,82,67,26,41
111,Dany Heatley,Thrashers,77,89,41,48
111,Dany Heatley,Thrashers,31,25,13,12
111,Dany Heatley,Senators,82,103,50,53
111,Dany Heatley,Senators,82,105,50,55
111,Dany Heatley,Senators,71,82,41,41
111,Dany Heatley,Senators,82,72,39,33
111,Dany Heatley,Sharks,82,82,39,43
111,Dany Heatley,Sharks,80,64,26,38
111,Dany Heatley,Wild,82,53,24,29
111,Dany Heatley,Wild,36,21,11,10
111,Dany Heatley,Wild,76,28,12,16
111,Dany Heatley,Ducks,4,0,0,0
112,Rick Kehoe,Maple Leafs,38,16,8,8
112,Rick Kehoe,Maple Leafs,77,75,33,42
112,Rick Kehoe,Maple Leafs,69,40,18,22
112,Rick Kehoe,Penguins,76,63,32,31
112,Rick Kehoe,Penguins,71,76,29,47
112,Rick Kehoe,Penguins,80,57,30,27
112,Rick Kehoe,Penguins,70,50,29,21
112,Rick Kehoe,Penguins,57,45,27,18
112,Rick Kehoe,Penguins,79,60,30,30
112,Rick Kehoe,Penguins,80,88,55,33
112,Rick Kehoe,Penguins,71,85,33,52
112,Rick Kehoe,Penguins,75,65,29,36
112,Rick Kehoe,Penguins,57,45,18,27
112,Rick Kehoe,Penguins,6,2,0,2
113,Tim Kerr,Flyers,68,45,22,23
113,Tim Kerr,Flyers,61,51,21,30
113,Tim Kerr,Flyers,24,19,11,8
113,Tim Kerr,Flyers,79,93,54,39
113,Tim Kerr,Flyers,74,98,54,44
113,Tim Kerr,Flyers,76,84,58,26
113,Tim Kerr,Flyers,75,95,58,37
113,Tim Kerr,Flyers,8,5,3,2
113,Tim Kerr,Flyers,69,88,48,40
113,Tim Kerr,Flyers,40,48,24,24
113,Tim Kerr,Flyers,27,24,10,14
113,Tim Kerr,Rangers,32,18,7,11
113,Tim Kerr,Whalers,22,6,0,6
114,Bernard Federko,Blues,31,23,14,9
114,Bernard Federko,Blues,72,41,17,24
114,Bernard Federko,Blues,74,95,31,64
114,Bernard Federko,Blues,79,94,38,56
114,Bernard Federko,Blues,78,104,31,73
114,Bernard Federko,Blues,74,92,30,62
114,Bernard Federko,Blues,75,84,24,60
114,Bernard Federko,Blues,79,107,41,66
114,Bernard Federko,Blues,76,103,30,73
114,Bernard Federko,Blues,80,102,34,68
114,Bernard Federko,Blues,64,72,20,52
114,Bernard Federko,Blues,79,89,20,69
114,Bernard Federko,Blues,66,67,22,45
114,Bernard Federko,Red Wings,73,57,17,40
115,Geoff Courtnall,Bruins,4,0,0,0
115,Geoff Courtnall,Bruins,64,28,12,16
115,Geoff Courtnall,Bruins,64,37,21,16
115,Geoff Courtnall,Bruins,65,36,13,23
115,Geoff Courtnall,Bruins,62,58,32,26
115,Geoff Courtnall,Oilers,12,8,4,4
115,Geoff Courtnall,Capitals,79,80,42,38
115,Geoff Courtnall,Capitals,80,74,35,39
115,Geoff Courtnall,Blues,66,57,27,30
115,Geoff Courtnall,Canucks,11,8,6,2
115,Geoff Courtnall,Canucks,70,57,23,34
115,Geoff Courtnall,Canucks,84,77,31,46
115,Geoff Courtnall,Canucks,82,70,26,44
115,Geoff Courtnall,Canucks,45,34,16,18
115,Geoff Courtnall,Blues,69,40,24,16
115,Geoff Courtnall,Blues,82,57,17,40
115,Geoff Courtnall,Blues,79,62,31,31
115,Geoff Courtnall,Blues,24,12,5,7
115,Geoff Courtnall,Blues,6,4,2,2
116,Jacques Lemaire,Canadiens,69,42,22,20
116,Jacques Lemaire,Canadiens,75,63,29,34
116,Jacques Lemaire,Canadiens,69,60,32,28
116,Jacques Lemaire,Canadiens,78,56,28,28
116,Jacques Lemaire,Canadiens,77,81,32,49
116,Jacques Lemaire,Canadiens,77,95,44,51
116,Jacques Lemaire,Canadiens,66,67,29,38
116,Jacques Lemaire,Canadiens,80,92,36,56
116,Jacques Lemaire,Canadiens,61,52,20,32
116,Jacques Lemaire,Canadiens,75,75,34,41
116,Jacques Lemaire,Canadiens,76,97,36,61
116,Jacques Lemaire,Canadiens,50,55,24,31
117,Scott Mellanby,Flyers,2,0,0,0
117,Scott Mellanby,Flyers,71,32,11,21
117,Scott Mellanby,Flyers,75,51,25,26
117,Scott Mellanby,Flyers,76,50,21,29
117,Scott Mellanby,Flyers,57,23,6,17
117,Scott Mellanby,Flyers,74,41,20,21
117,Scott Mellanby,Oilers,80,50,23,27
117,Scott Mellanby,Oilers,69,32,15,17
117,Scott Mellanby,Panthers,80,60,30,30
117,Scott Mellanby,Panthers,48,25,13,12
117,Scott Mellanby,Panthers,79,70,32,38
117,Scott Mellanby,Panthers,82,56,27,29
117,Scott Mellanby,Panthers,79,39,15,24
117,Scott Mellanby,Panthers,67,45,18,27
117,Scott Mellanby,Panthers,77,46,18,28
117,Scott Mellanby,Panthers,40,13,4,9
117,Scott Mellanby,Blues,23,8,7,1
117,Scott Mellanby,Blues,64,41,15,26
117,Scott Mellanby,Blues,80,57,26,31
117,Scott Mellanby,Blues,68,31,14,17
117,Scott Mellanby,Thrashers,71,34,12,22
117,Scott Mellanby,Thrashers,69,36,12,24
118,Brent Sutter,Islanders,3,4,2,2
118,Brent Sutter,Islanders,43,43,21,22
118,Brent Sutter,Islanders,80,40,21,19
118,Brent Sutter,Islanders,69,49,34,15
118,Brent Sutter,Islanders,72,102,42,60
118,Brent Sutter,Islanders,61,55,24,31
118,Brent Sutter,Islanders,69,63,27,36
118,Brent Sutter,Islanders,70,60,29,31
118,Brent Sutter,Islanders,77,63,29,34
118,Brent Sutter,Islanders,67,68,33,35
118,Brent Sutter,Islanders,75,53,21,32
118,Brent Sutter,Islanders,8,10,4,6
118,Brent Sutter,Blackhawks,61,50,18,32
118,Brent Sutter,Blackhawks,65,54,20,34
118,Brent Sutter,Blackhawks,73,38,9,29
118,Brent Sutter,Blackhawks,47,15,7,8
118,Brent Sutter,Blackhawks,80,40,13,27
118,Brent Sutter,Blackhawks,39,14,7,7
118,Brent Sutter,Blackhawks,52,8,2,6
119,Peter Mcnab,Sabres,22,9,3,6
119,Peter Mcnab,Sabres,53,43,22,21
119,Peter Mcnab,Sabres,79,56,24,32
119,Peter Mcnab,Bruins,80,86,38,48
119,Peter Mcnab,Bruins,79,80,41,39
119,Peter Mcnab,Bruins,76,80,35,45
119,Peter Mcnab,Bruins,74,78,40,38
119,Peter Mcnab,Bruins,80,83,37,46
119,Peter Mcnab,Bruins,80,76,36,40
119,Peter Mcnab,Bruins,74,74,22,52
119,Peter Mcnab,Bruins,52,30,14,16
119,Peter Mcnab,Canucks,13,7,1,6
119,Peter Mcnab,Canucks,75,48,23,25
119,Peter Mcnab,Devils,71,43,19,24
119,Peter Mcnab,Devils,46,20,8,12
120,Miroslav Satan,Oilers,62,35,18,17
120,Miroslav Satan,Oilers,64,28,17,11
120,Miroslav Satan,Sabres,12,10,8,2
120,Miroslav Satan,Sabres,79,46,22,24
120,Miroslav Satan,Sabres,81,66,40,26
120,Miroslav Satan,Sabres,81,67,33,34
120,Miroslav Satan,Sabres,82,62,29,33
120,Miroslav Satan,Sabres,82,73,37,36
120,Miroslav Satan,Sabres,79,75,26,49
120,Miroslav Satan,Sabres,82,57,29,28
120,Miroslav Satan,Islanders,82,66,35,31
120,Miroslav Satan,Islanders,81,59,27,32
120,Miroslav Satan,Islanders,80,41,16,25
120,Miroslav Satan,Penguins,65,36,17,19
120,Miroslav Satan,Bruins,38,14,9,5
121,Shane Doan,Jets (1979),74,17,7,10
121,Shane Doan,Coyotes,63,12,4,8
121,Shane Doan,Coyotes,33,11,5,6
121,Shane Doan,Coyotes,79,22,6,16
121,Shane Doan,Coyotes,81,51,26,25
121,Shane Doan,Coyotes,76,63,26,37
121,Shane Doan,Coyotes,81,49,20,29
121,Shane Doan,Coyotes,82,58,21,37
121,Shane Doan,Coyotes,79,68,27,41
121,Shane Doan,Coyotes,82,66,30,36
121,Shane Doan,Coyotes,73,55,27,28
121,Shane Doan,Coyotes,80,78,28,50
121,Shane Doan,Coyotes,82,73,31,42
121,Shane Doan,Coyotes,82,55,18,37
121,Shane Doan,Coyotes,72,60,20,40
121,Shane Doan,Coyotes,79,50,22,28
121,Shane Doan,Coyotes,48,27,13,14
121,Shane Doan,Coyotes,69,47,23,24
121,Shane Doan,Coyotes,23,15,7,8
122,Ivan Boldirev,Bruins,2,0,0,0
122,Ivan Boldirev,Bruins,11,2,0,2
122,Ivan Boldirev,Seals,57,39,16,23
122,Ivan Boldirev,Seals,56,34,11,23
122,Ivan Boldirev,Seals,78,56,25,31
122,Ivan Boldirev,Blackhawks,80,67,24,43
122,Ivan Boldirev,Blackhawks,78,62,28,34
122,Ivan Boldirev,Blackhawks,80,62,24,38
122,Ivan Boldirev,Blackhawks,80,80,35,45
122,Ivan Boldirev,Blackhawks,66,64,29,35
122,Ivan Boldirev,Flames,13,14,6,8
122,Ivan Boldirev,Flames,52,40,16,24
122,Ivan Boldirev,Canucks,27,27,16,11
122,Ivan Boldirev,Canucks,72,59,26,33
122,Ivan Boldirev,Canucks,78,73,33,40
122,Ivan Boldirev,Canucks,39,25,5,20
122,Ivan Boldirev,Red Wings,33,30,13,17
122,Ivan Boldirev,Red Wings,75,83,35,48
122,Ivan Boldirev,Red Wings,75,49,19,30
123,Bobby Clarke,Flyers,76,46,15,31
123,Bobby Clarke,Flyers,77,63,27,36
123,Bobby Clarke,Flyers,78,81,35,46
123,Bobby Clarke,Flyers,78,104,37,67
123,Bobby Clarke,Flyers,77,87,35,52
123,Bobby Clarke,Flyers,80,116,27,89
123,Bobby Clarke,Flyers,76,119,30,89
123,Bobby Clarke,Flyers,80,90,27,63
123,Bobby Clarke,Flyers,71,89,21,68
123,Bobby Clarke,Flyers,80,73,16,57
123,Bobby Clarke,Flyers,76,69,12,57
123,Bobby Clarke,Flyers,80,65,19,46
123,Bobby Clarke,Flyers,62,63,17,46
123,Bobby Clarke,Flyers,80,85,23,62
123,Bobby Clarke,Flyers,73,60,17,43
124,Henri Richard,Canadiens,64,40,19,21
124,Henri Richard,Canadiens,63,54,18,36
124,Henri Richard,Canadiens,67,80,28,52
124,Henri Richard,Canadiens,63,51,21,30
124,Henri Richard,Canadiens,70,73,30,43
124,Henri Richard,Canadiens,70,68,24,44
124,Henri Richard,Canadiens,54,50,21,29
124,Henri Richard,Canadiens,67,73,23,50
124,Henri Richard,Canadiens,66,53,14,39
124,Henri Richard,Canadiens,53,52,23,29
124,Henri Richard,Canadiens,62,61,22,39
124,Henri Richard,Canadiens,65,55,21,34
124,Henri Richard,Canadiens,54,28,9,19
124,Henri Richard,Canadiens,64,52,15,37
124,Henri Richard,Canadiens,62,52,16,36
124,Henri Richard,Canadiens,75,49,12,37
124,Henri Richard,Canadiens,75,44,12,32
124,Henri Richard,Canadiens,71,43,8,35
124,Henri Richard,Canadiens,75,55,19,36
124,Henri Richard,Canadiens,16,13,3,10
125,Bobby Smith,North Stars,80,74,30,44
125,Bobby Smith,North Stars,61,83,27,56
125,Bobby Smith,North Stars,78,93,29,64
125,Bobby Smith,North Stars,80,114,43,71
125,Bobby Smith,North Stars,77,77,24,53
125,Bobby Smith,North Stars,10,9,3,6
125,Bobby Smith,Canadiens,70,63,26,37
125,Bobby Smith,Canadiens,65,56,16,40
125,Bobby Smith,Canadiens,79,86,31,55
125,Bobby Smith,Canadiens,80,75,28,47
125,Bobby Smith,Canadiens,78,93,27,66
125,Bobby Smith,Canadiens,80,83,32,51
125,Bobby Smith,Canadiens,53,26,12,14
125,Bobby Smith,North Stars,73,46,15,31
125,Bobby Smith,North Stars,68,46,9,37
125,Bobby Smith,North Stars,45,12,5,7
126,Kirk Muller,Devils,80,54,17,37
126,Kirk Muller,Devils,77,66,25,41
126,Kirk Muller,Devils,79,76,26,50
126,Kirk Muller,Devils,80,94,37,57
126,Kirk Muller,Devils,80,74,31,43
126,Kirk Muller,Devils,80,86,30,56
126,Kirk Muller,Devils,80,70,19,51
126,Kirk Muller,Canadiens,78,77,36,41
126,Kirk Muller,Canadiens,80,94,37,57
126,Kirk Muller,Canadiens,76,57,23,34
126,Kirk Muller,Canadiens,33,19,8,11
126,Kirk Muller,Islanders,12,8,3,5
126,Kirk Muller,Islanders,15,7,4,3
126,Kirk Muller,Maple Leafs,36,25,9,16
126,Kirk Muller,Maple Leafs,66,37,20,17
126,Kirk Muller,Panthers,10,3,1,2
126,Kirk Muller,Panthers,70,29,8,21
126,Kirk Muller,Panthers,82,15,4,11
126,Kirk Muller,Stars,47,22,7,15
126,Kirk Muller,Stars,55,10,1,9
126,Kirk Muller,Stars,78,30,10,20
126,Kirk Muller,Stars,55,6,1,5
127,Ray Sheppard,Sabres,74,65,38,27
127,Ray Sheppard,Sabres,67,43,22,21
127,Ray Sheppard,Sabres,18,6,4,2
127,Ray Sheppard,Rangers,59,47,24,23
127,Ray Sheppard,Red Wings,74,62,36,26
127,Ray Sheppard,Red Wings,70,66,32,34
127,Ray Sheppard,Red Wings,82,93,52,41
127,Ray Sheppard,Red Wings,43,40,30,10
127,Ray Sheppard,Red Wings,5,4,2,2
127,Ray Sheppard,Sharks,51,46,27,19
127,Ray Sheppard,Panthers,14,10,8,2
127,Ray Sheppard,Panthers,68,60,29,31
127,Ray Sheppard,Panthers,61,31,14,17
127,Ray Sheppard,Hurricanes,10,6,4,2
127,Ray Sheppard,Hurricanes,74,58,25,33
127,Ray Sheppard,Panthers,47,20,10,10
128,Dennis Maruk,Seals,80,62,30,32
128,Dennis Maruk,Barons,80,78,28,50
128,Dennis Maruk,Barons,76,71,36,35
128,Dennis Maruk,North Stars,2,0,0,0
128,Dennis Maruk,Capitals,76,90,31,59
128,Dennis Maruk,Capitals,27,27,10,17
128,Dennis Maruk,Capitals,80,97,50,47
128,Dennis Maruk,Capitals,80,136,60,76
128,Dennis Maruk,Capitals,80,81,31,50
128,Dennis Maruk,North Stars,71,60,17,43
128,Dennis Maruk,North Stars,71,60,19,41
128,Dennis Maruk,North Stars,70,58,21,37
128,Dennis Maruk,North Stars,67,46,16,30
128,Dennis Maruk,North Stars,22,11,7,4
128,Dennis Maruk,North Stars,6,1,0,1
129,Vyacheslav Kozlov,Red Wings,7,2,0,2
129,Vyacheslav Kozlov,Red Wings,17,5,4,1
129,Vyacheslav Kozlov,Red Wings,77,73,34,39
129,Vyacheslav Kozlov,Red Wings,46,33,13,20
129,Vyacheslav Kozlov,Red Wings,82,73,36,37
129,Vyacheslav Kozlov,Red Wings,75,45,23,22
129,Vyacheslav Kozlov,Red Wings,80,52,25,27
129,Vyacheslav Kozlov,Red Wings,79,58,29,29
129,Vyacheslav Kozlov,Red Wings,72,36,18,18
129,Vyacheslav Kozlov,Red Wings,72,38,20,18
129,Vyacheslav Kozlov,Sabres,38,22,9,13
129,Vyacheslav Kozlov,Thrashers,79,70,21,49
129,Vyacheslav Kozlov,Thrashers,76,52,20,32
129,Vyacheslav Kozlov,Thrashers,82,71,25,46
129,Vyacheslav Kozlov,Thrashers,81,80,28,52
129,Vyacheslav Kozlov,Thrashers,82,41,17,24
129,Vyacheslav Kozlov,Thrashers,82,76,26,50
129,Vyacheslav Kozlov,Thrashers,55,26,8,18
130,Wilf Paiement,Scouts,78,39,26,13
130,Wilf Paiement,Scouts,57,43,21,22
130,Wilf Paiement,Rockies,78,81,41,40
130,Wilf Paiement,Rockies,80,87,31,56
130,Wilf Paiement,Rockies,65,60,24,36
130,Wilf Paiement,Rockies,34,26,10,16
130,Wilf Paiement,Maple Leafs,41,48,20,28
130,Wilf Paiement,Maple Leafs,77,97,40,57
130,Wilf Paiement,Maple Leafs,69,58,18,40
130,Wilf Paiement,Nordiques,8,13,7,6
130,Wilf Paiement,Nordiques,80,64,26,38
130,Wilf Paiement,Nordiques,80,76,39,37
130,Wilf Paiement,Nordiques,68,51,23,28
130,Wilf Paiement,Nordiques,44,19,7,12
130,Wilf Paiement,Rangers,8,7,1,6
130,Wilf Paiement,Sabres,56,37,20,17
130,Wilf Paiement,Penguins,23,8,2,6
131,Kevin Dineen,Whalers,57,41,25,16
131,Kevin Dineen,Whalers,57,68,33,35
131,Kevin Dineen,Whalers,78,79,40,39
131,Kevin Dineen,Whalers,74,50,25,25
131,Kevin Dineen,Whalers,79,89,45,44
131,Kevin Dineen,Whalers,67,66,25,41
131,Kevin Dineen,Whalers,61,47,17,30
131,Kevin Dineen,Whalers,16,6,4,2
131,Kevin Dineen,Flyers,64,56,26,30
131,Kevin Dineen,Flyers,83,63,35,28
131,Kevin Dineen,Flyers,71,42,19,23
131,Kevin Dineen,Flyers,40,13,8,5
131,Kevin Dineen,Flyers,26,2,0,2
131,Kevin Dineen,Whalers,20,9,2,7
131,Kevin Dineen,Whalers,78,48,19,29
131,Kevin Dineen,Hurricanes,54,23,7,16
131,Kevin Dineen,Hurricanes,67,18,8,10
131,Kevin Dineen,Senators,67,12,4,8
131,Kevin Dineen,Blue Jackets,66,15,8,7
131,Kevin Dineen,Blue Jackets,59,13,5,8
131,Kevin Dineen,Blue Jackets,4,0,0,0
132,Greg Adams,Devils,36,21,12,9
132,Greg Adams,Devils,78,77,35,42
132,Greg Adams,Devils,72,47,20,27
132,Greg Adams,Canucks,80,76,36,40
132,Greg Adams,Canucks,61,33,19,14
132,Greg Adams,Canucks,65,50,30,20
132,Greg Adams,Canucks,55,45,21,24
132,Greg Adams,Canucks,76,57,30,27
132,Greg Adams,Canucks,53,56,25,31
132,Greg Adams,Canucks,68,37,13,24
132,Greg Adams,Canucks,31,15,5,10
132,Greg Adams,Stars,12,6,3,3
132,Greg Adams,Stars,66,43,22,21
132,Greg Adams,Stars,50,36,21,15
132,Greg Adams,Stars,49,32,14,18
132,Greg Adams,Coyotes,75,43,19,24
132,Greg Adams,Coyotes,69,46,19,27
132,Greg Adams,Panthers,60,23,11,12
133,Michael Foligno,Red Wings,80,71,36,35
133,Michael Foligno,Red Wings,80,63,28,35
133,Michael Foligno,Red Wings,26,26,13,13
133,Michael Foligno,Sabres,56,51,20,31
133,Michael Foligno,Sabres,66,47,22,25
133,Michael Foligno,Sabres,70,63,32,31
133,Michael Foligno,Sabres,77,56,27,29
133,Michael Foligno,Sabres,79,80,41,39
133,Michael Foligno,Sabres,75,59,30,29
133,Michael Foligno,Sabres,74,57,29,28
133,Michael Foligno,Sabres,75,49,27,22
133,Michael Foligno,Sabres,61,40,15,25
133,Michael Foligno,Sabres,31,9,4,5
133,Michael Foligno,Maple Leafs,37,15,8,7
133,Michael Foligno,Maple Leafs,33,14,6,8
133,Michael Foligno,Maple Leafs,55,18,13,5
133,Michael Foligno,Maple Leafs,4,0,0,0
133,Michael Foligno,Panthers,39,9,4,5
134,Geoff Sanderson,Whalers,2,1,1,0
134,Geoff Sanderson,Whalers,64,31,13,18
134,Geoff Sanderson,Whalers,82,89,46,43
134,Geoff Sanderson,Whalers,82,67,41,26
134,Geoff Sanderson,Whalers,46,32,18,14
134,Geoff Sanderson,Whalers,81,65,34,31
134,Geoff Sanderson,Whalers,82,67,36,31
134,Geoff Sanderson,Hurricanes,40,17,7,10
134,Geoff Sanderson,Canucks,9,3,0,3
134,Geoff Sanderson,Sabres,26,9,4,5
134,Geoff Sanderson,Sabres,75,30,12,18
134,Geoff Sanderson,Sabres,67,26,13,13
134,Geoff Sanderson,Blue Jackets,68,56,30,26
134,Geoff Sanderson,Blue Jackets,42,16,11,5
134,Geoff Sanderson,Blue Jackets,82,67,34,33
134,Geoff Sanderson,Blue Jackets,67,29,13,16
134,Geoff Sanderson,Canucks,13,7,3,4
134,Geoff Sanderson,Blue Jackets,2,0,0,0
134,Geoff Sanderson,Coyotes,75,46,25,21
134,Geoff Sanderson,Flyers,58,29,11,18
134,Geoff Sanderson,Oilers,41,13,3,10
135,Daniel Gare,Sabres,78,62,31,31
135,Daniel Gare,Sabres,79,73,50,23
135,Daniel Gare,Sabres,35,26,11,15
135,Daniel Gare,Sabres,69,77,39,38
135,Daniel Gare,Sabres,71,67,27,40
135,Daniel Gare,Sabres,76,89,56,33
135,Daniel Gare,Sabres,73,85,46,39
135,Daniel Gare,Sabres,22,21,7,14
135,Daniel Gare,Red Wings,36,22,13,9
135,Daniel Gare,Red Wings,79,61,26,35
135,Daniel Gare,Red Wings,63,26,13,13
135,Daniel Gare,Red Wings,71,56,27,29
135,Daniel Gare,Red Wings,57,16,7,9
135,Daniel Gare,Oilers,18,4,1,3
136,Rick Nash,Blue Jackets,74,39,17,22
136,Rick Nash,Blue Jackets,80,57,41,16
136,Rick Nash,Blue Jackets,54,54,31,23
136,Rick Nash,Blue Jackets,75,57,27,30
136,Rick Nash,Blue Jackets,80,69,38,31
136,Rick Nash,Blue Jackets,78,79,40,39
136,Rick Nash,Blue Jackets,76,67,33,34
136,Rick Nash,Blue Jackets,75,66,32,34
136,Rick Nash,Blue Jackets,82,59,30,29
136,Rick Nash,Rangers,44,42,21,21
136,Rick Nash,Rangers,65,39,26,13
136,Rick Nash,Rangers,22,24,16,8
137,Marian Gaborik,Wild,71,36,18,18
137,Marian Gaborik,Wild,78,67,30,37
137,Marian Gaborik,Wild,81,65,30,35
137,Marian Gaborik,Wild,65,40,18,22
137,Marian Gaborik,Wild,65,66,38,28
137,Marian Gaborik,Wild,48,57,30,27
137,Marian Gaborik,Wild,77,83,42,41
137,Marian Gaborik,Wild,17,23,13,10
137,Marian Gaborik,Rangers,76,86,42,44
137,Marian Gaborik,Rangers,62,48,22,26
137,Marian Gaborik,Rangers,82,76,41,35
137,Marian Gaborik,Rangers,35,19,9,10
137,Marian Gaborik,Blue Jackets,12,8,3,5
137,Marian Gaborik,Blue Jackets,22,14,6,8
137,Marian Gaborik,Kings,19,16,5,11
137,Marian Gaborik,Kings,15,8,4,4
138,Joe Thornton,Bruins,55,7,3,4
138,Joe Thornton,Bruins,81,41,16,25
138,Joe Thornton,Bruins,81,60,23,37
138,Joe Thornton,Bruins,72,71,37,34
138,Joe Thornton,Bruins,66,68,22,46
138,Joe Thornton,Bruins,77,101,36,65
138,Joe Thornton,Bruins,77,73,23,50
138,Joe Thornton,Bruins,23,33,9,24
138,Joe Thornton,Sharks,58,92,20,72
138,Joe Thornton,Sharks,82,114,22,92
138,Joe Thornton,Sharks,82,96,29,67
138,Joe Thornton,Sharks,82,86,25,61
138,Joe Thornton,Sharks,79,89,20,69
138,Joe Thornton,Sharks,80,70,21,49
138,Joe Thornton,Sharks,82,77,18,59
138,Joe Thornton,Sharks,48,40,7,33
138,Joe Thornton,Sharks,82,76,11,65
138,Joe Thornton,Sharks,24,20,7,13
139,Andy Bathgate,Rangers,18,1,0,1
139,Andy Bathgate,Rangers,20,4,2,2
139,Andy Bathgate,Rangers,70,40,20,20
139,Andy Bathgate,Rangers,70,66,19,47
139,Andy Bathgate,Rangers,70,77,27,50
139,Andy Bathgate,Rangers,65,78,30,48
139,Andy Bathgate,Rangers,70,88,40,48
139,Andy Bathgate,Rangers,70,74,26,48
139,Andy Bathgate,Rangers,70,77,29,48
139,Andy Bathgate,Rangers,70,84,28,56
139,Andy Bathgate,Rangers,70,81,35,46
139,Andy Bathgate,Rangers,56,59,16,43
139,Andy Bathgate,Maple Leafs,15,18,3,15
139,Andy Bathgate,Maple Leafs,55,45,16,29
139,Andy Bathgate,Red Wings,70,47,15,32
139,Andy Bathgate,Red Wings,60,31,8,23
139,Andy Bathgate,Penguins,74,59,20,39
139,Andy Bathgate,Penguins,76,44,15,29
140,Richard Macleish,Flyers,26,6,2,4
140,Richard Macleish,Flyers,17,3,1,2
140,Richard Macleish,Flyers,78,100,50,50
140,Richard Macleish,Flyers,78,77,32,45
140,Richard Macleish,Flyers,80,79,38,41
140,Richard Macleish,Flyers,51,45,22,23
140,Richard Macleish,Flyers,79,97,49,48
140,Richard Macleish,Flyers,76,70,31,39
140,Richard Macleish,Flyers,71,58,26,32
140,Richard Macleish,Flyers,78,66,31,35
140,Richard Macleish,Flyers,78,74,38,36
140,Richard Macleish,Whalers,34,22,6,16
140,Richard Macleish,Penguins,40,25,13,12
140,Richard Macleish,Penguins,6,5,0,5
140,Richard Macleish,Flyers,29,22,8,14
140,Richard Macleish,Red Wings,25,10,2,8
141,Eddie Olczyk,Blackhawks,70,50,20,30
141,Eddie Olczyk,Blackhawks,79,79,29,50
141,Eddie Olczyk,Blackhawks,79,51,16,35
141,Eddie Olczyk,Maple Leafs,80,75,42,33
141,Eddie Olczyk,Maple Leafs,80,90,38,52
141,Eddie Olczyk,Maple Leafs,79,88,32,56
141,Eddie Olczyk,Maple Leafs,18,14,4,10
141,Eddie Olczyk,Jets (1979),61,57,26,31
141,Eddie Olczyk,Jets (1979),64,65,32,33
141,Eddie Olczyk,Jets (1979),25,20,8,12
141,Eddie Olczyk,Rangers,46,29,13,16
141,Eddie Olczyk,Rangers,37,8,3,5
141,Eddie Olczyk,Rangers,20,3,2,1
141,Eddie Olczyk,Jets (1979),13,10,2,8
141,Eddie Olczyk,Jets (1979),51,49,27,22
141,Eddie Olczyk,Kings,67,44,21,23
141,Eddie Olczyk,Penguins,12,11,4,7
141,Eddie Olczyk,Penguins,56,22,11,11
141,Eddie Olczyk,Blackhawks,61,25,10,15
141,Eddie Olczyk,Blackhawks,33,4,2,2
142,Brian Rolston,Devils,40,18,7,11
142,Brian Rolston,Devils,58,24,13,11
142,Brian Rolston,Devils,81,45,18,27
142,Brian Rolston,Devils,76,30,16,14
142,Brian Rolston,Devils,82,57,24,33
142,Brian Rolston,Devils,11,4,3,1
142,Brian Rolston,Avalanche,50,18,8,10
142,Brian Rolston,Bruins,16,9,5,4
142,Brian Rolston,Bruins,77,58,19,39
142,Brian Rolston,Bruins,82,62,31,31
142,Brian Rolston,Bruins,81,59,27,32
142,Brian Rolston,Bruins,82,48,19,29
142,Brian Rolston,Wild,82,79,34,45
142,Brian Rolston,Wild,78,64,31,33
142,Brian Rolston,Wild,81,59,31,28
142,Brian Rolston,Devils,64,32,15,17
142,Brian Rolston,Devils,80,37,20,17
142,Brian Rolston,Devils,65,34,14,20
142,Brian Rolston,Islanders,49,9,4,5
142,Brian Rolston,Bruins,21,15,3,12
143,Scott Young,Whalers,7,0,0,0
143,Scott Young,Whalers,76,59,19,40
143,Scott Young,Whalers,80,64,24,40
143,Scott Young,Whalers,34,15,6,9
143,Scott Young,Penguins,43,27,11,16
143,Scott Young,Nordiques,82,60,30,30
143,Scott Young,Nordiques,76,51,26,25
143,Scott Young,Nordiques,48,39,18,21
143,Scott Young,Avalanche,81,60,21,39
143,Scott Young,Avalanche,72,37,18,19
143,Scott Young,Ducks,73,33,13,20
143,Scott Young,Blues,75,52,24,28
143,Scott Young,Blues,75,39,24,15
143,Scott Young,Blues,81,73,40,33
143,Scott Young,Blues,67,41,19,22
143,Scott Young,Stars,79,42,23,19
143,Scott Young,Stars,53,16,8,8
143,Scott Young,Blues,79,49,18,31
144,Charles Simmer,Seals,35,21,8,13
144,Charles Simmer,Seals,21,2,1,1
144,Charles Simmer,Barons,24,2,2,0
144,Charles Simmer,Kings,3,0,0,0
144,Charles Simmer,Kings,38,48,21,27
144,Charles Simmer,Kings,64,101,56,45
144,Charles Simmer,Kings,65,105,56,49
144,Charles Simmer,Kings,50,39,15,24
144,Charles Simmer,Kings,80,80,29,51
144,Charles Simmer,Kings,79,92,44,48
144,Charles Simmer,Kings,5,1,1,0
144,Charles Simmer,Bruins,63,63,33,30
144,Charles Simmer,Bruins,55,60,36,24
144,Charles Simmer,Bruins,80,69,29,40
144,Charles Simmer,Penguins,50,28,11,17
145,Adam Oates,Red Wings,38,20,9,11
145,Adam Oates,Red Wings,76,47,15,32
145,Adam Oates,Red Wings,63,54,14,40
145,Adam Oates,Red Wings,69,78,16,62
145,Adam Oates,Blues,80,102,23,79
145,Adam Oates,Blues,61,115,25,90
145,Adam Oates,Blues,54,69,10,59
145,Adam Oates,Bruins,26,30,10,20
145,Adam Oates,Bruins,84,142,45,97
145,Adam Oates,Bruins,77,112,32,80
145,Adam Oates,Bruins,48,53,12,41
145,Adam Oates,Bruins,70,92,25,67
145,Adam Oates,Bruins,63,70,18,52
145,Adam Oates,Capitals,17,12,4,8
145,Adam Oates,Capitals,82,76,18,58
145,Adam Oates,Capitals,59,54,12,42
145,Adam Oates,Capitals,82,71,15,56
145,Adam Oates,Capitals,81,82,13,69
145,Adam Oates,Capitals,66,68,11,57
145,Adam Oates,Flyers,14,10,3,7
145,Adam Oates,Ducks,67,45,9,36
145,Adam Oates,Oilers,60,18,2,16
146,Al MacInnis,Flames,2,0,0,0
146,Al MacInnis,Flames,14,4,1,3
146,Al MacInnis,Flames,51,45,11,34
146,Al MacInnis,Flames,67,66,14,52
146,Al MacInnis,Flames,77,68,11,57
146,Al MacInnis,Flames,79,76,20,56
146,Al MacInnis,Flames,80,83,25,58
146,Al MacInnis,Flames,79,74,16,58
146,Al MacInnis,Flames,79,90,28,62
146,Al MacInnis,Flames,78,103,28,75
146,Al MacInnis,Flames,72,77,20,57
146,Al MacInnis,Flames,50,54,11,43
146,Al MacInnis,Flames,75,82,28,54
146,Al MacInnis,Blues,32,28,8,20
146,Al MacInnis,Blues,82,61,17,44
146,Al MacInnis,Blues,72,43,13,30
146,Al MacInnis,Blues,71,49,19,30
146,Al MacInnis,Blues,82,62,20,42
146,Al MacInnis,Blues,61,39,11,28
146,Al MacInnis,Blues,59,54,12,42
146,Al MacInnis,Blues,71,46,11,35
146,Al MacInnis,Blues,80,68,16,52
146,Al MacInnis,Blues,3,2,0,2
147,Dave Christian,Jets (1979),15,18,8,10
147,Dave Christian,Jets (1979),80,71,28,43
147,Dave Christian,Jets (1979),80,76,25,51
147,Dave Christian,Jets (1979),55,44,18,26
147,Dave Christian,Capitals,80,81,29,52
147,Dave Christian,Capitals,80,69,26,43
147,Dave Christian,Capitals,80,83,41,42
147,Dave Christian,Capitals,76,50,23,27
147,Dave Christian,Capitals,80,58,37,21
147,Dave Christian,Capitals,80,65,34,31
147,Dave Christian,Capitals,28,11,3,8
147,Dave Christian,Bruins,50,29,12,17
147,Dave Christian,Bruins,78,53,32,21
147,Dave Christian,Blues,78,44,20,24
147,Dave Christian,Blackhawks,60,18,4,14
147,Dave Christian,Blackhawks,9,3,0,3
148,Phil Housley,Sabres,77,66,19,47
148,Phil Housley,Sabres,75,77,31,46
148,Phil Housley,Sabres,73,69,16,53
148,Phil Housley,Sabres,79,62,15,47
148,Phil Housley,Sabres,78,67,21,46
148,Phil Housley,Sabres,74,66,29,37
148,Phil Housley,Sabres,72,70,26,44
148,Phil Housley,Sabres,80,81,21,60
148,Phil Housley,Jets (1979),78,76,23,53
148,Phil Housley,Jets (1979),74,86,23,63
148,Phil Housley,Jets (1979),80,97,18,79
148,Phil Housley,Blues,26,22,7,15
148,Phil Housley,Flames,43,43,8,35
148,Phil Housley,Flames,59,52,16,36
148,Phil Housley,Devils,22,16,1,15
148,Phil Housley,Capitals,77,40,11,29
148,Phil Housley,Capitals,64,31,6,25
148,Phil Housley,Flames,79,54,11,43
148,Phil Housley,Flames,78,55,11,44
148,Phil Housley,Flames,69,34,4,30
148,Phil Housley,Blackhawks,80,39,15,24
148,Phil Housley,Blackhawks,57,29,6,23
148,Phil Housley,Maple Leafs,1,0,0,0
149,Alexei Yashin,Senators,83,79,30,49
149,Alexei Yashin,Senators,47,44,21,23
149,Alexei Yashin,Senators,46,39,15,24
149,Alexei Yashin,Senators,82,75,35,40
149,Alexei Yashin,Senators,82,72,33,39
149,Alexei Yashin,Senators,82,94,44,50
149,Alexei Yashin,Senators,82,88,40,48
149,Alexei Yashin,Islanders,78,75,32,43
149,Alexei Yashin,Islanders,81,65,26,39
149,Alexei Yashin,Islanders,47,34,15,19
149,Alexei Yashin,Islanders,82,66,28,38
149,Alexei Yashin,Islanders,58,50,18,32
150,Glen Murray,Bruins,5,4,3,1
150,Glen Murray,Bruins,27,7,3,4
150,Glen Murray,Bruins,81,31,18,13
150,Glen Murray,Bruins,35,7,5,2
150,Glen Murray,Penguins,69,29,14,15
150,Glen Murray,Penguins,66,22,11,11
150,Glen Murray,Kings,11,8,5,3
150,Glen Murray,Kings,81,60,29,31
150,Glen Murray,Kings,61,31,16,15
150,Glen Murray,Kings,78,62,29,33
150,Glen Murray,Kings,64,39,18,21
150,Glen Murray,Kings,9,11,6,5
150,Glen Murray,Bruins,73,60,35,25
150,Glen Murray,Bruins,82,92,44,48
150,Glen Murray,Bruins,81,60,32,28
150,Glen Murray,Bruins,64,53,24,29
150,Glen Murray,Bruins,59,45,28,17
150,Glen Murray,Bruins,63,30,17,13
151,Ronald Ellis,Maple Leafs,1,0,0,0
151,Ronald Ellis,Maple Leafs,62,39,23,16
151,Ronald Ellis,Maple Leafs,70,42,19,23
151,Ronald Ellis,Maple Leafs,67,45,22,23
151,Ronald Ellis,Maple Leafs,74,48,28,20
151,Ronald Ellis,Maple Leafs,72,46,25,21
151,Ronald Ellis,Maple Leafs,76,54,35,19
151,Ronald Ellis,Maple Leafs,78,53,24,29
151,Ronald Ellis,Maple Leafs,78,47,23,24
151,Ronald Ellis,Maple Leafs,78,51,22,29
151,Ronald Ellis,Maple Leafs,70,48,23,25
151,Ronald Ellis,Maple Leafs,79,61,32,29
151,Ronald Ellis,Maple Leafs,80,50,26,24
151,Ronald Ellis,Maple Leafs,63,28,16,12
151,Ronald Ellis,Maple Leafs,59,23,12,11
151,Ronald Ellis,Maple Leafs,27,5,2,3
152,Wendel Clark,Maple Leafs,66,45,34,11
152,Wendel Clark,Maple Leafs,80,60,37,23
152,Wendel Clark,Maple Leafs,28,23,12,11
152,Wendel Clark,Maple Leafs,15,11,7,4
152,Wendel Clark,Maple Leafs,38,26,18,8
152,Wendel Clark,Maple Leafs,63,34,18,16
152,Wendel Clark,Maple Leafs,43,40,19,21
152,Wendel Clark,Maple Leafs,66,39,17,22
152,Wendel Clark,Maple Leafs,64,76,46,30
152,Wendel Clark,Nordiques,37,30,12,18
152,Wendel Clark,Islanders,58,43,24,19
152,Wendel Clark,Maple Leafs,13,15,8,7
152,Wendel Clark,Maple Leafs,65,49,30,19
152,Wendel Clark,Maple Leafs,47,19,12,7
152,Wendel Clark,Lightning,65,42,28,14
152,Wendel Clark,Red Wings,12,6,4,2
152,Wendel Clark,Blackhawks,13,2,2,0
152,Wendel Clark,Maple Leafs,20,4,2,2
153,Kevin Stevens,Penguins,16,7,5,2
153,Kevin Stevens,Penguins,24,15,12,3
153,Kevin Stevens,Penguins,76,70,29,41
153,Kevin Stevens,Penguins,80,86,40,46
153,Kevin Stevens,Penguins,80,123,54,69
153,Kevin Stevens,Penguins,72,111,55,56
153,Kevin Stevens,Penguins,83,88,41,47
153,Kevin Stevens,Penguins,27,27,15,12
153,Kevin Stevens,Bruins,41,23,10,13
153,Kevin Stevens,Kings,20,13,3,10
153,Kevin Stevens,Kings,69,34,14,20
153,Kevin Stevens,Rangers,80,41,14,27
153,Kevin Stevens,Rangers,81,43,23,20
153,Kevin Stevens,Rangers,38,8,3,5
153,Kevin Stevens,Flyers,23,9,2,7
153,Kevin Stevens,Penguins,32,23,8,15
153,Kevin Stevens,Penguins,32,5,1,4
154,Ziggy Palffy,Islanders,5,0,0,0
154,Ziggy Palffy,Islanders,33,17,10,7
154,Ziggy Palffy,Islanders,81,87,43,44
154,Ziggy Palffy,Islanders,80,90,48,42
154,Ziggy Palffy,Islanders,82,87,45,42
154,Ziggy Palffy,Islanders,50,50,22,28
154,Ziggy Palffy,Kings,64,66,27,39
154,Ziggy Palffy,Kings,73,89,38,51
154,Ziggy Palffy,Kings,63,59,32,27
154,Ziggy Palffy,Kings,76,85,37,48
154,Ziggy Palffy,Kings,35,41,16,25
154,Ziggy Palffy,Penguins,42,42,11,31
155,Michael Bullard,Penguins,15,3,1,2
155,Michael Bullard,Penguins,75,63,36,27
155,Michael Bullard,Penguins,57,44,22,22
155,Michael Bullard,Penguins,76,92,51,41
155,Michael Bullard,Penguins,68,63,32,31
155,Michael Bullard,Penguins,77,83,41,42
155,Michael Bullard,Penguins,14,12,2,10
155,Michael Bullard,Flames,57,54,28,26
155,Michael Bullard,Flames,79,103,48,55
155,Michael Bullard,Blues,20,16,4,12
155,Michael Bullard,Flyers,54,49,23,26
155,Michael Bullard,Flyers,70,64,27,37
155,Michael Bullard,Maple Leafs,65,28,14,14
156,Adam Graves,Red Wings,9,1,0,1
156,Adam Graves,Red Wings,56,12,7,5
156,Adam Graves,Red Wings,13,1,0,1
156,Adam Graves,Oilers,63,21,9,12
156,Adam Graves,Oilers,76,25,7,18
156,Adam Graves,Rangers,80,59,26,33
156,Adam Graves,Rangers,84,65,36,29
156,Adam Graves,Rangers,84,79,52,27
156,Adam Graves,Rangers,47,31,17,14
156,Adam Graves,Rangers,82,58,22,36
156,Adam Graves,Rangers,82,61,33,28
156,Adam Graves,Rangers,72,35,23,12
156,Adam Graves,Rangers,82,53,38,15
156,Adam Graves,Rangers,77,40,23,17
156,Adam Graves,Rangers,82,26,10,16
156,Adam Graves,Sharks,81,31,17,14
156,Adam Graves,Sharks,82,18,9,9
157,Ken Hodge,Blackhawks,1,0,0,0
157,Ken Hodge,Blackhawks,63,23,6,17
157,Ken Hodge,Blackhawks,69,35,10,25
157,Ken Hodge,Bruins,74,56,25,31
157,Ken Hodge,Bruins,75,90,45,45
157,Ken Hodge,Bruins,72,54,25,29
157,Ken Hodge,Bruins,78,105,43,62
157,Ken Hodge,Bruins,60,56,16,40
157,Ken Hodge,Bruins,73,81,37,44
157,Ken Hodge,Bruins,76,105,50,55
157,Ken Hodge,Bruins,72,66,23,43
157,Ken Hodge,Bruins,72,61,25,36
157,Ken Hodge,Rangers,78,62,21,41
157,Ken Hodge,Rangers,18,6,2,4
158,Bobby Holik,Whalers,78,43,21,22
158,Bobby Holik,Whalers,76,45,21,24
158,Bobby Holik,Devils,61,39,20,19
158,Bobby Holik,Devils,70,33,13,20
158,Bobby Holik,Devils,48,20,10,10
158,Bobby Holik,Devils,63,30,13,17
158,Bobby Holik,Devils,82,62,23,39
158,Bobby Holik,Devils,82,65,29,36
158,Bobby Holik,Devils,78,64,27,37
158,Bobby Holik,Devils,79,46,23,23
158,Bobby Holik,Devils,80,50,15,35
158,Bobby Holik,Devils,81,54,25,29
158,Bobby Holik,Rangers,64,35,16,19
158,Bobby Holik,Rangers,82,56,25,31
158,Bobby Holik,Thrashers,64,33,15,18
158,Bobby Holik,Thrashers,82,29,11,18
158,Bobby Holik,Thrashers,82,34,15,19
158,Bobby Holik,Devils,62,9,4,5
159,John Tonelli,Islanders,73,56,17,39
159,John Tonelli,Islanders,77,44,14,30
159,John Tonelli,Islanders,70,52,20,32
159,John Tonelli,Islanders,80,93,35,58
159,John Tonelli,Islanders,76,71,31,40
159,John Tonelli,Islanders,73,67,27,40
159,John Tonelli,Islanders,80,100,42,58
159,John Tonelli,Islanders,65,61,20,41
159,John Tonelli,Flames,9,7,3,4
159,John Tonelli,Flames,78,51,20,31
159,John Tonelli,Flames,74,58,17,41
159,John Tonelli,Kings,77,64,31,33
159,John Tonelli,Kings,73,68,31,37
159,John Tonelli,Kings,71,30,14,16
159,John Tonelli,Blackhawks,33,8,1,7
159,John Tonelli,Nordiques,19,6,2,4
160,Pit Martin,Red Wings,1,1,0,1
160,Pit Martin,Red Wings,50,21,9,12
160,Pit Martin,Red Wings,58,17,8,9
160,Pit Martin,Red Wings,10,2,1,1
160,Pit Martin,Bruins,41,27,16,11
160,Pit Martin,Bruins,70,42,20,22
160,Pit Martin,Blackhawks,63,35,16,19
160,Pit Martin,Blackhawks,76,61,23,38
160,Pit Martin,Blackhawks,73,63,30,33
160,Pit Martin,Blackhawks,62,55,22,33
160,Pit Martin,Blackhawks,78,75,24,51
160,Pit Martin,Blackhawks,78,90,29,61
160,Pit Martin,Blackhawks,78,77,30,47
160,Pit Martin,Blackhawks,70,45,19,26
160,Pit Martin,Blackhawks,80,71,32,39
160,Pit Martin,Blackhawks,75,53,17,36
160,Pit Martin,Blackhawks,7,2,1,1
160,Pit Martin,Canucks,67,46,15,31
160,Pit Martin,Canucks,64,26,12,14
161,Paul MacLean,Blues,1,0,0,0
161,Paul MacLean,Jets (1979),74,61,36,25
161,Paul MacLean,Jets (1979),80,76,32,44
161,Paul MacLean,Jets (1979),76,71,40,31
161,Paul MacLean,Jets (1979),79,101,41,60
161,Paul MacLean,Jets (1979),69,56,27,29
161,Paul MacLean,Jets (1979),72,74,32,42
161,Paul MacLean,Jets (1979),77,79,40,39
161,Paul MacLean,Red Wings,76,71,36,35
161,Paul MacLean,Blues,78,67,34,33
161,Paul MacLean,Blues,37,17,6,11
162,Nels Stewart,Maroons,36,42,34,8
162,Nels Stewart,Maroons,43,21,17,4
162,Nels Stewart,Maroons,41,34,27,7
162,Nels Stewart,Maroons,44,29,21,8
162,Nels Stewart,Maroons,44,55,39,16
162,Nels Stewart,Maroons,42,39,25,14
162,Nels Stewart,Maroons,38,33,22,11
162,Nels Stewart,Bruins,47,36,18,18
162,Nels Stewart,Bruins,48,39,22,17
162,Nels Stewart,Bruins,47,39,21,18
162,Nels Stewart,Americans,48,29,14,15
162,Nels Stewart,Bruins,11,5,3,2
162,Nels Stewart,Americans,32,30,20,10
162,Nels Stewart,Americans,48,36,19,17
162,Nels Stewart,Americans,46,35,16,19
162,Nels Stewart,Americans,35,13,6,7
163,Dale Hunter,Nordiques,80,63,19,44
163,Dale Hunter,Nordiques,80,72,22,50
163,Dale Hunter,Nordiques,80,63,17,46
163,Dale Hunter,Nordiques,77,79,24,55
163,Dale Hunter,Nordiques,80,72,20,52
163,Dale Hunter,Nordiques,80,70,28,42
163,Dale Hunter,Nordiques,46,39,10,29
163,Dale Hunter,Capitals,79,59,22,37
163,Dale Hunter,Capitals,80,57,20,37
163,Dale Hunter,Capitals,80,62,23,39
163,Dale Hunter,Capitals,76,46,16,30
163,Dale Hunter,Capitals,80,78,28,50
163,Dale Hunter,Capitals,84,79,20,59
163,Dale Hunter,Capitals,52,38,9,29
163,Dale Hunter,Capitals,45,23,8,15
163,Dale Hunter,Capitals,82,37,13,24
163,Dale Hunter,Capitals,82,46,14,32
163,Dale Hunter,Capitals,82,26,8,18
163,Dale Hunter,Capitals,50,5,0,5
163,Dale Hunter,Avalanche,12,6,2,4
164,Petr Sykora,Devils,63,42,18,24
164,Petr Sykora,Devils,19,3,1,2
164,Petr Sykora,Devils,58,36,16,20
164,Petr Sykora,Devils,80,72,29,43
164,Petr Sykora,Devils,79,68,25,43
164,Petr Sykora,Devils,73,81,35,46
164,Petr Sykora,Devils,73,48,21,27
164,Petr Sykora,Ducks,82,59,34,25
164,Petr Sykora,Ducks,81,52,23,29
164,Petr Sykora,Ducks,34,20,7,13
164,Petr Sykora,Rangers,40,31,16,15
164,Petr Sykora,Oilers,82,53,22,31
164,Petr Sykora,Penguins,81,63,28,35
164,Petr Sykora,Penguins,76,46,25,21
164,Petr Sykora,Wild,14,3,2,1
164,Petr Sykora,Devils,82,44,21,23
165,Vic Hadfield,Rangers,44,4,3,1
165,Vic Hadfield,Rangers,36,11,5,6
165,Vic Hadfield,Rangers,69,25,14,11
165,Vic Hadfield,Rangers,70,38,18,20
165,Vic Hadfield,Rangers,67,35,16,19
165,Vic Hadfield,Rangers,69,33,13,20
165,Vic Hadfield,Rangers,59,39,20,19
165,Vic Hadfield,Rangers,73,66,26,40
165,Vic Hadfield,Rangers,71,54,20,34
165,Vic Hadfield,Rangers,63,44,22,22
165,Vic Hadfield,Rangers,78,106,50,56
165,Vic Hadfield,Rangers,63,62,28,34
165,Vic Hadfield,Rangers,77,55,27,28
165,Vic Hadfield,Penguins,78,73,31,42
165,Vic Hadfield,Penguins,76,65,30,35
165,Vic Hadfield,Penguins,9,2,0,2
166,Bobby Carpenter,Capitals,80,67,32,35
166,Bobby Carpenter,Capitals,80,69,32,37
166,Bobby Carpenter,Capitals,80,68,28,40
166,Bobby Carpenter,Capitals,80,95,53,42
166,Bobby Carpenter,Capitals,80,56,27,29
166,Bobby Carpenter,Capitals,22,12,5,7
166,Bobby Carpenter,Rangers,28,10,2,8
166,Bobby Carpenter,Kings,10,5,2,3
166,Bobby Carpenter,Kings,71,52,19,33
166,Bobby Carpenter,Kings,39,26,11,15
166,Bobby Carpenter,Bruins,18,14,5,9
166,Bobby Carpenter,Bruins,80,56,25,31
166,Bobby Carpenter,Bruins,29,16,8,8
166,Bobby Carpenter,Bruins,60,48,25,23
166,Bobby Carpenter,Capitals,68,28,11,17
166,Bobby Carpenter,Devils,76,33,10,23
166,Bobby Carpenter,Devils,41,16,5,11
166,Bobby Carpenter,Devils,52,10,5,5
166,Bobby Carpenter,Devils,62,19,4,15
166,Bobby Carpenter,Devils,66,18,9,9
166,Bobby Carpenter,Devils,56,10,2,8
167,Tony McKegney,Sabres,52,22,8,14
167,Tony McKegney,Sabres,80,52,23,29
167,Tony McKegney,Sabres,80,69,37,32
167,Tony McKegney,Sabres,73,52,23,29
167,Tony McKegney,Sabres,78,73,36,37
167,Tony McKegney,Nordiques,75,51,24,27
167,Tony McKegney,Nordiques,30,21,12,9
167,Tony McKegney,North Stars,27,24,11,13
167,Tony McKegney,North Stars,70,40,15,25
167,Tony McKegney,North Stars,11,5,2,3
167,Tony McKegney,Rangers,64,46,29,17
167,Tony McKegney,Blues,80,78,40,38
167,Tony McKegney,Blues,71,42,25,17
167,Tony McKegney,Red Wings,14,3,2,1
167,Tony McKegney,Nordiques,48,27,16,11
167,Tony McKegney,Nordiques,50,33,17,16
167,Tony McKegney,Blackhawks,9,1,0,1
168,Clark Gillies,Islanders,80,47,25,22
168,Clark Gillies,Islanders,80,61,34,27
168,Clark Gillies,Islanders,70,55,33,22
168,Clark Gillies,Islanders,80,85,35,50
168,Clark Gillies,Islanders,75,91,35,56
168,Clark Gillies,Islanders,73,54,19,35
168,Clark Gillies,Islanders,80,78,33,45
168,Clark Gillies,Islanders,79,77,38,39
168,Clark Gillies,Islanders,70,41,21,20
168,Clark Gillies,Islanders,76,28,12,16
168,Clark Gillies,Islanders,54,32,15,17
168,Clark Gillies,Islanders,55,14,4,10
168,Clark Gillies,Sabres,61,27,10,17
168,Clark Gillies,Sabres,25,7,5,2
169,Olli Jokinen,Kings,8,0,0,0
169,Olli Jokinen,Kings,66,21,9,12
169,Olli Jokinen,Islanders,82,21,11,10
169,Olli Jokinen,Panthers,78,16,6,10
169,Olli Jokinen,Panthers,80,29,9,20
169,Olli Jokinen,Panthers,81,65,36,29
169,Olli Jokinen,Panthers,82,58,26,32
169,Olli Jokinen,Panthers,82,89,38,51
169,Olli Jokinen,Panthers,82,91,39,52
169,Olli Jokinen,Panthers,82,71,34,37
169,Olli Jokinen,Coyotes,57,42,21,21
169,Olli Jokinen,Flames,19,15,8,7
169,Olli Jokinen,Flames,56,35,11,24
169,Olli Jokinen,Rangers,26,15,4,11
169,Olli Jokinen,Flames,79,54,17,37
169,Olli Jokinen,Flames,82,61,23,38
169,Olli Jokinen,Jets,45,14,7,7
169,Olli Jokinen,Jets,82,43,18,25
169,Olli Jokinen,Predators,22,1,1,0
170,Dave Gagner,Rangers,38,12,6,6
170,Dave Gagner,Rangers,32,10,4,6
170,Dave Gagner,Rangers,10,5,1,4
170,Dave Gagner,North Stars,51,19,8,11
170,Dave Gagner,North Stars,75,78,35,43
170,Dave Gagner,North Stars,79,78,40,38
170,Dave Gagner,North Stars,73,82,40,42
170,Dave Gagner,North Stars,78,71,31,40
170,Dave Gagner,North Stars,84,76,33,43
170,Dave Gagner,Stars,76,61,32,29
170,Dave Gagner,Stars,48,42,14,28
170,Dave Gagner,Stars,45,27,14,13
170,Dave Gagner,Maple Leafs,28,22,7,15
170,Dave Gagner,Flames,82,60,27,33
170,Dave Gagner,Panthers,78,48,20,28
170,Dave Gagner,Panthers,36,14,4,10
170,Dave Gagner,Canucks,33,14,2,12
171,Todd Bertuzzi,Islanders,76,39,18,21
171,Todd Bertuzzi,Islanders,64,23,10,13
171,Todd Bertuzzi,Islanders,52,18,7,11
171,Todd Bertuzzi,Canucks,22,15,6,9
171,Todd Bertuzzi,Canucks,32,16,8,8
171,Todd Bertuzzi,Canucks,80,50,25,25
171,Todd Bertuzzi,Canucks,79,55,25,30
171,Todd Bertuzzi,Canucks,72,85,36,49
171,Todd Bertuzzi,Canucks,82,97,46,51
171,Todd Bertuzzi,Canucks,69,60,17,43
171,Todd Bertuzzi,Canucks,82,71,25,46
171,Todd Bertuzzi,Panthers,7,7,1,6
171,Todd Bertuzzi,Red Wings,8,4,2,2
171,Todd Bertuzzi,Ducks,68,40,14,26
171,Todd Bertuzzi,Flames,66,44,15,29
171,Todd Bertuzzi,Red Wings,82,44,18,26
171,Todd Bertuzzi,Red Wings,81,45,16,29
171,Todd Bertuzzi,Red Wings,71,38,14,24
171,Todd Bertuzzi,Red Wings,7,3,2,1
171,Todd Bertuzzi,Red Wings,59,16,9,7
172,Donald Lever,Canucks,78,38,12,26
172,Donald Lever,Canucks,78,48,23,25
172,Donald Lever,Canucks,80,68,38,30
172,Donald Lever,Canucks,80,65,25,40
172,Donald Lever,Canucks,80,57,27,30
172,Donald Lever,Canucks,75,49,17,32
172,Donald Lever,Canucks,71,44,23,21
172,Donald Lever,Canucks,51,38,21,17
172,Donald Lever,Flames,28,30,14,16
172,Donald Lever,Flames,62,57,26,31
172,Donald Lever,Flames,23,19,8,11
172,Donald Lever,Rockies,59,50,22,28
172,Donald Lever,Devils,79,53,23,30
172,Donald Lever,Devils,70,33,14,19
172,Donald Lever,Devils,67,18,10,8
172,Donald Lever,Sabres,29,8,7,1
172,Donald Lever,Sabres,10,5,3,2
173,Petr Klima,Red Wings,74,56,32,24
173,Petr Klima,Red Wings,77,53,30,23
173,Petr Klima,Red Wings,78,62,37,25
173,Petr Klima,Red Wings,51,41,25,16
173,Petr Klima,Red Wings,13,10,5,5
173,Petr Klima,Oilers,63,53,25,28
173,Petr Klima,Oilers,70,68,40,28
173,Petr Klima,Oilers,57,34,21,13
173,Petr Klima,Oilers,68,48,32,16
173,Petr Klima,Lightning,75,55,28,27
173,Petr Klima,Lightning,47,26,13,13
173,Petr Klima,Lightning,67,52,22,30
173,Petr Klima,Kings,8,4,0,4
173,Petr Klima,Penguins,9,4,1,3
173,Petr Klima,Oilers,16,6,1,5
173,Petr Klima,Red Wings,13,1,1,0
174,Daniel Sedin,Canucks,75,34,20,14
174,Daniel Sedin,Canucks,79,32,9,23
174,Daniel Sedin,Canucks,79,31,14,17
174,Daniel Sedin,Canucks,82,54,18,36
174,Daniel Sedin,Canucks,82,71,22,49
174,Daniel Sedin,Canucks,81,84,36,48
174,Daniel Sedin,Canucks,82,74,29,45
174,Daniel Sedin,Canucks,82,82,31,51
174,Daniel Sedin,Canucks,63,85,29,56
174,Daniel Sedin,Canucks,82,104,41,63
174,Daniel Sedin,Canucks,72,67,30,37
174,Daniel Sedin,Canucks,47,40,12,28
174,Daniel Sedin,Canucks,73,47,16,31
174,Daniel Sedin,Canucks,23,21,4,17
175,Denis Potvin,Islanders,77,54,17,37
175,Denis Potvin,Islanders,79,76,21,55
175,Denis Potvin,Islanders,78,98,31,67
175,Denis Potvin,Islanders,80,80,25,55
175,Denis Potvin,Islanders,80,94,30,64
175,Denis Potvin,Islanders,73,101,31,70
175,Denis Potvin,Islanders,31,41,8,33
175,Denis Potvin,Islanders,74,76,20,56
175,Denis Potvin,Islanders,60,61,24,37
175,Denis Potvin,Islanders,69,66,12,54
175,Denis Potvin,Islanders,78,85,22,63
175,Denis Potvin,Islanders,77,68,17,51
175,Denis Potvin,Islanders,74,59,21,38
175,Denis Potvin,Islanders,58,42,12,30
175,Denis Potvin,Islanders,72,51,19,32
176,Petr Nedved,Canucks,61,16,10,6
176,Petr Nedved,Canucks,77,37,15,22
176,Petr Nedved,Canucks,84,71,38,33
176,Petr Nedved,Blues,19,20,6,14
176,Petr Nedved,Rangers,46,23,11,12
176,Petr Nedved,Penguins,80,99,45,54
176,Petr Nedved,Penguins,74,71,33,38
176,Petr Nedved,Rangers,56,47,20,27
176,Petr Nedved,Rangers,76,68,24,44
176,Petr Nedved,Rangers,79,78,32,46
176,Petr Nedved,Rangers,78,46,21,25
176,Petr Nedved,Rangers,78,58,27,31
176,Petr Nedved,Rangers,65,31,14,17
176,Petr Nedved,Oilers,16,15,5,10
176,Petr Nedved,Coyotes,25,11,2,9
176,Petr Nedved,Flyers,28,14,5,9
176,Petr Nedved,Flyers,21,7,1,6
176,Petr Nedved,Oilers,19,5,1,4
177,Martin Gelinas,Oilers,6,3,1,2
177,Martin Gelinas,Oilers,46,25,17,8
177,Martin Gelinas,Oilers,73,40,20,20
177,Martin Gelinas,Oilers,68,29,11,18
177,Martin Gelinas,Oilers,65,23,11,12
177,Martin Gelinas,Nordiques,31,12,6,6
177,Martin Gelinas,Canucks,33,16,8,8
177,Martin Gelinas,Canucks,46,23,13,10
177,Martin Gelinas,Canucks,81,56,30,26
177,Martin Gelinas,Canucks,74,68,35,33
177,Martin Gelinas,Canucks,24,8,4,4
177,Martin Gelinas,Hurricanes,40,26,12,14
177,Martin Gelinas,Hurricanes,76,28,13,15
177,Martin Gelinas,Hurricanes,81,30,14,16
177,Martin Gelinas,Hurricanes,79,52,23,29
177,Martin Gelinas,Hurricanes,72,29,13,16
177,Martin Gelinas,Flames,81,52,21,31
177,Martin Gelinas,Flames,76,35,17,18
177,Martin Gelinas,Panthers,82,41,17,24
177,Martin Gelinas,Panthers,82,44,14,30
177,Martin Gelinas,Predators,57,20,9,11
178,Bob Nevin,Maple Leafs,4,0,0,0
178,Bob Nevin,Maple Leafs,2,0,0,0
178,Bob Nevin,Maple Leafs,68,58,21,37
178,Bob Nevin,Maple Leafs,69,45,15,30
178,Bob Nevin,Maple Leafs,58,33,12,21
178,Bob Nevin,Maple Leafs,49,19,7,12
178,Bob Nevin,Rangers,14,9,5,4
178,Bob Nevin,Rangers,64,30,16,14
178,Bob Nevin,Rangers,69,62,29,33
178,Bob Nevin,Rangers,67,44,20,24
178,Bob Nevin,Rangers,74,58,28,30
178,Bob Nevin,Rangers,71,56,31,25
178,Bob Nevin,Rangers,68,37,18,19
178,Bob Nevin,Rangers,78,46,21,25
178,Bob Nevin,North Stars,72,34,15,19
178,Bob Nevin,North Stars,66,18,5,13
178,Bob Nevin,Kings,78,50,20,30
178,Bob Nevin,Kings,80,72,31,41
178,Bob Nevin,Kings,77,55,13,42
179,Cliff Ronning,Blues,42,25,11,14
179,Cliff Ronning,Blues,26,13,5,8
179,Cliff Ronning,Blues,64,55,24,31
179,Cliff Ronning,Blues,48,32,14,18
179,Cliff Ronning,Canucks,11,12,6,6
179,Cliff Ronning,Canucks,80,71,24,47
179,Cliff Ronning,Canucks,79,85,29,56
179,Cliff Ronning,Canucks,76,68,25,43
179,Cliff Ronning,Canucks,41,25,6,19
179,Cliff Ronning,Canucks,79,67,22,45
179,Cliff Ronning,Coyotes,69,51,19,32
179,Cliff Ronning,Coyotes,80,55,11,44
179,Cliff Ronning,Coyotes,7,7,2,5
179,Cliff Ronning,Predators,72,53,18,35
179,Cliff Ronning,Predators,82,62,26,36
179,Cliff Ronning,Predators,80,62,19,43
179,Cliff Ronning,Predators,67,49,18,31
179,Cliff Ronning,Kings,14,5,1,4
179,Cliff Ronning,Wild,80,48,17,31
179,Cliff Ronning,Islanders,40,24,9,15
180,Pavol Demitra,Senators,12,2,1,1
180,Pavol Demitra,Senators,16,7,4,3
180,Pavol Demitra,Senators,31,17,7,10
180,Pavol Demitra,Blues,8,3,3,0
180,Pavol Demitra,Blues,61,52,22,30
180,Pavol Demitra,Blues,82,89,37,52
180,Pavol Demitra,Blues,71,75,28,47
180,Pavol Demitra,Blues,44,45,20,25
180,Pavol Demitra,Blues,82,78,35,43
180,Pavol Demitra,Blues,78,93,36,57
180,Pavol Demitra,Blues,68,58,23,35
180,Pavol Demitra,Kings,58,62,25,37
180,Pavol Demitra,Wild,71,64,25,39
180,Pavol Demitra,Wild,68,54,15,39
180,Pavol Demitra,Canucks,69,53,20,33
180,Pavol Demitra,Canucks,28,16,3,13
181,Daniel Briere,Coyotes,5,1,1,0
181,Daniel Briere,Coyotes,64,22,8,14
181,Daniel Briere,Coyotes,13,2,1,1
181,Daniel Briere,Coyotes,30,15,11,4
181,Daniel Briere,Coyotes,78,60,32,28
181,Daniel Briere,Coyotes,68,46,17,29
181,Daniel Briere,Sabres,14,12,7,5
181,Daniel Briere,Sabres,82,65,28,37
181,Daniel Briere,Sabres,48,58,25,33
181,Daniel Briere,Sabres,81,95,32,63
181,Daniel Briere,Flyers,79,72,31,41
181,Daniel Briere,Flyers,29,25,11,14
181,Daniel Briere,Flyers,75,53,26,27
181,Daniel Briere,Flyers,77,68,34,34
181,Daniel Briere,Flyers,70,49,16,33
181,Daniel Briere,Flyers,34,16,6,10
181,Daniel Briere,Canadiens,69,25,13,12
181,Daniel Briere,Avalanche,16,5,4,1
182,Dennis Hull,Blackhawks,55,14,10,4
182,Dennis Hull,Blackhawks,25,6,1,5
182,Dennis Hull,Blackhawks,70,42,25,17
182,Dennis Hull,Blackhawks,74,33,18,15
182,Dennis Hull,Blackhawks,72,64,30,34
182,Dennis Hull,Blackhawks,76,52,17,35
182,Dennis Hull,Blackhawks,78,66,40,26
182,Dennis Hull,Blackhawks,78,69,30,39
182,Dennis Hull,Blackhawks,78,90,39,51
182,Dennis Hull,Blackhawks,74,68,29,39
182,Dennis Hull,Blackhawks,69,37,16,21
182,Dennis Hull,Blackhawks,80,66,27,39
182,Dennis Hull,Blackhawks,75,33,16,17
182,Dennis Hull,Red Wings,55,14,5,9
183,Brian Sutter,Blues,35,14,4,10
183,Brian Sutter,Blues,78,22,9,13
183,Brian Sutter,Blues,77,80,41,39
183,Brian Sutter,Blues,71,58,23,35
183,Brian Sutter,Blues,78,69,35,34
183,Brian Sutter,Blues,74,75,39,36
183,Brian Sutter,Blues,79,76,46,30
183,Brian Sutter,Blues,76,83,32,51
183,Brian Sutter,Blues,77,74,37,37
183,Brian Sutter,Blues,44,42,19,23
183,Brian Sutter,Blues,14,6,3,3
183,Brian Sutter,Blues,76,37,15,22
184,Ulf Dahlen,Rangers,70,52,29,23
184,Ulf Dahlen,Rangers,56,43,24,19
184,Ulf Dahlen,Rangers,63,36,18,18
184,Ulf Dahlen,North Stars,13,6,2,4
184,Ulf Dahlen,North Stars,66,39,21,18
184,Ulf Dahlen,North Stars,79,66,36,30
184,Ulf Dahlen,North Stars,83,74,35,39
184,Ulf Dahlen,Stars,65,57,19,38
184,Ulf Dahlen,Sharks,13,12,6,6
184,Ulf Dahlen,Sharks,46,34,11,23
184,Ulf Dahlen,Sharks,59,28,16,12
184,Ulf Dahlen,Sharks,43,19,8,11
184,Ulf Dahlen,Blackhawks,30,14,6,8
184,Ulf Dahlen,Capitals,75,38,15,23
184,Ulf Dahlen,Capitals,73,48,15,33
184,Ulf Dahlen,Capitals,69,52,23,29
184,Ulf Dahlen,Stars,63,37,17,20
185,Russ Courtnall,Maple Leafs,14,12,3,9
185,Russ Courtnall,Maple Leafs,69,22,12,10
185,Russ Courtnall,Maple Leafs,73,60,22,38
185,Russ Courtnall,Maple Leafs,79,73,29,44
185,Russ Courtnall,Maple Leafs,65,49,23,26
185,Russ Courtnall,Maple Leafs,9,2,1,1
185,Russ Courtnall,Canadiens,64,39,22,17
185,Russ Courtnall,Canadiens,80,59,27,32
185,Russ Courtnall,Canadiens,79,76,26,50
185,Russ Courtnall,Canadiens,27,21,7,14
185,Russ Courtnall,North Stars,84,79,36,43
185,Russ Courtnall,Stars,84,80,23,57
185,Russ Courtnall,Stars,32,17,7,10
185,Russ Courtnall,Canucks,13,18,4,14
185,Russ Courtnall,Canucks,81,65,26,39
185,Russ Courtnall,Canucks,47,28,9,19
185,Russ Courtnall,Rangers,14,7,2,5
185,Russ Courtnall,Kings,58,18,12,6
185,Russ Courtnall,Kings,57,19,6,13
186,George Armstrong,Maple Leafs,2,0,0,0
186,George Armstrong,Maple Leafs,20,6,3,3
186,George Armstrong,Maple Leafs,52,25,14,11
186,George Armstrong,Maple Leafs,63,32,17,15
186,George Armstrong,Maple Leafs,66,28,10,18
186,George Armstrong,Maple Leafs,67,48,16,32
186,George Armstrong,Maple Leafs,54,44,18,26
186,George Armstrong,Maple Leafs,59,42,17,25
186,George Armstrong,Maple Leafs,59,36,20,16
186,George Armstrong,Maple Leafs,70,51,23,28
186,George Armstrong,Maple Leafs,47,33,14,19
186,George Armstrong,Maple Leafs,70,53,21,32
186,George Armstrong,Maple Leafs,70,43,19,24
186,George Armstrong,Maple Leafs,66,37,20,17
186,George Armstrong,Maple Leafs,59,37,15,22
186,George Armstrong,Maple Leafs,70,51,16,35
186,George Armstrong,Maple Leafs,70,33,9,24
186,George Armstrong,Maple Leafs,62,34,13,21
186,George Armstrong,Maple Leafs,53,27,11,16
186,George Armstrong,Maple Leafs,49,28,13,15
186,George Armstrong,Maple Leafs,59,25,7,18
187,Eric Staal,Hurricanes,81,31,11,20
187,Eric Staal,Hurricanes,82,100,45,55
187,Eric Staal,Hurricanes,82,70,30,40
187,Eric Staal,Hurricanes,82,82,38,44
187,Eric Staal,Hurricanes,82,75,40,35
187,Eric Staal,Hurricanes,70,70,29,41
187,Eric Staal,Hurricanes,81,76,33,43
187,Eric Staal,Hurricanes,82,70,24,46
187,Eric Staal,Hurricanes,48,53,18,35
187,Eric Staal,Hurricanes,79,61,21,40
187,Eric Staal,Hurricanes,17,14,6,8
188,Thomas Lysiak,Flames,77,64,19,45
188,Thomas Lysiak,Flames,77,77,25,52
188,Thomas Lysiak,Flames,80,82,31,51
188,Thomas Lysiak,Flames,79,81,30,51
188,Thomas Lysiak,Flames,80,69,27,42
188,Thomas Lysiak,Flames,52,58,23,35
188,Thomas Lysiak,Blackhawks,14,10,0,10
188,Thomas Lysiak,Blackhawks,77,69,26,43
188,Thomas Lysiak,Blackhawks,72,76,21,55
188,Thomas Lysiak,Blackhawks,71,82,32,50
188,Thomas Lysiak,Blackhawks,61,61,23,38
188,Thomas Lysiak,Blackhawks,54,47,17,30
188,Thomas Lysiak,Blackhawks,74,46,16,30
188,Thomas Lysiak,Blackhawks,51,21,2,19
189,Mike Ridley,Rangers,80,65,22,43
189,Mike Ridley,Rangers,38,36,16,20
189,Mike Ridley,Capitals,40,34,15,19
189,Mike Ridley,Capitals,70,59,28,31
189,Mike Ridley,Capitals,80,89,41,48
189,Mike Ridley,Capitals,74,73,30,43
189,Mike Ridley,Capitals,79,71,23,48
189,Mike Ridley,Capitals,80,69,29,40
189,Mike Ridley,Capitals,84,82,26,56
189,Mike Ridley,Capitals,81,70,26,44
189,Mike Ridley,Maple Leafs,48,37,10,27
189,Mike Ridley,Canucks,37,21,6,15
189,Mike Ridley,Canucks,75,52,20,32
190,Steve Sullivan,Devils,16,9,5,4
190,Steve Sullivan,Devils,33,22,8,14
190,Steve Sullivan,Maple Leafs,21,16,5,11
190,Steve Sullivan,Maple Leafs,63,28,10,18
190,Steve Sullivan,Maple Leafs,63,40,20,20
190,Steve Sullivan,Maple Leafs,7,1,0,1
190,Steve Sullivan,Blackhawks,73,64,22,42
190,Steve Sullivan,Blackhawks,81,75,34,41
190,Steve Sullivan,Blackhawks,78,60,21,39
190,Steve Sullivan,Blackhawks,82,61,26,35
190,Steve Sullivan,Blackhawks,56,43,15,28
190,Steve Sullivan,Predators,24,30,9,21
190,Steve Sullivan,Predators,69,68,31,37
190,Steve Sullivan,Predators,57,60,22,38
190,Steve Sullivan,Predators,41,32,11,21
190,Steve Sullivan,Predators,82,51,17,34
190,Steve Sullivan,Predators,44,22,10,12
190,Steve Sullivan,Penguins,79,48,17,31
190,Steve Sullivan,Coyotes,33,12,5,7
190,Steve Sullivan,Devils,9,5,2,3
191,Neal Broten,North Stars,3,2,2,0
191,Neal Broten,North Stars,73,98,38,60
191,Neal Broten,North Stars,79,77,32,45
191,Neal Broten,North Stars,76,89,28,61
191,Neal Broten,North Stars,80,56,19,37
191,Neal Broten,North Stars,80,105,29,76
191,Neal Broten,North Stars,46,53,18,35
191,Neal Broten,North Stars,54,39,9,30
191,Neal Broten,North Stars,68,56,18,38
191,Neal Broten,North Stars,80,85,23,62
191,Neal Broten,North Stars,79,69,13,56
191,Neal Broten,North Stars,76,34,8,26
191,Neal Broten,North Stars,82,33,12,21
191,Neal Broten,Stars,79,52,17,35
191,Neal Broten,Stars,17,4,0,4
191,Neal Broten,Devils,30,28,8,20
191,Neal Broten,Devils,55,23,7,16
191,Neal Broten,Devils,3,1,0,1
191,Neal Broten,Kings,19,4,0,4
191,Neal Broten,Stars,20,15,8,7
192,Simon Gagne,Flyers,80,48,20,28
192,Simon Gagne,Flyers,69,59,27,32
192,Simon Gagne,Flyers,79,66,33,33
192,Simon Gagne,Flyers,46,27,9,18
192,Simon Gagne,Flyers,80,45,24,21
192,Simon Gagne,Flyers,72,79,47,32
192,Simon Gagne,Flyers,76,68,41,27
192,Simon Gagne,Flyers,25,18,7,11
192,Simon Gagne,Flyers,79,74,34,40
192,Simon Gagne,Flyers,58,40,17,23
192,Simon Gagne,Lightning,63,40,17,23
192,Simon Gagne,Kings,34,17,7,10
192,Simon Gagne,Kings,11,5,0,5
192,Simon Gagne,Flyers,27,11,5,6
192,Simon Gagne,Bruins,19,2,1,1
193,Peter Mahovlich,Red Wings,3,1,0,1
193,Peter Mahovlich,Red Wings,34,4,1,3
193,Peter Mahovlich,Red Wings,15,10,6,4
193,Peter Mahovlich,Red Wings,30,4,2,2
193,Peter Mahovlich,Canadiens,36,17,9,8
193,Peter Mahovlich,Canadiens,78,61,35,26
193,Peter Mahovlich,Canadiens,75,67,35,32
193,Peter Mahovlich,Canadiens,61,59,21,38
193,Peter Mahovlich,Canadiens,78,73,36,37
193,Peter Mahovlich,Canadiens,80,117,35,82
193,Peter Mahovlich,Canadiens,80,105,34,71
193,Peter Mahovlich,Canadiens,76,62,15,47
193,Peter Mahovlich,Canadiens,17,8,3,5
193,Peter Mahovlich,Penguins,57,61,25,36
193,Peter Mahovlich,Penguins,60,53,14,39
193,Peter Mahovlich,Red Wings,80,66,16,50
193,Peter Mahovlich,Red Wings,24,5,1,4
194,Larry Murphy,Kings,80,76,16,60
194,Larry Murphy,Kings,79,66,22,44
194,Larry Murphy,Kings,77,62,14,48
194,Larry Murphy,Kings,6,3,0,3
194,Larry Murphy,Capitals,72,46,13,33
194,Larry Murphy,Capitals,79,55,13,42
194,Larry Murphy,Capitals,78,65,21,44
194,Larry Murphy,Capitals,80,81,23,58
194,Larry Murphy,Capitals,79,61,8,53
194,Larry Murphy,Capitals,65,36,7,29
194,Larry Murphy,North Stars,13,10,4,6
194,Larry Murphy,North Stars,77,68,10,58
194,Larry Murphy,North Stars,31,15,4,11
194,Larry Murphy,Penguins,44,28,5,23
194,Larry Murphy,Penguins,77,77,21,56
194,Larry Murphy,Penguins,83,85,22,63
194,Larry Murphy,Penguins,84,73,17,56
194,Larry Murphy,Penguins,48,38,13,25
194,Larry Murphy,Maple Leafs,82,61,12,49
194,Larry Murphy,Maple Leafs,69,39,7,32
194,Larry Murphy,Red Wings,12,6,2,4
194,Larry Murphy,Red Wings,82,52,11,41
194,Larry Murphy,Red Wings,80,52,10,42
194,Larry Murphy,Red Wings,81,40,10,30
194,Larry Murphy,Red Wings,57,21,2,19
195,Tony Tanti,Blackhawks,2,0,0,0
195,Tony Tanti,Blackhawks,1,1,1,0
195,Tony Tanti,Canucks,39,16,8,8
195,Tony Tanti,Canucks,79,86,45,41
195,Tony Tanti,Canucks,68,59,39,20
195,Tony Tanti,Canucks,77,72,39,33
195,Tony Tanti,Canucks,77,79,41,38
195,Tony Tanti,Canucks,73,77,40,37
195,Tony Tanti,Canucks,77,49,24,25
195,Tony Tanti,Canucks,41,32,14,18
195,Tony Tanti,Penguins,37,32,14,18
195,Tony Tanti,Penguins,46,18,6,12
195,Tony Tanti,Sabres,10,8,1,7
195,Tony Tanti,Sabres,70,31,15,16
196,Henrik Zetterberg,Red Wings,79,44,22,22
196,Henrik Zetterberg,Red Wings,61,43,15,28
196,Henrik Zetterberg,Red Wings,77,85,39,46
196,Henrik Zetterberg,Red Wings,63,68,33,35
196,Henrik Zetterberg,Red Wings,75,92,43,49
196,Henrik Zetterberg,Red Wings,77,73,31,42
196,Henrik Zetterberg,Red Wings,74,70,23,47
196,Henrik Zetterberg,Red Wings,80,80,24,56
196,Henrik Zetterberg,Red Wings,82,69,22,47
196,Henrik Zetterberg,Red Wings,46,48,11,37
196,Henrik Zetterberg,Red Wings,45,48,16,32
196,Henrik Zetterberg,Red Wings,23,21,5,16
197,Rene Robert,Maple Leafs,5,0,0,0
197,Rene Robert,Penguins,49,18,7,11
197,Rene Robert,Sabres,12,9,6,3
197,Rene Robert,Sabres,75,83,40,43
197,Rene Robert,Sabres,76,65,21,44
197,Rene Robert,Sabres,74,100,40,60
197,Rene Robert,Sabres,72,87,35,52
197,Rene Robert,Sabres,80,73,33,40
197,Rene Robert,Sabres,67,73,25,48
197,Rene Robert,Sabres,68,62,22,40
197,Rene Robert,Rockies,69,63,28,35
197,Rene Robert,Rockies,28,19,8,11
197,Rene Robert,Maple Leafs,14,13,6,7
197,Rene Robert,Maple Leafs,55,37,13,24
198,Brent Ashton,Canucks,47,19,5,14
198,Brent Ashton,Canucks,77,29,18,11
198,Brent Ashton,Rockies,80,60,24,36
198,Brent Ashton,Devils,76,33,14,19
198,Brent Ashton,North Stars,68,17,7,10
198,Brent Ashton,North Stars,29,11,4,7
198,Brent Ashton,Nordiques,49,51,27,24
198,Brent Ashton,Nordiques,77,58,26,32
198,Brent Ashton,Nordiques,46,44,25,19
198,Brent Ashton,Red Wings,35,31,15,16
198,Brent Ashton,Red Wings,73,53,26,27
198,Brent Ashton,Jets (1979),75,68,31,37
198,Brent Ashton,Jets (1979),79,56,22,34
198,Brent Ashton,Jets (1979),61,36,12,24
198,Brent Ashton,Jets (1979),7,1,1,0
198,Brent Ashton,Bruins,61,39,17,22
198,Brent Ashton,Bruins,26,4,2,2
198,Brent Ashton,Flames,32,19,8,11
199,Sidney Crosby,Penguins,81,102,39,63
199,Sidney Crosby,Penguins,79,120,36,84
199,Sidney Crosby,Penguins,53,72,24,48
199,Sidney Crosby,Penguins,77,103,33,70
199,Sidney Crosby,Penguins,81,109,51,58
199,Sidney Crosby,Penguins,41,66,32,34
199,Sidney Crosby,Penguins,22,37,8,29
199,Sidney Crosby,Penguins,36,56,15,41
199,Sidney Crosby,Penguins,80,104,36,68
199,Sidney Crosby,Penguins,22,33,9,24
200,Dick Duff,Maple Leafs,3,0,0,0
200,Dick Duff,Maple Leafs,69,37,18,19
200,Dick Duff,Maple Leafs,70,40,26,14
200,Dick Duff,Maple Leafs,65,49,26,23
200,Dick Duff,Maple Leafs,69,53,29,24
200,Dick Duff,Maple Leafs,67,41,19,22
200,Dick Duff,Maple Leafs,67,33,16,17
200,Dick Duff,Maple Leafs,51,37,17,20
200,Dick Duff,Maple Leafs,69,35,16,19
200,Dick Duff,Maple Leafs,52,17,7,10
200,Dick Duff,Rangers,14,8,4,4
200,Dick Duff,Rangers,29,12,3,9
200,Dick Duff,Canadiens,40,16,9,7
200,Dick Duff,Canadiens,63,45,21,24
200,Dick Duff,Canadiens,51,23,12,11
200,Dick Duff,Canadiens,66,46,25,21
200,Dick Duff,Canadiens,68,40,19,21
200,Dick Duff,Canadiens,17,2,1,1
200,Dick Duff,Kings,32,13,5,8
200,Dick Duff,Kings,7,1,1,0
200,Dick Duff,Sabres,53,20,7,13
200,Dick Duff,Sabres,8,4,2,2
201,Bill Goldsworthy,Bruins,2,0,0,0
201,Bill Goldsworthy,Bruins,13,4,3,1
201,Bill Goldsworthy,Bruins,18,8,3,5
201,Bill Goldsworthy,North Stars,68,33,14,19
201,Bill Goldsworthy,North Stars,68,24,14,10
201,Bill Goldsworthy,North Stars,75,65,36,29
201,Bill Goldsworthy,North Stars,77,65,34,31
201,Bill Goldsworthy,North Stars,78,62,31,31
201,Bill Goldsworthy,North Stars,75,60,27,33
201,Bill Goldsworthy,North Stars,74,74,48,26
201,Bill Goldsworthy,North Stars,71,72,37,35
201,Bill Goldsworthy,North Stars,68,46,24,22
201,Bill Goldsworthy,North Stars,16,5,2,3
201,Bill Goldsworthy,Rangers,61,22,10,12
201,Bill Goldsworthy,Rangers,7,1,0,1
202,John Anderson,Maple Leafs,17,3,1,2
202,John Anderson,Maple Leafs,71,26,15,11
202,John Anderson,Maple Leafs,74,53,25,28
202,John Anderson,Maple Leafs,75,43,17,26
202,John Anderson,Maple Leafs,69,57,31,26
202,John Anderson,Maple Leafs,80,80,31,49
202,John Anderson,Maple Leafs,73,68,37,31
202,John Anderson,Maple Leafs,75,63,32,31
202,John Anderson,Nordiques,65,49,21,28
202,John Anderson,Whalers,14,25,8,17
202,John Anderson,Whalers,76,75,31,44
202,John Anderson,Whalers,63,49,17,32
202,John Anderson,Whalers,62,40,16,24
203,Red Kelly,Red Wings,60,20,6,14
203,Red Kelly,Red Wings,59,16,5,11
203,Red Kelly,Red Wings,70,40,15,25
203,Red Kelly,Red Wings,70,54,17,37
203,Red Kelly,Red Wings,67,47,16,31
203,Red Kelly,Red Wings,70,46,19,27
203,Red Kelly,Red Wings,62,49,16,33
203,Red Kelly,Red Wings,70,45,15,30
203,Red Kelly,Red Wings,70,50,16,34
203,Red Kelly,Red Wings,70,35,10,25
203,Red Kelly,Red Wings,61,31,13,18
203,Red Kelly,Red Wings,67,21,8,13
203,Red Kelly,Red Wings,50,18,6,12
203,Red Kelly,Maple Leafs,18,11,6,5
203,Red Kelly,Maple Leafs,64,70,20,50
203,Red Kelly,Maple Leafs,58,49,22,27
203,Red Kelly,Maple Leafs,66,60,20,40
203,Red Kelly,Maple Leafs,70,45,11,34
203,Red Kelly,Maple Leafs,70,46,18,28
203,Red Kelly,Maple Leafs,63,32,8,24
203,Red Kelly,Maple Leafs,61,38,14,24
204,Bob Pulford,Maple Leafs,65,22,11,11
204,Bob Pulford,Maple Leafs,70,31,14,17
204,Bob Pulford,Maple Leafs,70,37,23,14
204,Bob Pulford,Maple Leafs,70,52,24,28
204,Bob Pulford,Maple Leafs,40,29,11,18
204,Bob Pulford,Maple Leafs,70,39,18,21
204,Bob Pulford,Maple Leafs,70,44,19,25
204,Bob Pulford,Maple Leafs,70,48,18,30
204,Bob Pulford,Maple Leafs,65,39,19,20
204,Bob Pulford,Maple Leafs,70,56,28,28
204,Bob Pulford,Maple Leafs,67,45,17,28
204,Bob Pulford,Maple Leafs,74,50,20,30
204,Bob Pulford,Maple Leafs,72,34,11,23
204,Bob Pulford,Maple Leafs,74,37,18,19
204,Bob Pulford,Kings,59,43,17,26
204,Bob Pulford,Kings,73,37,13,24
205,Brad Richards,Lightning,82,62,21,41
205,Brad Richards,Lightning,82,62,20,42
205,Brad Richards,Lightning,80,74,17,57
205,Brad Richards,Lightning,82,79,26,53
205,Brad Richards,Lightning,82,91,23,68
205,Brad Richards,Lightning,82,70,25,45
205,Brad Richards,Lightning,62,51,18,33
205,Brad Richards,Stars,12,11,2,9
205,Brad Richards,Stars,56,48,16,32
205,Brad Richards,Stars,80,91,24,67
205,Brad Richards,Stars,72,77,28,49
205,Brad Richards,Rangers,82,66,25,41
205,Brad Richards,Rangers,46,34,11,23
205,Brad Richards,Rangers,82,51,20,31
205,Brad Richards,Blackhawks,23,14,4,10
206,Pavel Datsyuk,Red Wings,70,35,11,24
206,Pavel Datsyuk,Red Wings,64,51,12,39
206,Pavel Datsyuk,Red Wings,75,68,30,38
206,Pavel Datsyuk,Red Wings,75,87,28,59
206,Pavel Datsyuk,Red Wings,79,87,27,60
206,Pavel Datsyuk,Red Wings,82,97,31,66
206,Pavel Datsyuk,Red Wings,81,97,32,65
206,Pavel Datsyuk,Red Wings,80,70,27,43
206,Pavel Datsyuk,Red Wings,56,59,23,36
206,Pavel Datsyuk,Red Wings,70,67,19,48
206,Pavel Datsyuk,Red Wings,47,49,15,34
206,Pavel Datsyuk,Red Wings,45,37,17,20
206,Pavel Datsyuk,Red Wings,12,13,7,6
207,Thomas Vanek,Sabres,81,48,25,23
207,Thomas Vanek,Sabres,82,84,43,41
207,Thomas Vanek,Sabres,82,64,36,28
207,Thomas Vanek,Sabres,73,64,40,24
207,Thomas Vanek,Sabres,71,53,28,25
207,Thomas Vanek,Sabres,80,73,32,41
207,Thomas Vanek,Sabres,78,61,26,35
207,Thomas Vanek,Sabres,38,41,20,21
207,Thomas Vanek,Sabres,13,9,4,5
207,Thomas Vanek,Islanders,47,44,17,27
207,Thomas Vanek,Canadiens,18,15,6,9
207,Thomas Vanek,Wild,22,14,2,12
208,Camille Henry,Rangers,66,39,24,15
208,Camille Henry,Rangers,21,7,5,2
208,Camille Henry,Rangers,36,29,14,15
208,Camille Henry,Rangers,70,56,32,24
208,Camille Henry,Rangers,70,58,23,35
208,Camille Henry,Rangers,49,27,12,15
208,Camille Henry,Rangers,53,53,28,25
208,Camille Henry,Rangers,60,38,23,15
208,Camille Henry,Rangers,60,60,37,23
208,Camille Henry,Rangers,68,55,29,26
208,Camille Henry,Rangers,48,36,21,15
208,Camille Henry,Blackhawks,22,8,5,3
208,Camille Henry,Rangers,36,20,8,12
208,Camille Henry,Blues,64,39,17,22
208,Camille Henry,Blues,4,3,1,2
209,Doug Weight,Rangers,53,30,8,22
209,Doug Weight,Rangers,65,40,15,25
209,Doug Weight,Oilers,13,8,2,6
209,Doug Weight,Oilers,84,74,24,50
209,Doug Weight,Oilers,48,40,7,33
209,Doug Weight,Oilers,82,104,25,79
209,Doug Weight,Oilers,80,82,21,61
209,Doug Weight,Oilers,79,70,26,44
209,Doug Weight,Oilers,43,37,6,31
209,Doug Weight,Oilers,77,72,21,51
209,Doug Weight,Oilers,82,90,25,65
209,Doug Weight,Blues,61,49,15,34
209,Doug Weight,Blues,70,67,15,52
209,Doug Weight,Blues,75,65,14,51
209,Doug Weight,Blues,47,44,11,33
209,Doug Weight,Hurricanes,23,13,4,9
209,Doug Weight,Blues,82,59,16,43
209,Doug Weight,Blues,29,11,4,7
209,Doug Weight,Ducks,38,14,6,8
209,Doug Weight,Islanders,53,38,10,28
209,Doug Weight,Islanders,36,17,1,16
209,Doug Weight,Islanders,18,9,2,7
210,Cory Stillman,Flames,10,2,0,2
210,Cory Stillman,Flames,74,35,16,19
210,Cory Stillman,Flames,58,26,6,20
210,Cory Stillman,Flames,72,49,27,22
210,Cory Stillman,Flames,76,57,27,30
210,Cory Stillman,Flames,37,21,12,9
210,Cory Stillman,Flames,66,45,21,24
210,Cory Stillman,Blues,12,7,3,4
210,Cory Stillman,Blues,80,45,23,22
210,Cory Stillman,Blues,79,67,24,43
210,Cory Stillman,Lightning,81,80,25,55
210,Cory Stillman,Hurricanes,72,76,21,55
210,Cory Stillman,Hurricanes,43,27,5,22
210,Cory Stillman,Hurricanes,55,46,21,25
210,Cory Stillman,Senators,24,19,3,16
210,Cory Stillman,Panthers,63,49,17,32
210,Cory Stillman,Panthers,58,37,15,22
210,Cory Stillman,Panthers,44,23,7,16
210,Cory Stillman,Hurricanes,21,16,5,11
211,Ralph Backstrom,Canadiens,3,0,0,0
211,Ralph Backstrom,Canadiens,2,1,0,1
211,Ralph Backstrom,Canadiens,64,40,18,22
211,Ralph Backstrom,Canadiens,64,28,13,15
211,Ralph Backstrom,Canadiens,69,32,12,20
211,Ralph Backstrom,Canadiens,66,65,27,38
211,Ralph Backstrom,Canadiens,70,35,23,12
211,Ralph Backstrom,Canadiens,70,29,8,21
211,Ralph Backstrom,Canadiens,70,55,25,30
211,Ralph Backstrom,Canadiens,67,42,22,20
211,Ralph Backstrom,Canadiens,69,41,14,27
211,Ralph Backstrom,Canadiens,70,45,20,25
211,Ralph Backstrom,Canadiens,72,41,13,28
211,Ralph Backstrom,Canadiens,72,43,19,24
211,Ralph Backstrom,Canadiens,16,5,1,4
211,Ralph Backstrom,Kings,33,27,14,13
211,Ralph Backstrom,Kings,76,52,23,29
211,Ralph Backstrom,Kings,63,49,20,29
211,Ralph Backstrom,Blackhawks,16,9,6,3
212,Jim Pappin,Maple Leafs,50,19,11,8
212,Jim Pappin,Maple Leafs,44,18,9,9
212,Jim Pappin,Maple Leafs,7,3,0,3
212,Jim Pappin,Maple Leafs,64,32,21,11
212,Jim Pappin,Maple Leafs,58,28,13,15
212,Jim Pappin,Blackhawks,75,70,30,40
212,Jim Pappin,Blackhawks,66,53,28,25
212,Jim Pappin,Blackhawks,58,45,22,23
212,Jim Pappin,Blackhawks,64,48,27,21
212,Jim Pappin,Blackhawks,76,92,41,51
212,Jim Pappin,Blackhawks,78,73,32,41
212,Jim Pappin,Blackhawks,71,63,36,27
212,Jim Pappin,Seals,32,19,6,13
212,Jim Pappin,Barons,24,10,2,8
213,Mike Knuble,Red Wings,9,1,1,0
213,Mike Knuble,Red Wings,53,13,7,6
213,Mike Knuble,Rangers,82,35,15,20
213,Mike Knuble,Rangers,59,14,9,5
213,Mike Knuble,Bruins,14,6,3,3
213,Mike Knuble,Bruins,82,20,7,13
213,Mike Knuble,Bruins,54,14,8,6
213,Mike Knuble,Bruins,75,59,30,29
213,Mike Knuble,Bruins,82,46,21,25
213,Mike Knuble,Flyers,82,65,34,31
213,Mike Knuble,Flyers,64,54,24,30
213,Mike Knuble,Flyers,82,55,29,26
213,Mike Knuble,Flyers,82,47,27,20
213,Mike Knuble,Capitals,69,53,29,24
213,Mike Knuble,Capitals,79,40,24,16
213,Mike Knuble,Capitals,72,18,6,12
213,Mike Knuble,Flyers,28,8,4,4
214,Wayne Cashman,Bruins,1,0,0,0
214,Wayne Cashman,Bruins,12,4,0,4
214,Wayne Cashman,Bruins,51,31,8,23
214,Wayne Cashman,Bruins,70,35,9,26
214,Wayne Cashman,Bruins,77,79,21,58
214,Wayne Cashman,Bruins,74,52,23,29
214,Wayne Cashman,Bruins,76,68,29,39
214,Wayne Cashman,Bruins,78,89,30,59
214,Wayne Cashman,Bruins,42,33,11,22
214,Wayne Cashman,Bruins,80,71,28,43
214,Wayne Cashman,Bruins,65,52,15,37
214,Wayne Cashman,Bruins,76,62,24,38
214,Wayne Cashman,Bruins,75,67,27,40
214,Wayne Cashman,Bruins,44,32,11,21
214,Wayne Cashman,Bruins,77,60,25,35
214,Wayne Cashman,Bruins,64,43,12,31
214,Wayne Cashman,Bruins,65,15,4,11
215,Ron Stewart,Maple Leafs,70,35,13,22
215,Ron Stewart,Maple Leafs,70,25,14,11
215,Ron Stewart,Maple Leafs,53,19,14,5
215,Ron Stewart,Maple Leafs,69,27,13,14
215,Ron Stewart,Maple Leafs,65,35,15,20
215,Ron Stewart,Maple Leafs,70,39,15,24
215,Ron Stewart,Maple Leafs,70,34,21,13
215,Ron Stewart,Maple Leafs,67,34,14,20
215,Ron Stewart,Maple Leafs,51,25,13,12
215,Ron Stewart,Maple Leafs,60,17,8,9
215,Ron Stewart,Maple Leafs,63,32,16,16
215,Ron Stewart,Maple Leafs,65,19,14,5
215,Ron Stewart,Maple Leafs,65,27,16,11
215,Ron Stewart,Bruins,70,36,20,16
215,Ron Stewart,Bruins,56,24,14,10
215,Ron Stewart,Blues,19,12,7,5
215,Ron Stewart,Rangers,55,14,7,7
215,Ron Stewart,Rangers,75,29,18,11
215,Ron Stewart,Rangers,76,24,14,10
215,Ron Stewart,Rangers,76,11,5,6
215,Ron Stewart,Canucks,42,4,3,1
215,Ron Stewart,Rangers,13,2,0,2
215,Ron Stewart,Rangers,11,1,0,1
215,Ron Stewart,Islanders,22,4,2,2
216,Corey Perry,Ducks,56,25,13,12
216,Corey Perry,Ducks,82,44,17,27
216,Corey Perry,Ducks,70,54,29,25
216,Corey Perry,Ducks,78,72,32,40
216,Corey Perry,Ducks,82,76,27,49
216,Corey Perry,Ducks,82,98,50,48
216,Corey Perry,Ducks,80,60,37,23
216,Corey Perry,Ducks,44,36,15,21
216,Corey Perry,Ducks,81,82,43,39
216,Corey Perry,Ducks,19,17,12,5
217,James Carson,Kings,80,79,37,42
217,James Carson,Kings,80,107,55,52
217,James Carson,Oilers,80,100,49,51
217,James Carson,Oilers,4,3,1,2
217,James Carson,Red Wings,44,36,20,16
217,James Carson,Red Wings,64,46,21,25
217,James Carson,Red Wings,80,69,34,35
217,James Carson,Red Wings,52,51,25,26
217,James Carson,Kings,34,22,12,10
217,James Carson,Kings,25,11,4,7
217,James Carson,Canucks,34,17,7,10
217,James Carson,Whalers,38,19,9,10
217,James Carson,Whalers,11,1,1,0
218,Murray Oliver,Red Wings,1,1,0,1
218,Murray Oliver,Red Wings,54,39,20,19
218,Murray Oliver,Red Wings,49,23,11,12
218,Murray Oliver,Bruins,21,16,6,10
218,Murray Oliver,Bruins,70,46,17,29
218,Murray Oliver,Bruins,65,62,22,40
218,Murray Oliver,Bruins,70,68,24,44
218,Murray Oliver,Bruins,65,43,20,23
218,Murray Oliver,Bruins,70,60,18,42
218,Murray Oliver,Bruins,65,35,9,26
218,Murray Oliver,Maple Leafs,74,37,16,21
218,Murray Oliver,Maple Leafs,76,50,14,36
218,Murray Oliver,Maple Leafs,76,47,14,33
218,Murray Oliver,North Stars,61,32,9,23
218,Murray Oliver,North Stars,77,56,27,29
218,Murray Oliver,North Stars,75,42,11,31
218,Murray Oliver,North Stars,78,37,17,20
218,Murray Oliver,North Stars,80,34,19,15
219,Bryan Smolinski,Bruins,9,4,1,3
219,Bryan Smolinski,Bruins,83,51,31,20
219,Bryan Smolinski,Bruins,44,31,18,13
219,Bryan Smolinski,Penguins,81,64,24,40
219,Bryan Smolinski,Islanders,64,56,28,28
219,Bryan Smolinski,Islanders,81,43,13,30
219,Bryan Smolinski,Islanders,82,40,16,24
219,Bryan Smolinski,Kings,79,56,20,36
219,Bryan Smolinski,Kings,78,59,27,32
219,Bryan Smolinski,Kings,80,38,13,25
219,Bryan Smolinski,Kings,58,38,18,20
219,Bryan Smolinski,Senators,10,8,3,5
219,Bryan Smolinski,Senators,80,46,19,27
219,Bryan Smolinski,Senators,81,48,17,31
219,Bryan Smolinski,Blackhawks,62,37,14,23
219,Bryan Smolinski,Canucks,20,7,4,3
219,Bryan Smolinski,Canadiens,64,25,8,17
220,Ron Duguay,Rangers,71,40,20,20
220,Ron Duguay,Rangers,79,63,27,36
220,Ron Duguay,Rangers,73,50,28,22
220,Ron Duguay,Rangers,50,38,17,21
220,Ron Duguay,Rangers,72,76,40,36
220,Ron Duguay,Rangers,72,44,19,25
220,Ron Duguay,Red Wings,80,80,33,47
220,Ron Duguay,Red Wings,80,89,38,51
220,Ron Duguay,Red Wings,67,48,19,29
220,Ron Duguay,Penguins,13,13,6,7
220,Ron Duguay,Penguins,40,18,5,13
220,Ron Duguay,Rangers,34,21,9,12
220,Ron Duguay,Rangers,48,8,4,4
220,Ron Duguay,Kings,15,8,2,6
220,Ron Duguay,Kings,70,24,7,17
221,Shayne Corson,Canadiens,3,0,0,0
221,Shayne Corson,Canadiens,55,23,12,11
221,Shayne Corson,Canadiens,71,39,12,27
221,Shayne Corson,Canadiens,80,50,26,24
221,Shayne Corson,Canadiens,76,75,31,44
221,Shayne Corson,Canadiens,71,47,23,24
221,Shayne Corson,Canadiens,64,53,17,36
221,Shayne Corson,Oilers,80,47,16,31
221,Shayne Corson,Oilers,64,54,25,29
221,Shayne Corson,Oilers,48,36,12,24
221,Shayne Corson,Blues,77,46,18,28
221,Shayne Corson,Blues,11,3,2,1
221,Shayne Corson,Canadiens,47,21,6,15
221,Shayne Corson,Canadiens,62,55,21,34
221,Shayne Corson,Canadiens,63,32,12,20
221,Shayne Corson,Canadiens,70,28,8,20
221,Shayne Corson,Maple Leafs,77,26,8,18
221,Shayne Corson,Maple Leafs,74,33,12,21
221,Shayne Corson,Maple Leafs,46,15,7,8
221,Shayne Corson,Stars,17,10,5,5
222,Al Secord,Bruins,71,23,16,7
222,Al Secord,Bruins,77,39,23,16
222,Al Secord,Bruins,18,3,0,3
222,Al Secord,Blackhawks,41,22,13,9
222,Al Secord,Blackhawks,80,75,44,31
222,Al Secord,Blackhawks,80,86,54,32
222,Al Secord,Blackhawks,14,8,4,4
222,Al Secord,Blackhawks,51,26,15,11
222,Al Secord,Blackhawks,80,76,40,36
222,Al Secord,Blackhawks,77,58,29,29
222,Al Secord,Maple Leafs,74,42,15,27
222,Al Secord,Maple Leafs,40,15,5,10
222,Al Secord,Flyers,20,1,1,0
222,Al Secord,Blackhawks,43,21,14,7
223,Robert Schmautz,Blackhawks,13,5,3,2
223,Robert Schmautz,Blackhawks,63,16,9,7
223,Robert Schmautz,Canucks,26,10,5,5
223,Robert Schmautz,Canucks,60,25,12,13
223,Robert Schmautz,Canucks,77,71,38,33
223,Robert Schmautz,Canucks,49,45,26,19
223,Robert Schmautz,Bruins,27,20,7,13
223,Robert Schmautz,Bruins,56,51,21,30
223,Robert Schmautz,Bruins,75,62,28,34
223,Robert Schmautz,Bruins,57,52,23,29
223,Robert Schmautz,Bruins,54,54,27,27
223,Robert Schmautz,Bruins,65,42,20,22
223,Robert Schmautz,Bruins,20,14,8,6
223,Robert Schmautz,Oilers,29,16,8,8
223,Robert Schmautz,Rockies,20,13,9,4
223,Robert Schmautz,Canucks,73,61,27,34
224,Howie Morenz,Canadiens,24,16,13,3
224,Howie Morenz,Canadiens,30,39,28,11
224,Howie Morenz,Canadiens,31,26,23,3
224,Howie Morenz,Canadiens,44,32,25,7
224,Howie Morenz,Canadiens,43,51,33,18
224,Howie Morenz,Canadiens,42,27,17,10
224,Howie Morenz,Canadiens,44,50,40,10
224,Howie Morenz,Canadiens,39,51,28,23
224,Howie Morenz,Canadiens,48,49,24,25
224,Howie Morenz,Canadiens,46,35,14,21
224,Howie Morenz,Canadiens,39,21,8,13
224,Howie Morenz,Blackhawks,48,34,8,26
224,Howie Morenz,Blackhawks,23,15,4,11
224,Howie Morenz,Rangers,19,6,2,4
224,Howie Morenz,Canadiens,30,20,4,16
225,Bobby Orr,Bruins,61,41,13,28
225,Bobby Orr,Bruins,46,31,11,20
225,Bobby Orr,Bruins,67,64,21,43
225,Bobby Orr,Bruins,76,120,33,87
225,Bobby Orr,Bruins,78,139,37,102
225,Bobby Orr,Bruins,76,117,37,80
225,Bobby Orr,Bruins,63,101,29,72
225,Bobby Orr,Bruins,74,122,32,90
225,Bobby Orr,Bruins,80,135,46,89
225,Bobby Orr,Bruins,10,18,5,13
225,Bobby Orr,Blackhawks,20,23,4,19
225,Bobby Orr,Blackhawks,6,4,2,2
226,Daymond Langkow,Lightning,4,1,0,1
226,Daymond Langkow,Lightning,79,28,15,13
226,Daymond Langkow,Lightning,68,22,8,14
226,Daymond Langkow,Lightning,22,10,4,6
226,Daymond Langkow,Flyers,56,23,10,13
226,Daymond Langkow,Flyers,82,50,18,32
226,Daymond Langkow,Flyers,71,54,13,41
226,Daymond Langkow,Coyotes,80,62,27,35
226,Daymond Langkow,Coyotes,82,52,20,32
226,Daymond Langkow,Coyotes,81,52,21,31
226,Daymond Langkow,Flames,82,59,25,34
226,Daymond Langkow,Flames,81,77,33,44
226,Daymond Langkow,Flames,80,65,30,35
226,Daymond Langkow,Flames,73,49,21,28
226,Daymond Langkow,Flames,72,37,14,23
226,Daymond Langkow,Flames,4,1,0,1
226,Daymond Langkow,Coyotes,73,30,11,19
227,Aurel Joliat,Canadiens,24,21,12,9
227,Aurel Joliat,Canadiens,24,20,15,5
227,Aurel Joliat,Canadiens,25,41,30,11
227,Aurel Joliat,Canadiens,35,26,17,9
227,Aurel Joliat,Canadiens,43,18,14,4
227,Aurel Joliat,Canadiens,44,39,28,11
227,Aurel Joliat,Canadiens,44,17,12,5
227,Aurel Joliat,Canadiens,42,31,19,12
227,Aurel Joliat,Canadiens,43,35,13,22
227,Aurel Joliat,Canadiens,48,39,15,24
227,Aurel Joliat,Canadiens,48,39,18,21
227,Aurel Joliat,Canadiens,48,37,22,15
227,Aurel Joliat,Canadiens,48,29,17,12
227,Aurel Joliat,Canadiens,48,23,15,8
227,Aurel Joliat,Canadiens,47,32,17,15
227,Aurel Joliat,Canadiens,44,13,6,7
228,Sylvain Turgeon,Whalers,76,72,40,32
228,Sylvain Turgeon,Whalers,64,62,31,31
228,Sylvain Turgeon,Whalers,76,79,45,34
228,Sylvain Turgeon,Whalers,41,36,23,13
228,Sylvain Turgeon,Whalers,71,49,23,26
228,Sylvain Turgeon,Whalers,42,30,16,14
228,Sylvain Turgeon,Devils,72,47,30,17
228,Sylvain Turgeon,Canadiens,19,12,5,7
228,Sylvain Turgeon,Canadiens,56,20,9,11
228,Sylvain Turgeon,Senators,72,43,25,18
228,Sylvain Turgeon,Senators,47,26,11,15
228,Sylvain Turgeon,Senators,33,19,11,8
229,Andrew Brunette,Capitals,11,6,3,3
229,Andrew Brunette,Capitals,23,11,4,7
229,Andrew Brunette,Capitals,28,23,11,12
229,Andrew Brunette,Predators,77,31,11,20
229,Andrew Brunette,Thrashers,81,50,23,27
229,Andrew Brunette,Thrashers,77,59,15,44
229,Andrew Brunette,Wild,81,69,21,48
229,Andrew Brunette,Wild,82,46,18,28
229,Andrew Brunette,Wild,82,49,15,34
229,Andrew Brunette,Avalanche,82,63,24,39
229,Andrew Brunette,Avalanche,82,83,27,56
229,Andrew Brunette,Avalanche,82,59,19,40
229,Andrew Brunette,Wild,80,50,22,28
229,Andrew Brunette,Wild,82,61,25,36
229,Andrew Brunette,Wild,82,46,18,28
229,Andrew Brunette,Blackhawks,78,27,12,15
230,Murray Craven,Red Wings,31,11,4,7
230,Murray Craven,Red Wings,15,4,0,4
230,Murray Craven,Flyers,80,61,26,35
230,Murray Craven,Flyers,78,54,21,33
230,Murray Craven,Flyers,77,49,19,30
230,Murray Craven,Flyers,72,76,30,46
230,Murray Craven,Flyers,51,37,9,28
230,Murray Craven,Flyers,76,75,25,50
230,Murray Craven,Flyers,77,66,19,47
230,Murray Craven,Flyers,12,6,3,3
230,Murray Craven,Whalers,61,54,24,30
230,Murray Craven,Whalers,67,67,25,42
230,Murray Craven,Canucks,10,10,0,10
230,Murray Craven,Canucks,78,55,15,40
230,Murray Craven,Blackhawks,16,7,4,3
230,Murray Craven,Blackhawks,66,47,18,29
230,Murray Craven,Blackhawks,75,35,8,27
230,Murray Craven,Sharks,67,29,12,17
230,Murray Craven,Sharks,43,14,4,10
230,Murray Craven,Sharks,19,2,0,2
231,Dan Quinn,Flames,54,52,19,33
231,Dan Quinn,Flames,74,58,20,38
231,Dan Quinn,Flames,78,72,30,42
231,Dan Quinn,Flames,16,9,3,6
231,Dan Quinn,Penguins,64,71,28,43
231,Dan Quinn,Penguins,70,79,40,39
231,Dan Quinn,Penguins,79,94,34,60
231,Dan Quinn,Penguins,41,29,9,20
231,Dan Quinn,Canucks,37,34,16,18
231,Dan Quinn,Canucks,64,49,18,31
231,Dan Quinn,Blues,14,11,4,7
231,Dan Quinn,Flyers,67,37,11,26
231,Dan Quinn,North Stars,11,4,0,4
231,Dan Quinn,Senators,13,7,7,0
231,Dan Quinn,Kings,44,31,14,17
231,Dan Quinn,Senators,28,24,6,18
231,Dan Quinn,Flyers,35,21,7,14
231,Dan Quinn,Penguins,16,3,0,3
232,Keith Primeau,Red Wings,58,15,3,12
232,Keith Primeau,Red Wings,35,16,6,10
232,Keith Primeau,Red Wings,73,32,15,17
232,Keith Primeau,Red Wings,78,73,31,42
232,Keith Primeau,Red Wings,45,42,15,27
232,Keith Primeau,Red Wings,74,52,27,25
232,Keith Primeau,Whalers,75,51,26,25
232,Keith Primeau,Hurricanes,81,63,26,37
232,Keith Primeau,Hurricanes,78,62,30,32
232,Keith Primeau,Flyers,23,17,7,10
232,Keith Primeau,Flyers,71,73,34,39
232,Keith Primeau,Flyers,75,48,19,29
232,Keith Primeau,Flyers,80,46,19,27
232,Keith Primeau,Flyers,54,22,7,15
232,Keith Primeau,Flyers,9,7,1,6
233,Donnie Marshall,Canadiens,1,0,0,0
233,Donnie Marshall,Canadiens,39,8,5,3
233,Donnie Marshall,Canadiens,66,5,4,1
233,Donnie Marshall,Canadiens,70,20,12,8
233,Donnie Marshall,Canadiens,68,41,22,19
233,Donnie Marshall,Canadiens,70,32,10,22
233,Donnie Marshall,Canadiens,70,38,16,22
233,Donnie Marshall,Canadiens,70,31,14,17
233,Donnie Marshall,Canadiens,66,46,18,28
233,Donnie Marshall,Canadiens,65,33,13,20
233,Donnie Marshall,Rangers,70,23,11,12
233,Donnie Marshall,Rangers,69,35,20,15
233,Donnie Marshall,Rangers,69,54,26,28
233,Donnie Marshall,Rangers,70,46,24,22
233,Donnie Marshall,Rangers,70,49,19,30
233,Donnie Marshall,Rangers,74,39,20,19
233,Donnie Marshall,Rangers,57,24,9,15
233,Donnie Marshall,Sabres,62,49,20,29
233,Donnie Marshall,Maple Leafs,50,16,2,14
234,Nicklas Lidstrom,Red Wings,80,60,11,49
234,Nicklas Lidstrom,Red Wings,84,41,7,34
234,Nicklas Lidstrom,Red Wings,84,56,10,46
234,Nicklas Lidstrom,Red Wings,43,26,10,16
234,Nicklas Lidstrom,Red Wings,81,67,17,50
234,Nicklas Lidstrom,Red Wings,79,57,15,42
234,Nicklas Lidstrom,Red Wings,80,59,17,42
234,Nicklas Lidstrom,Red Wings,81,57,14,43
234,Nicklas Lidstrom,Red Wings,81,73,20,53
234,Nicklas Lidstrom,Red Wings,82,71,15,56
234,Nicklas Lidstrom,Red Wings,78,59,9,50
234,Nicklas Lidstrom,Red Wings,82,62,18,44
234,Nicklas Lidstrom,Red Wings,81,38,10,28
234,Nicklas Lidstrom,Red Wings,80,80,16,64
234,Nicklas Lidstrom,Red Wings,80,62,13,49
234,Nicklas Lidstrom,Red Wings,76,70,10,60
234,Nicklas Lidstrom,Red Wings,78,59,16,43
234,Nicklas Lidstrom,Red Wings,82,49,9,40
234,Nicklas Lidstrom,Red Wings,82,62,16,46
234,Nicklas Lidstrom,Red Wings,70,34,11,23
235,Thomas Steen,Jets (1979),73,44,15,29
235,Thomas Steen,Jets (1979),75,59,26,33
235,Thomas Steen,Jets (1979),78,65,20,45
235,Thomas Steen,Jets (1979),79,84,30,54
235,Thomas Steen,Jets (1979),78,64,17,47
235,Thomas Steen,Jets (1979),75,50,17,33
235,Thomas Steen,Jets (1979),76,54,16,38
235,Thomas Steen,Jets (1979),80,88,27,61
235,Thomas Steen,Jets (1979),53,66,18,48
235,Thomas Steen,Jets (1979),58,67,19,48
235,Thomas Steen,Jets (1979),38,38,13,25
235,Thomas Steen,Jets (1979),80,72,22,50
235,Thomas Steen,Jets (1979),76,51,19,32
235,Thomas Steen,Jets (1979),31,15,5,10
236,Kent Nilsson,Flames,80,93,40,53
236,Kent Nilsson,Flames,80,131,49,82
236,Kent Nilsson,Flames,41,55,26,29
236,Kent Nilsson,Flames,80,104,46,58
236,Kent Nilsson,Flames,67,80,31,49
236,Kent Nilsson,Flames,77,99,37,62
236,Kent Nilsson,North Stars,61,60,16,44
236,Kent Nilsson,North Stars,44,46,13,33
236,Kent Nilsson,Oilers,17,17,5,12
236,Kent Nilsson,Oilers,6,1,1,0
237,Ryan Walter,Capitals,69,56,28,28
237,Ryan Walter,Capitals,80,66,24,42
237,Ryan Walter,Capitals,80,68,24,44
237,Ryan Walter,Capitals,78,87,38,49
237,Ryan Walter,Canadiens,80,75,29,46
237,Ryan Walter,Canadiens,73,49,20,29
237,Ryan Walter,Canadiens,72,38,19,19
237,Ryan Walter,Canadiens,69,49,15,34
237,Ryan Walter,Canadiens,76,46,23,23
237,Ryan Walter,Canadiens,61,36,13,23
237,Ryan Walter,Canadiens,78,31,14,17
237,Ryan Walter,Canadiens,70,24,8,16
237,Ryan Walter,Canadiens,25,1,0,1
237,Ryan Walter,Canucks,67,17,6,11
237,Ryan Walter,Canucks,25,3,3,0
238,Daniel Grant,Canadiens,1,0,0,0
238,Daniel Grant,Canadiens,22,7,3,4
238,Daniel Grant,North Stars,75,65,34,31
238,Daniel Grant,North Stars,76,57,29,28
238,Daniel Grant,North Stars,78,57,34,23
238,Daniel Grant,North Stars,78,43,18,25
238,Daniel Grant,North Stars,78,67,32,35
238,Daniel Grant,North Stars,78,64,29,35
238,Daniel Grant,Red Wings,80,87,50,37
238,Daniel Grant,Red Wings,39,23,10,13
238,Daniel Grant,Red Wings,42,12,2,10
238,Daniel Grant,Red Wings,13,4,2,2
238,Daniel Grant,Kings,41,29,10,19
238,Daniel Grant,Kings,35,21,10,11
239,Stanley Smyl,Canucks,62,38,14,24
239,Stanley Smyl,Canucks,77,78,31,47
239,Stanley Smyl,Canucks,80,63,25,38
239,Stanley Smyl,Canucks,80,78,34,44
239,Stanley Smyl,Canucks,74,88,38,50
239,Stanley Smyl,Canucks,80,67,24,43
239,Stanley Smyl,Canucks,80,64,27,37
239,Stanley Smyl,Canucks,73,62,27,35
239,Stanley Smyl,Canucks,66,43,20,23
239,Stanley Smyl,Canucks,57,37,12,25
239,Stanley Smyl,Canucks,75,25,7,18
239,Stanley Smyl,Canucks,47,16,1,15
239,Stanley Smyl,Canucks,45,14,2,12
240,Brenden Morrow,Stars,64,33,14,19
240,Brenden Morrow,Stars,82,44,20,24
240,Brenden Morrow,Stars,72,35,17,18
240,Brenden Morrow,Stars,71,43,21,22
240,Brenden Morrow,Stars,81,49,25,24
240,Brenden Morrow,Stars,81,65,23,42
240,Brenden Morrow,Stars,40,31,16,15
240,Brenden Morrow,Stars,82,74,32,42
240,Brenden Morrow,Stars,18,15,5,10
240,Brenden Morrow,Stars,76,46,20,26
240,Brenden Morrow,Stars,82,56,33,23
240,Brenden Morrow,Stars,57,26,11,15
240,Brenden Morrow,Stars,29,11,6,5
240,Brenden Morrow,Penguins,15,14,6,8
240,Brenden Morrow,Blues,71,25,13,12
240,Brenden Morrow,Lightning,21,2,0,2
241,Jeff Carter,Flyers,81,42,23,19
241,Jeff Carter,Flyers,62,37,14,23
241,Jeff Carter,Flyers,82,53,29,24
241,Jeff Carter,Flyers,82,84,46,38
241,Jeff Carter,Flyers,74,61,33,28
241,Jeff Carter,Flyers,80,66,36,30
241,Jeff Carter,Blue Jackets,39,25,15,10
241,Jeff Carter,Kings,16,9,6,3
241,Jeff Carter,Kings,48,33,26,7
241,Jeff Carter,Kings,72,50,27,23
241,Jeff Carter,Kings,23,18,7,11
242,Robert Lang,Kings,11,5,0,5
242,Robert Lang,Kings,32,19,9,10
242,Robert Lang,Kings,36,12,4,8
242,Robert Lang,Kings,68,22,6,16
242,Robert Lang,Bruins,3,0,0,0
242,Robert Lang,Penguins,51,22,9,13
242,Robert Lang,Penguins,72,44,21,23
242,Robert Lang,Penguins,78,65,23,42
242,Robert Lang,Penguins,82,80,32,48
242,Robert Lang,Penguins,62,50,18,32
242,Robert Lang,Capitals,82,69,22,47
242,Robert Lang,Capitals,63,74,29,45
242,Robert Lang,Red Wings,6,5,1,4
242,Robert Lang,Red Wings,72,62,20,42
242,Robert Lang,Red Wings,81,52,19,33
242,Robert Lang,Blackhawks,76,54,21,33
242,Robert Lang,Canadiens,50,39,18,21
242,Robert Lang,Coyotes,64,29,9,20
243,Red Berenson,Canadiens,4,3,1,2
243,Red Berenson,Canadiens,37,8,2,6
243,Red Berenson,Canadiens,69,16,7,9
243,Red Berenson,Canadiens,3,3,1,2
243,Red Berenson,Canadiens,23,7,3,4
243,Red Berenson,Rangers,30,5,0,5
243,Red Berenson,Rangers,19,3,2,1
243,Red Berenson,Blues,55,51,22,29
243,Red Berenson,Blues,76,82,35,47
243,Red Berenson,Blues,67,72,33,39
243,Red Berenson,Blues,45,42,16,26
243,Red Berenson,Red Wings,24,17,5,12
243,Red Berenson,Red Wings,78,69,28,41
243,Red Berenson,Red Wings,78,43,13,30
243,Red Berenson,Red Wings,76,66,24,42
243,Red Berenson,Red Wings,27,6,3,3
243,Red Berenson,Blues,44,31,12,19
243,Red Berenson,Blues,72,47,20,27
243,Red Berenson,Blues,80,49,21,28
243,Red Berenson,Blues,80,38,13,25
244,Derek King,Islanders,2,0,0,0
244,Derek King,Islanders,55,36,12,24
244,Derek King,Islanders,60,43,14,29
244,Derek King,Islanders,46,40,13,27
244,Derek King,Islanders,66,45,19,26
244,Derek King,Islanders,80,78,40,38
244,Derek King,Islanders,77,76,38,38
244,Derek King,Islanders,78,70,30,40
244,Derek King,Islanders,43,26,10,16
244,Derek King,Islanders,61,32,12,20
244,Derek King,Islanders,70,53,23,30
244,Derek King,Whalers,12,6,3,3
244,Derek King,Maple Leafs,77,46,21,25
244,Derek King,Maple Leafs,81,52,24,28
244,Derek King,Maple Leafs,3,0,0,0
244,Derek King,Blues,19,9,2,7
245,Dickie Moore,Canadiens,33,33,18,15
245,Dickie Moore,Canadiens,18,8,2,6
245,Dickie Moore,Canadiens,13,5,1,4
245,Dickie Moore,Canadiens,67,36,16,20
245,Dickie Moore,Canadiens,70,50,11,39
245,Dickie Moore,Canadiens,70,58,29,29
245,Dickie Moore,Canadiens,70,84,36,48
245,Dickie Moore,Canadiens,70,96,41,55
245,Dickie Moore,Canadiens,62,64,22,42
245,Dickie Moore,Canadiens,57,69,35,34
245,Dickie Moore,Canadiens,57,41,19,22
245,Dickie Moore,Canadiens,67,50,24,26
245,Dickie Moore,Maple Leafs,38,6,2,4
245,Dickie Moore,Blues,27,8,5,3
246,Stu Barnes,Jets (1979),46,17,8,9
246,Stu Barnes,Jets (1979),38,22,12,10
246,Stu Barnes,Jets (1979),18,9,5,4
246,Stu Barnes,Panthers,59,38,18,20
246,Stu Barnes,Panthers,41,29,10,19
246,Stu Barnes,Panthers,72,44,19,25
246,Stu Barnes,Panthers,19,10,2,8
246,Stu Barnes,Penguins,62,39,17,22
246,Stu Barnes,Penguins,78,65,30,35
246,Stu Barnes,Penguins,64,32,20,12
246,Stu Barnes,Sabres,17,4,0,4
246,Stu Barnes,Sabres,82,45,20,25
246,Stu Barnes,Sabres,75,43,19,24
246,Stu Barnes,Sabres,68,48,17,31
246,Stu Barnes,Sabres,68,32,11,21
246,Stu Barnes,Stars,13,7,2,5
246,Stu Barnes,Stars,77,29,11,18
246,Stu Barnes,Stars,78,36,15,21
246,Stu Barnes,Stars,82,25,13,12
246,Stu Barnes,Stars,79,23,12,11
247,Alex Tanguay,Avalanche,76,51,17,34
247,Alex Tanguay,Avalanche,82,77,27,50
247,Alex Tanguay,Avalanche,70,48,13,35
247,Alex Tanguay,Avalanche,82,67,26,41
247,Alex Tanguay,Avalanche,69,79,25,54
247,Alex Tanguay,Avalanche,71,78,29,49
247,Alex Tanguay,Flames,81,81,22,59
247,Alex Tanguay,Flames,78,58,18,40
247,Alex Tanguay,Canadiens,50,41,16,25
247,Alex Tanguay,Lightning,80,37,10,27
247,Alex Tanguay,Flames,79,69,22,47
247,Alex Tanguay,Flames,64,49,13,36
247,Alex Tanguay,Flames,40,27,11,16
247,Alex Tanguay,Avalanche,16,11,4,7
247,Alex Tanguay,Avalanche,21,12,7,5
248,Guy Carbonneau,Canadiens,2,1,0,1
248,Guy Carbonneau,Canadiens,77,47,18,29
248,Guy Carbonneau,Canadiens,78,54,24,30
248,Guy Carbonneau,Canadiens,79,57,23,34
248,Guy Carbonneau,Canadiens,80,56,20,36
248,Guy Carbonneau,Canadiens,79,45,18,27
248,Guy Carbonneau,Canadiens,80,38,17,21
248,Guy Carbonneau,Canadiens,79,56,26,30
248,Guy Carbonneau,Canadiens,68,55,19,36
248,Guy Carbonneau,Canadiens,78,44,20,24
248,Guy Carbonneau,Canadiens,72,39,18,21
248,Guy Carbonneau,Canadiens,61,17,4,13
248,Guy Carbonneau,Canadiens,79,38,14,24
248,Guy Carbonneau,Blues,42,16,5,11
248,Guy Carbonneau,Stars,71,23,8,15
248,Guy Carbonneau,Stars,73,21,5,16
248,Guy Carbonneau,Stars,77,24,7,17
248,Guy Carbonneau,Stars,74,16,4,12
248,Guy Carbonneau,Stars,69,16,10,6
249,Brian Mullen,Jets (1979),80,50,24,26
249,Brian Mullen,Jets (1979),75,62,21,41
249,Brian Mullen,Jets (1979),69,71,32,39
249,Brian Mullen,Jets (1979),79,62,28,34
249,Brian Mullen,Jets (1979),69,51,19,32
249,Brian Mullen,Rangers,74,54,25,29
249,Brian Mullen,Rangers,78,64,29,35
249,Brian Mullen,Rangers,76,68,27,41
249,Brian Mullen,Rangers,79,62,19,43
249,Brian Mullen,Sharks,72,46,18,28
249,Brian Mullen,Islanders,81,32,18,14
250,Donald Audette,Sabres,8,7,4,3
250,Donald Audette,Sabres,63,48,31,17
250,Donald Audette,Sabres,44,19,12,7
250,Donald Audette,Sabres,77,59,29,30
250,Donald Audette,Sabres,46,37,24,13
250,Donald Audette,Sabres,23,25,12,13
250,Donald Audette,Sabres,73,50,28,22
250,Donald Audette,Sabres,75,44,24,20
250,Donald Audette,Kings,49,36,18,18
250,Donald Audette,Kings,49,32,12,20
250,Donald Audette,Thrashers,14,11,7,4
250,Donald Audette,Thrashers,64,71,32,39
250,Donald Audette,Sabres,12,8,2,6
250,Donald Audette,Stars,20,12,4,8
250,Donald Audette,Canadiens,13,6,1,5
250,Donald Audette,Canadiens,54,23,11,12
250,Donald Audette,Canadiens,23,8,3,5
250,Donald Audette,Panthers,28,13,6,7
251,Dmitri Khristich,Capitals,40,27,13,14
251,Dmitri Khristich,Capitals,80,73,36,37
251,Dmitri Khristich,Capitals,64,66,31,35
251,Dmitri Khristich,Capitals,83,58,29,29
251,Dmitri Khristich,Capitals,48,26,12,14
251,Dmitri Khristich,Kings,76,64,27,37
251,Dmitri Khristich,Kings,75,56,19,37
251,Dmitri Khristich,Bruins,82,66,29,37
251,Dmitri Khristich,Bruins,79,71,29,42
251,Dmitri Khristich,Maple Leafs,53,30,12,18
251,Dmitri Khristich,Maple Leafs,27,9,3,6
251,Dmitri Khristich,Capitals,43,29,10,19
251,Dmitri Khristich,Capitals,61,21,9,12
252,Mario Tremblay,Canadiens,63,39,21,18
252,Mario Tremblay,Canadiens,71,27,11,16
252,Mario Tremblay,Canadiens,74,46,18,28
252,Mario Tremblay,Canadiens,56,24,10,14
252,Mario Tremblay,Canadiens,76,59,30,29
252,Mario Tremblay,Canadiens,77,42,16,26
252,Mario Tremblay,Canadiens,77,63,25,38
252,Mario Tremblay,Canadiens,80,73,33,40
252,Mario Tremblay,Canadiens,80,67,30,37
252,Mario Tremblay,Canadiens,67,39,14,25
252,Mario Tremblay,Canadiens,75,66,31,35
252,Mario Tremblay,Canadiens,56,39,19,20
253,Robert Bourne,Islanders,77,39,16,23
253,Robert Bourne,Islanders,14,5,2,3
253,Robert Bourne,Islanders,75,35,16,19
253,Robert Bourne,Islanders,80,63,30,33
253,Robert Bourne,Islanders,80,61,30,31
253,Robert Bourne,Islanders,73,40,15,25
253,Robert Bourne,Islanders,78,76,35,41
253,Robert Bourne,Islanders,76,53,27,26
253,Robert Bourne,Islanders,77,62,20,42
253,Robert Bourne,Islanders,78,56,22,34
253,Robert Bourne,Islanders,44,20,8,12
253,Robert Bourne,Islanders,62,32,17,15
253,Robert Bourne,Kings,78,22,13,9
253,Robert Bourne,Kings,72,18,7,11
254,Bill Mosienko,Blackhawks,12,14,6,8
254,Bill Mosienko,Blackhawks,2,2,2,0
254,Bill Mosienko,Blackhawks,50,70,32,38
254,Bill Mosienko,Blackhawks,50,54,28,26
254,Bill Mosienko,Blackhawks,40,48,18,30
254,Bill Mosienko,Blackhawks,59,52,25,27
254,Bill Mosienko,Blackhawks,40,25,16,9
254,Bill Mosienko,Blackhawks,60,42,17,25
254,Bill Mosienko,Blackhawks,69,46,18,28
254,Bill Mosienko,Blackhawks,65,36,21,15
254,Bill Mosienko,Blackhawks,70,53,31,22
254,Bill Mosienko,Blackhawks,65,37,17,20
254,Bill Mosienko,Blackhawks,65,34,15,19
254,Bill Mosienko,Blackhawks,64,27,12,15
255,Blaine Stoughton,Penguins,34,11,5,6
255,Blaine Stoughton,Maple Leafs,78,37,23,14
255,Blaine Stoughton,Maple Leafs,43,17,6,11
255,Blaine Stoughton,Whalers,80,100,56,44
255,Blaine Stoughton,Whalers,71,73,43,30
255,Blaine Stoughton,Whalers,80,91,52,39
255,Blaine Stoughton,Whalers,72,76,45,31
255,Blaine Stoughton,Whalers,54,37,23,14
255,Blaine Stoughton,Rangers,14,7,5,2
256,Martin Straka,Penguins,42,16,3,13
256,Martin Straka,Penguins,84,64,30,34
256,Martin Straka,Penguins,31,16,4,12
256,Martin Straka,Senators,6,2,1,1
256,Martin Straka,Senators,43,25,9,16
256,Martin Straka,Islanders,22,12,2,10
256,Martin Straka,Panthers,12,6,2,4
256,Martin Straka,Panthers,55,29,7,22
256,Martin Straka,Penguins,75,42,19,23
256,Martin Straka,Penguins,80,83,35,48
256,Martin Straka,Penguins,71,59,20,39
256,Martin Straka,Penguins,82,95,27,68
256,Martin Straka,Penguins,13,9,5,4
256,Martin Straka,Penguins,60,46,18,28
256,Martin Straka,Penguins,22,12,4,8
256,Martin Straka,Kings,32,14,6,8
256,Martin Straka,Rangers,82,76,22,54
256,Martin Straka,Rangers,77,70,29,41
256,Martin Straka,Rangers,65,41,14,27
257,Ken Linseman,Flyers,30,25,5,20
257,Ken Linseman,Flyers,80,79,22,57
257,Ken Linseman,Flyers,51,47,17,30
257,Ken Linseman,Flyers,79,92,24,68
257,Ken Linseman,Oilers,72,75,33,42
257,Ken Linseman,Oilers,72,67,18,49
257,Ken Linseman,Bruins,74,74,25,49
257,Ken Linseman,Bruins,64,81,23,58
257,Ken Linseman,Bruins,64,49,15,34
257,Ken Linseman,Bruins,77,74,29,45
257,Ken Linseman,Bruins,78,72,27,45
257,Ken Linseman,Bruins,32,22,6,16
257,Ken Linseman,Flyers,29,14,5,9
257,Ken Linseman,Oilers,56,36,7,29
257,Ken Linseman,Maple Leafs,2,0,0,0
258,Shawn McEachern,Penguins,15,4,0,4
258,Shawn McEachern,Penguins,84,61,28,33
258,Shawn McEachern,Kings,49,21,8,13
258,Shawn McEachern,Penguins,27,21,12,9
258,Shawn McEachern,Penguins,44,26,13,13
258,Shawn McEachern,Bruins,82,53,24,29
258,Shawn McEachern,Senators,65,31,11,20
258,Shawn McEachern,Senators,81,48,24,24
258,Shawn McEachern,Senators,77,56,31,25
258,Shawn McEachern,Senators,69,51,29,22
258,Shawn McEachern,Senators,82,72,32,40
258,Shawn McEachern,Senators,80,46,15,31
258,Shawn McEachern,Thrashers,46,26,10,16
258,Shawn McEachern,Thrashers,82,55,17,38
258,Shawn McEachern,Bruins,28,8,2,6
259,David Lonsberry,Bruins,8,1,0,1
259,David Lonsberry,Bruins,19,4,2,2
259,David Lonsberry,Bruins,6,0,0,0
259,David Lonsberry,Kings,76,42,20,22
259,David Lonsberry,Kings,76,53,25,28
259,David Lonsberry,Kings,50,23,9,14
259,David Lonsberry,Flyers,32,14,7,7
259,David Lonsberry,Flyers,77,50,21,29
259,David Lonsberry,Flyers,75,51,32,19
259,David Lonsberry,Flyers,80,49,24,25
259,David Lonsberry,Flyers,80,47,19,28
259,David Lonsberry,Flyers,75,55,23,32
259,David Lonsberry,Flyers,78,48,18,30
259,David Lonsberry,Penguins,80,46,24,22
259,David Lonsberry,Penguins,76,33,15,18
259,David Lonsberry,Penguins,80,50,17,33
260,Darcy Rota,Blackhawks,74,33,21,12
260,Darcy Rota,Blackhawks,78,44,22,22
260,Darcy Rota,Blackhawks,79,37,20,17
260,Darcy Rota,Blackhawks,76,46,24,22
260,Darcy Rota,Blackhawks,78,37,17,20
260,Darcy Rota,Blackhawks,63,30,13,17
260,Darcy Rota,Flames,13,14,9,5
260,Darcy Rota,Flames,44,18,10,8
260,Darcy Rota,Canucks,26,11,5,6
260,Darcy Rota,Canucks,80,56,25,31
260,Darcy Rota,Canucks,51,40,20,20
260,Darcy Rota,Canucks,73,81,42,39
260,Darcy Rota,Canucks,59,48,28,20
261,Saku Koivu,Canadiens,82,45,20,25
261,Saku Koivu,Canadiens,50,56,17,39
261,Saku Koivu,Canadiens,69,57,14,43
261,Saku Koivu,Canadiens,65,44,14,30
261,Saku Koivu,Canadiens,24,21,3,18
261,Saku Koivu,Canadiens,54,47,17,30
261,Saku Koivu,Canadiens,3,2,0,2
261,Saku Koivu,Canadiens,82,71,21,50
261,Saku Koivu,Canadiens,68,55,14,41
261,Saku Koivu,Canadiens,72,62,17,45
261,Saku Koivu,Canadiens,81,75,22,53
261,Saku Koivu,Canadiens,77,56,16,40
261,Saku Koivu,Canadiens,65,50,16,34
261,Saku Koivu,Ducks,71,52,19,33
261,Saku Koivu,Ducks,75,45,15,30
261,Saku Koivu,Ducks,74,38,11,27
261,Saku Koivu,Ducks,47,27,8,19
261,Saku Koivu,Ducks,65,29,11,18
262,Vinny Prospal,Flyers,18,15,5,10
262,Vinny Prospal,Flyers,41,18,5,13
262,Vinny Prospal,Senators,15,7,1,6
262,Vinny Prospal,Senators,79,36,10,26
262,Vinny Prospal,Senators,79,55,22,33
262,Vinny Prospal,Senators,40,13,1,12
262,Vinny Prospal,Panthers,34,16,4,12
262,Vinny Prospal,Lightning,81,55,18,37
262,Vinny Prospal,Lightning,80,79,22,57
262,Vinny Prospal,Ducks,82,54,19,35
262,Vinny Prospal,Lightning,81,80,25,55
262,Vinny Prospal,Lightning,82,55,14,41
262,Vinny Prospal,Lightning,62,57,29,28
262,Vinny Prospal,Flyers,18,14,4,10
262,Vinny Prospal,Lightning,82,45,19,26
262,Vinny Prospal,Rangers,75,58,20,38
262,Vinny Prospal,Rangers,29,23,9,14
262,Vinny Prospal,Blue Jackets,82,55,16,39
262,Vinny Prospal,Blue Jackets,48,30,12,18
263,Jason Spezza,Senators,33,21,7,14
263,Jason Spezza,Senators,78,55,22,33
263,Jason Spezza,Senators,68,90,19,71
263,Jason Spezza,Senators,67,87,34,53
263,Jason Spezza,Senators,76,92,34,58
263,Jason Spezza,Senators,82,73,32,41
263,Jason Spezza,Senators,60,57,23,34
263,Jason Spezza,Senators,62,57,21,36
263,Jason Spezza,Senators,80,84,34,50
263,Jason Spezza,Senators,5,5,2,3
263,Jason Spezza,Senators,75,66,23,43
263,Jason Spezza,Stars,23,19,4,15
264,Chris Drury,Avalanche,79,44,20,24
264,Chris Drury,Avalanche,82,67,20,47
264,Chris Drury,Avalanche,71,65,24,41
264,Chris Drury,Avalanche,82,46,21,25
264,Chris Drury,Flames,80,53,23,30
264,Chris Drury,Sabres,76,53,18,35
264,Chris Drury,Sabres,81,67,30,37
264,Chris Drury,Sabres,77,69,37,32
264,Chris Drury,Rangers,82,58,25,33
264,Chris Drury,Rangers,81,56,22,34
264,Chris Drury,Rangers,77,32,14,18
264,Chris Drury,Rangers,24,5,1,4
265,Scott Hartnell,Predators,75,16,2,14
265,Scott Hartnell,Predators,75,41,14,27
265,Scott Hartnell,Predators,82,34,12,22
265,Scott Hartnell,Predators,59,33,18,15
265,Scott Hartnell,Predators,81,48,25,23
265,Scott Hartnell,Predators,64,39,22,17
265,Scott Hartnell,Flyers,80,43,24,19
265,Scott Hartnell,Flyers,82,60,30,30
265,Scott Hartnell,Flyers,81,44,14,30
265,Scott Hartnell,Flyers,82,49,24,25
265,Scott Hartnell,Flyers,82,67,37,30
265,Scott Hartnell,Flyers,32,11,8,3
265,Scott Hartnell,Flyers,78,52,20,32
265,Scott Hartnell,Blue Jackets,22,14,5,9
266,Claude Provost,Canadiens,60,29,13,16
266,Claude Provost,Canadiens,67,30,16,14
266,Claude Provost,Canadiens,70,51,19,32
266,Claude Provost,Canadiens,69,38,16,22
266,Claude Provost,Canadiens,70,46,17,29
266,Claude Provost,Canadiens,49,15,11,4
266,Claude Provost,Canadiens,70,62,33,29
266,Claude Provost,Canadiens,67,50,20,30
266,Claude Provost,Canadiens,68,32,15,17
266,Claude Provost,Canadiens,70,64,27,37
266,Claude Provost,Canadiens,70,55,19,36
266,Claude Provost,Canadiens,64,24,11,13
266,Claude Provost,Canadiens,73,44,14,30
266,Claude Provost,Canadiens,73,28,13,15
266,Claude Provost,Canadiens,65,21,10,11
267,Mel Bridgman,Flyers,80,50,23,27
267,Mel Bridgman,Flyers,70,57,19,38
267,Mel Bridgman,Flyers,76,48,16,32
267,Mel Bridgman,Flyers,76,59,24,35
267,Mel Bridgman,Flyers,74,47,16,31
267,Mel Bridgman,Flyers,77,51,14,37
267,Mel Bridgman,Flyers,9,12,7,5
267,Mel Bridgman,Flames,63,75,26,49
267,Mel Bridgman,Flames,79,50,19,31
267,Mel Bridgman,Devils,79,61,23,38
267,Mel Bridgman,Devils,80,61,22,39
267,Mel Bridgman,Devils,78,63,23,40
267,Mel Bridgman,Devils,51,39,8,31
267,Mel Bridgman,Red Wings,13,4,2,2
267,Mel Bridgman,Red Wings,57,17,6,11
267,Mel Bridgman,Canucks,15,7,4,3
268,Craig Ramsay,Sabres,57,16,6,10
268,Craig Ramsay,Sabres,76,28,11,17
268,Craig Ramsay,Sabres,78,46,20,26
268,Craig Ramsay,Sabres,80,64,26,38
268,Craig Ramsay,Sabres,80,71,22,49
268,Craig Ramsay,Sabres,80,61,20,41
268,Craig Ramsay,Sabres,80,71,28,43
268,Craig Ramsay,Sabres,80,57,26,31
268,Craig Ramsay,Sabres,80,60,21,39
268,Craig Ramsay,Sabres,80,59,24,35
268,Craig Ramsay,Sabres,80,51,16,35
268,Craig Ramsay,Sabres,64,29,11,18
268,Craig Ramsay,Sabres,76,26,9,17
268,Craig Ramsay,Sabres,79,33,12,21
269,Anton Stastny,Nordiques,80,85,39,46
269,Anton Stastny,Nordiques,68,72,26,46
269,Anton Stastny,Nordiques,79,92,32,60
269,Anton Stastny,Nordiques,69,62,25,37
269,Anton Stastny,Nordiques,79,80,38,42
269,Anton Stastny,Nordiques,74,74,31,43
269,Anton Stastny,Nordiques,77,62,27,35
269,Anton Stastny,Nordiques,69,72,27,45
269,Anton Stastny,Nordiques,55,37,7,30
270,Robert Reichel,Flames,66,41,19,22
270,Robert Reichel,Flames,77,54,20,34
270,Robert Reichel,Flames,80,88,40,48
270,Robert Reichel,Flames,84,93,40,53
270,Robert Reichel,Flames,48,35,18,17
270,Robert Reichel,Flames,70,43,16,27
270,Robert Reichel,Islanders,12,19,5,14
270,Robert Reichel,Islanders,82,65,25,40
270,Robert Reichel,Islanders,70,56,19,37
270,Robert Reichel,Coyotes,13,13,7,6
270,Robert Reichel,Maple Leafs,78,51,20,31
270,Robert Reichel,Maple Leafs,81,42,12,30
270,Robert Reichel,Maple Leafs,69,30,11,19
271,Kenny Wharram,Blackhawks,1,0,0,0
271,Kenny Wharram,Blackhawks,29,8,1,7
271,Kenny Wharram,Blackhawks,3,0,0,0
271,Kenny Wharram,Blackhawks,66,19,10,9
271,Kenny Wharram,Blackhawks,59,25,14,11
271,Kenny Wharram,Blackhawks,64,45,16,29
271,Kenny Wharram,Blackhawks,62,37,14,23
271,Kenny Wharram,Blackhawks,55,38,20,18
271,Kenny Wharram,Blackhawks,70,71,39,32
271,Kenny Wharram,Blackhawks,68,44,24,20
271,Kenny Wharram,Blackhawks,69,43,26,17
271,Kenny Wharram,Blackhawks,70,65,31,34
271,Kenny Wharram,Blackhawks,74,69,27,42
271,Kenny Wharram,Blackhawks,76,69,30,39
272,Evgeni Malkin,Penguins,78,85,33,52
272,Evgeni Malkin,Penguins,82,106,47,59
272,Evgeni Malkin,Penguins,82,113,35,78
272,Evgeni Malkin,Penguins,67,77,28,49
272,Evgeni Malkin,Penguins,43,37,15,22
272,Evgeni Malkin,Penguins,75,109,50,59
272,Evgeni Malkin,Penguins,31,33,9,24
272,Evgeni Malkin,Penguins,60,72,23,49
272,Evgeni Malkin,Penguins,22,28,11,17
273,Mats Naslund,Canadiens,74,71,26,45
273,Mats Naslund,Canadiens,77,64,29,35
273,Mats Naslund,Canadiens,80,79,42,37
273,Mats Naslund,Canadiens,80,110,43,67
273,Mats Naslund,Canadiens,79,80,25,55
273,Mats Naslund,Canadiens,78,83,24,59
273,Mats Naslund,Canadiens,77,84,33,51
273,Mats Naslund,Canadiens,72,41,21,20
273,Mats Naslund,Bruins,34,22,8,14
274,Brian Gionta,Devils,33,11,4,7
274,Brian Gionta,Devils,58,25,12,13
274,Brian Gionta,Devils,75,29,21,8
274,Brian Gionta,Devils,82,89,48,41
274,Brian Gionta,Devils,62,45,25,20
274,Brian Gionta,Devils,82,53,22,31
274,Brian Gionta,Devils,81,60,20,40
274,Brian Gionta,Canadiens,61,46,28,18
274,Brian Gionta,Canadiens,82,46,29,17
274,Brian Gionta,Canadiens,31,15,8,7
274,Brian Gionta,Canadiens,48,26,14,12
274,Brian Gionta,Canadiens,81,40,18,22
274,Brian Gionta,Sabres,23,7,2,5
275,Eric Nesterenko,Maple Leafs,1,0,0,0
275,Eric Nesterenko,Maple Leafs,35,16,10,6
275,Eric Nesterenko,Maple Leafs,68,23,14,9
275,Eric Nesterenko,Maple Leafs,62,30,15,15
275,Eric Nesterenko,Maple Leafs,40,10,4,6
275,Eric Nesterenko,Blackhawks,24,23,8,15
275,Eric Nesterenko,Blackhawks,70,38,20,18
275,Eric Nesterenko,Blackhawks,70,34,16,18
275,Eric Nesterenko,Blackhawks,61,36,13,23
275,Eric Nesterenko,Blackhawks,68,38,19,19
275,Eric Nesterenko,Blackhawks,68,29,15,14
275,Eric Nesterenko,Blackhawks,67,27,12,15
275,Eric Nesterenko,Blackhawks,70,26,7,19
275,Eric Nesterenko,Blackhawks,56,30,14,16
275,Eric Nesterenko,Blackhawks,67,40,15,25
275,Eric Nesterenko,Blackhawks,68,37,14,23
275,Eric Nesterenko,Blackhawks,71,36,11,25
275,Eric Nesterenko,Blackhawks,72,32,15,17
275,Eric Nesterenko,Blackhawks,67,34,16,18
275,Eric Nesterenko,Blackhawks,76,23,8,15
275,Eric Nesterenko,Blackhawks,38,12,4,8
276,Peter Forsberg,Nordiques,47,50,15,35
276,Peter Forsberg,Avalanche,82,116,30,86
276,Peter Forsberg,Avalanche,65,86,28,58
276,Peter Forsberg,Avalanche,72,91,25,66
276,Peter Forsberg,Avalanche,78,97,30,67
276,Peter Forsberg,Avalanche,49,51,14,37
276,Peter Forsberg,Avalanche,73,89,27,62
276,Peter Forsberg,Avalanche,75,106,29,77
276,Peter Forsberg,Avalanche,39,55,18,37
276,Peter Forsberg,Flyers,60,75,19,56
276,Peter Forsberg,Flyers,40,40,11,29
276,Peter Forsberg,Predators,17,15,2,13
276,Peter Forsberg,Avalanche,9,14,1,13
276,Peter Forsberg,Avalanche,2,0,0,0
277,Alexei Zhamnov,Jets (1979),68,72,25,47
277,Alexei Zhamnov,Jets (1979),61,71,26,45
277,Alexei Zhamnov,Jets (1979),48,65,30,35
277,Alexei Zhamnov,Jets (1979),58,59,22,37
277,Alexei Zhamnov,Blackhawks,74,62,20,42
277,Alexei Zhamnov,Blackhawks,70,49,21,28
277,Alexei Zhamnov,Blackhawks,76,61,20,41
277,Alexei Zhamnov,Blackhawks,71,60,23,37
277,Alexei Zhamnov,Blackhawks,63,49,13,36
277,Alexei Zhamnov,Blackhawks,77,67,22,45
277,Alexei Zhamnov,Blackhawks,74,58,15,43
277,Alexei Zhamnov,Blackhawks,23,18,6,12
277,Alexei Zhamnov,Flyers,20,18,5,13
277,Alexei Zhamnov,Bruins,24,10,1,9
278,Lucien DeBlois,Rangers,71,30,22,8
278,Lucien DeBlois,Rangers,62,28,11,17
278,Lucien DeBlois,Rangers,6,4,3,1
278,Lucien DeBlois,Rockies,70,43,24,19
278,Lucien DeBlois,Rockies,74,42,26,16
278,Lucien DeBlois,Jets (1979),65,52,25,27
278,Lucien DeBlois,Jets (1979),79,54,27,27
278,Lucien DeBlois,Jets (1979),80,79,34,45
278,Lucien DeBlois,Canadiens,51,23,12,11
278,Lucien DeBlois,Canadiens,61,31,14,17
278,Lucien DeBlois,Rangers,40,11,3,8
278,Lucien DeBlois,Rangers,74,30,9,21
278,Lucien DeBlois,Rangers,73,33,9,24
278,Lucien DeBlois,Nordiques,70,17,9,8
278,Lucien DeBlois,Nordiques,14,4,2,2
278,Lucien DeBlois,Maple Leafs,38,22,10,12
278,Lucien DeBlois,Maple Leafs,54,19,8,11
278,Lucien DeBlois,Jets (1979),11,3,1,2
279,Zach Parise,Devils,81,32,14,18
279,Zach Parise,Devils,82,62,31,31
279,Zach Parise,Devils,81,65,32,33
279,Zach Parise,Devils,82,94,45,49
279,Zach Parise,Devils,81,82,38,44
279,Zach Parise,Devils,13,6,3,3
279,Zach Parise,Devils,82,69,31,38
279,Zach Parise,Wild,48,38,18,20
279,Zach Parise,Wild,67,56,29,27
279,Zach Parise,Wild,17,17,8,9
280,Erik Cole,Hurricanes,81,40,16,24
280,Erik Cole,Hurricanes,53,27,14,13
280,Erik Cole,Hurricanes,80,42,18,24
280,Erik Cole,Hurricanes,60,59,30,29
280,Erik Cole,Hurricanes,71,61,29,32
280,Erik Cole,Hurricanes,73,51,22,29
280,Erik Cole,Oilers,63,27,16,11
280,Erik Cole,Hurricanes,17,15,2,13
280,Erik Cole,Hurricanes,40,16,11,5
280,Erik Cole,Hurricanes,82,52,26,26
280,Erik Cole,Canadiens,82,61,35,26
280,Erik Cole,Canadiens,19,6,3,3
280,Erik Cole,Stars,28,7,6,1
280,Erik Cole,Stars,75,29,16,13
280,Erik Cole,Stars,22,8,5,3
281,Doug Mohns,Bruins,70,27,13,14
281,Doug Mohns,Bruins,70,32,14,18
281,Doug Mohns,Bruins,64,18,10,8
281,Doug Mohns,Bruins,68,40,6,34
281,Doug Mohns,Bruins,54,21,5,16
281,Doug Mohns,Bruins,47,30,6,24
281,Doug Mohns,Bruins,65,45,20,25
281,Doug Mohns,Bruins,65,33,12,21
281,Doug Mohns,Bruins,69,45,16,29
281,Doug Mohns,Bruins,68,30,7,23
281,Doug Mohns,Bruins,70,26,9,17
281,Doug Mohns,Blackhawks,49,33,13,20
281,Doug Mohns,Blackhawks,70,49,22,27
281,Doug Mohns,Blackhawks,61,60,25,35
281,Doug Mohns,Blackhawks,65,53,24,29
281,Doug Mohns,Blackhawks,65,41,22,19
281,Doug Mohns,Blackhawks,66,33,6,27
281,Doug Mohns,Blackhawks,39,10,4,6
281,Doug Mohns,North Stars,17,7,2,5
281,Doug Mohns,North Stars,78,36,6,30
281,Doug Mohns,North Stars,67,17,4,13
281,Doug Mohns,Flames,28,3,0,3
281,Doug Mohns,Capitals,75,21,2,19
282,Tony Granato,Rangers,78,63,36,27
282,Tony Granato,Rangers,37,25,7,18
282,Tony Granato,Kings,19,11,5,6
282,Tony Granato,Kings,68,64,30,34
282,Tony Granato,Kings,80,68,39,29
282,Tony Granato,Kings,81,82,37,45
282,Tony Granato,Kings,50,21,7,14
282,Tony Granato,Kings,33,24,13,11
282,Tony Granato,Kings,49,35,17,18
282,Tony Granato,Sharks,76,40,25,15
282,Tony Granato,Sharks,59,25,16,9
282,Tony Granato,Sharks,35,12,6,6
282,Tony Granato,Sharks,48,13,6,7
282,Tony Granato,Sharks,60,9,4,5
283,Steven Stamkos,Lightning,79,46,23,23
283,Steven Stamkos,Lightning,82,95,51,44
283,Steven Stamkos,Lightning,82,91,45,46
283,Steven Stamkos,Lightning,82,97,60,37
283,Steven Stamkos,Lightning,48,57,29,28
283,Steven Stamkos,Lightning,37,40,25,15
283,Steven Stamkos,Lightning,23,27,15,12
284,Cy Denneny,Senators (1917),20,46,36,10
284,Cy Denneny,Senators (1917),18,22,18,4
284,Cy Denneny,Senators (1917),24,22,16,6
284,Cy Denneny,Senators (1917),24,39,34,5
284,Cy Denneny,Senators (1917),22,39,27,12
284,Cy Denneny,Senators (1917),24,34,23,11
284,Cy Denneny,Senators (1917),22,24,22,2
284,Cy Denneny,Senators (1917),29,42,27,15
284,Cy Denneny,Senators (1917),36,36,24,12
284,Cy Denneny,Senators (1917),42,23,17,6
284,Cy Denneny,Senators (1917),44,3,3,0
284,Cy Denneny,Bruins,23,3,1,2
285,Brian Leetch,Rangers,17,14,2,12
285,Brian Leetch,Rangers,68,71,23,48
285,Brian Leetch,Rangers,72,56,11,45
285,Brian Leetch,Rangers,80,88,16,72
285,Brian Leetch,Rangers,80,102,22,80
285,Brian Leetch,Rangers,36,36,6,30
285,Brian Leetch,Rangers,84,79,23,56
285,Brian Leetch,Rangers,48,41,9,32
285,Brian Leetch,Rangers,82,85,15,70
285,Brian Leetch,Rangers,82,78,20,58
285,Brian Leetch,Rangers,76,50,17,33
285,Brian Leetch,Rangers,82,55,13,42
285,Brian Leetch,Rangers,50,26,7,19
285,Brian Leetch,Rangers,82,79,21,58
285,Brian Leetch,Rangers,82,55,10,45
285,Brian Leetch,Rangers,51,30,12,18
285,Brian Leetch,Rangers,57,36,13,23
285,Brian Leetch,Maple Leafs,15,15,2,13
285,Brian Leetch,Bruins,61,32,5,27
286,Yanic Perreault,Maple Leafs,13,6,3,3
286,Yanic Perreault,Kings,26,7,2,5
286,Yanic Perreault,Kings,78,49,25,24
286,Yanic Perreault,Kings,41,25,11,14
286,Yanic Perreault,Kings,79,48,28,20
286,Yanic Perreault,Kings,64,27,10,17
286,Yanic Perreault,Maple Leafs,12,15,7,8
286,Yanic Perreault,Maple Leafs,58,45,18,27
286,Yanic Perreault,Maple Leafs,76,52,24,28
286,Yanic Perreault,Canadiens,82,56,27,29
286,Yanic Perreault,Canadiens,73,46,24,22
286,Yanic Perreault,Canadiens,69,31,16,15
286,Yanic Perreault,Predators,69,57,22,35
286,Yanic Perreault,Coyotes,49,33,19,14
286,Yanic Perreault,Maple Leafs,17,5,2,3
286,Yanic Perreault,Blackhawks,53,14,9,5
287,Craig Simpson,Penguins,76,28,11,17
287,Craig Simpson,Penguins,72,51,26,25
287,Craig Simpson,Penguins,21,26,13,13
287,Craig Simpson,Oilers,59,64,43,21
287,Craig Simpson,Oilers,66,76,35,41
287,Craig Simpson,Oilers,80,61,29,32
287,Craig Simpson,Oilers,75,57,30,27
287,Craig Simpson,Oilers,79,61,24,37
287,Craig Simpson,Oilers,60,46,24,22
287,Craig Simpson,Sabres,22,16,8,8
287,Craig Simpson,Sabres,24,11,4,7
288,Steve Vickers,Rangers,61,53,30,23
288,Steve Vickers,Rangers,75,58,34,24
288,Steve Vickers,Rangers,80,89,41,48
288,Steve Vickers,Rangers,80,83,30,53
288,Steve Vickers,Rangers,75,53,22,31
288,Steve Vickers,Rangers,79,63,19,44
288,Steve Vickers,Rangers,66,47,13,34
288,Steve Vickers,Rangers,75,62,29,33
288,Steve Vickers,Rangers,73,58,19,39
288,Steve Vickers,Rangers,34,20,9,11
289,Mike Cammalleri,Kings,28,8,5,3
289,Mike Cammalleri,Kings,31,15,9,6
289,Mike Cammalleri,Kings,80,55,26,29
289,Mike Cammalleri,Kings,81,80,34,46
289,Mike Cammalleri,Kings,63,47,19,28
289,Mike Cammalleri,Flames,81,82,39,43
289,Mike Cammalleri,Canadiens,65,50,26,24
289,Mike Cammalleri,Canadiens,67,47,19,28
289,Mike Cammalleri,Canadiens,38,22,9,13
289,Mike Cammalleri,Flames,28,19,11,8
289,Mike Cammalleri,Flames,44,32,13,19
289,Mike Cammalleri,Flames,63,45,26,19
289,Mike Cammalleri,Devils,17,14,10,4
290,Bobby Rousseau,Canadiens,15,3,1,2
290,Bobby Rousseau,Canadiens,70,45,21,24
290,Bobby Rousseau,Canadiens,62,37,19,18
290,Bobby Rousseau,Canadiens,70,56,25,31
290,Bobby Rousseau,Canadiens,66,47,12,35
290,Bobby Rousseau,Canadiens,70,78,30,48
290,Bobby Rousseau,Canadiens,68,63,19,44
290,Bobby Rousseau,Canadiens,74,65,19,46
290,Bobby Rousseau,Canadiens,76,70,30,40
290,Bobby Rousseau,Canadiens,72,58,24,34
290,Bobby Rousseau,North Stars,63,24,4,20
290,Bobby Rousseau,Rangers,78,57,21,36
290,Bobby Rousseau,Rangers,78,45,8,37
290,Bobby Rousseau,Rangers,72,51,10,41
290,Bobby Rousseau,Rangers,8,4,2,2
291,Max Bentley,Blackhawks,36,17,7,10
291,Max Bentley,Blackhawks,39,30,13,17
291,Max Bentley,Blackhawks,47,70,26,44
291,Max Bentley,Blackhawks,47,61,31,30
291,Max Bentley,Blackhawks,60,72,29,43
291,Max Bentley,Blackhawks,6,6,3,3
291,Max Bentley,Maple Leafs,53,48,23,25
291,Max Bentley,Maple Leafs,60,41,19,22
291,Max Bentley,Maple Leafs,69,41,23,18
291,Max Bentley,Maple Leafs,67,62,21,41
291,Max Bentley,Maple Leafs,69,41,24,17
291,Max Bentley,Maple Leafs,36,23,12,11
291,Max Bentley,Rangers,57,32,14,18
292,Esa Tikkanen,Oilers,35,13,7,6
292,Esa Tikkanen,Oilers,76,78,34,44
292,Esa Tikkanen,Oilers,80,74,23,51
292,Esa Tikkanen,Oilers,67,78,31,47
292,Esa Tikkanen,Oilers,79,63,30,33
292,Esa Tikkanen,Oilers,79,69,27,42
292,Esa Tikkanen,Oilers,40,28,12,16
292,Esa Tikkanen,Oilers,66,33,14,19
292,Esa Tikkanen,Rangers,15,7,2,5
292,Esa Tikkanen,Rangers,83,54,22,32
292,Esa Tikkanen,Blues,43,35,12,23
292,Esa Tikkanen,Blues,11,5,1,4
292,Esa Tikkanen,Devils,9,2,0,2
292,Esa Tikkanen,Canucks,38,37,13,24
292,Esa Tikkanen,Canucks,62,27,12,15
292,Esa Tikkanen,Rangers,14,3,1,2
292,Esa Tikkanen,Panthers,28,9,1,8
292,Esa Tikkanen,Capitals,20,12,2,10
292,Esa Tikkanen,Rangers,32,3,0,3
293,Jamie Langenbrunner,Stars,2,0,0,0
293,Jamie Langenbrunner,Stars,12,4,2,2
293,Jamie Langenbrunner,Stars,76,39,13,26
293,Jamie Langenbrunner,Stars,81,52,23,29
293,Jamie Langenbrunner,Stars,75,45,12,33
293,Jamie Langenbrunner,Stars,65,39,18,21
293,Jamie Langenbrunner,Stars,53,30,12,18
293,Jamie Langenbrunner,Stars,68,26,10,16
293,Jamie Langenbrunner,Devils,14,6,3,3
293,Jamie Langenbrunner,Devils,78,55,22,33
293,Jamie Langenbrunner,Devils,53,26,10,16
293,Jamie Langenbrunner,Devils,80,53,19,34
293,Jamie Langenbrunner,Devils,82,60,23,37
293,Jamie Langenbrunner,Devils,64,41,13,28
293,Jamie Langenbrunner,Devils,81,69,29,40
293,Jamie Langenbrunner,Devils,81,61,19,42
293,Jamie Langenbrunner,Devils,31,14,4,10
293,Jamie Langenbrunner,Stars,39,18,5,13
293,Jamie Langenbrunner,Blues,70,24,6,18
293,Jamie Langenbrunner,Blues,4,1,0,1
294,Mike Ricci,Flyers,68,41,21,20
294,Mike Ricci,Flyers,78,56,20,36
294,Mike Ricci,Nordiques,77,78,27,51
294,Mike Ricci,Nordiques,83,51,30,21
294,Mike Ricci,Nordiques,48,36,15,21
294,Mike Ricci,Avalanche,62,27,6,21
294,Mike Ricci,Avalanche,63,32,13,19
294,Mike Ricci,Avalanche,6,4,0,4
294,Mike Ricci,Sharks,59,23,9,14
294,Mike Ricci,Sharks,82,39,13,26
294,Mike Ricci,Sharks,82,44,20,24
294,Mike Ricci,Sharks,81,44,22,22
294,Mike Ricci,Sharks,79,53,19,34
294,Mike Ricci,Sharks,75,34,11,23
294,Mike Ricci,Sharks,71,26,7,19
294,Mike Ricci,Coyotes,78,16,10,6
294,Mike Ricci,Coyotes,7,1,0,1
295,Tomas Holmstrom,Red Wings,47,9,6,3
295,Tomas Holmstrom,Red Wings,57,22,5,17
295,Tomas Holmstrom,Red Wings,82,34,13,21
295,Tomas Holmstrom,Red Wings,72,35,13,22
295,Tomas Holmstrom,Red Wings,73,40,16,24
295,Tomas Holmstrom,Red Wings,69,26,8,18
295,Tomas Holmstrom,Red Wings,74,40,20,20
295,Tomas Holmstrom,Red Wings,67,30,15,15
295,Tomas Holmstrom,Red Wings,81,59,29,30
295,Tomas Holmstrom,Red Wings,77,52,30,22
295,Tomas Holmstrom,Red Wings,59,40,20,20
295,Tomas Holmstrom,Red Wings,53,37,14,23
295,Tomas Holmstrom,Red Wings,68,45,25,20
295,Tomas Holmstrom,Red Wings,73,37,18,19
295,Tomas Holmstrom,Red Wings,74,24,11,13
296,Jere Lehtinen,Stars,57,28,6,22
296,Jere Lehtinen,Stars,63,43,16,27
296,Jere Lehtinen,Stars,72,42,23,19
296,Jere Lehtinen,Stars,74,52,20,32
296,Jere Lehtinen,Stars,17,8,3,5
296,Jere Lehtinen,Stars,74,45,20,25
296,Jere Lehtinen,Stars,73,49,25,24
296,Jere Lehtinen,Stars,80,48,31,17
296,Jere Lehtinen,Stars,58,26,13,13
296,Jere Lehtinen,Stars,80,52,33,19
296,Jere Lehtinen,Stars,73,43,26,17
296,Jere Lehtinen,Stars,48,37,15,22
296,Jere Lehtinen,Stars,48,24,8,16
296,Jere Lehtinen,Stars,58,17,4,13
297,Marco Sturm,Sharks,74,30,10,20
297,Marco Sturm,Sharks,78,38,16,22
297,Marco Sturm,Sharks,74,27,12,15
297,Marco Sturm,Sharks,81,32,14,18
297,Marco Sturm,Sharks,77,41,21,20
297,Marco Sturm,Sharks,82,48,28,20
297,Marco Sturm,Sharks,64,41,21,20
297,Marco Sturm,Sharks,23,16,6,10
297,Marco Sturm,Bruins,51,43,23,20
297,Marco Sturm,Bruins,76,44,27,17
297,Marco Sturm,Bruins,80,56,27,29
297,Marco Sturm,Bruins,19,13,7,6
297,Marco Sturm,Bruins,76,37,22,15
297,Marco Sturm,Kings,17,9,4,5
297,Marco Sturm,Capitals,18,7,1,6
297,Marco Sturm,Canucks,6,0,0,0
297,Marco Sturm,Panthers,42,5,3,2
298,Martin Rucinsky,Oilers,2,0,0,0
298,Martin Rucinsky,Nordiques,4,2,1,1
298,Martin Rucinsky,Nordiques,77,48,18,30
298,Martin Rucinsky,Nordiques,60,32,9,23
298,Martin Rucinsky,Nordiques,20,9,3,6
298,Martin Rucinsky,Avalanche,22,15,4,11
298,Martin Rucinsky,Canadiens,56,60,25,35
298,Martin Rucinsky,Canadiens,70,55,28,27
298,Martin Rucinsky,Canadiens,78,53,21,32
298,Martin Rucinsky,Canadiens,73,34,17,17
298,Martin Rucinsky,Canadiens,80,49,25,24
298,Martin Rucinsky,Canadiens,57,38,16,22
298,Martin Rucinsky,Canadiens,18,8,2,6
298,Martin Rucinsky,Stars,42,17,6,11
298,Martin Rucinsky,Rangers,15,13,3,10
298,Martin Rucinsky,Blues,61,30,16,14
298,Martin Rucinsky,Rangers,69,42,13,29
298,Martin Rucinsky,Canucks,13,3,1,2
298,Martin Rucinsky,Rangers,52,55,16,39
298,Martin Rucinsky,Blues,52,33,12,21
298,Martin Rucinsky,Blues,40,16,5,11
299,Mike Krushelnyski,Bruins,17,6,3,3
299,Mike Krushelnyski,Bruins,79,65,23,42
299,Mike Krushelnyski,Bruins,66,45,25,20
299,Mike Krushelnyski,Oilers,80,88,43,45
299,Mike Krushelnyski,Oilers,54,40,16,24
299,Mike Krushelnyski,Oilers,80,51,16,35
299,Mike Krushelnyski,Oilers,76,47,20,27
299,Mike Krushelnyski,Kings,78,62,26,36
299,Mike Krushelnyski,Kings,63,41,16,25
299,Mike Krushelnyski,Kings,15,6,1,5
299,Mike Krushelnyski,Maple Leafs,59,39,17,22
299,Mike Krushelnyski,Maple Leafs,72,24,9,15
299,Mike Krushelnyski,Maple Leafs,84,39,19,20
299,Mike Krushelnyski,Maple Leafs,54,11,5,6
299,Mike Krushelnyski,Red Wings,20,5,2,3
300,Dave Williams,Maple Leafs,42,29,10,19
300,Dave Williams,Maple Leafs,78,40,21,19
300,Dave Williams,Maple Leafs,77,43,18,25
300,Dave Williams,Maple Leafs,78,50,19,31
300,Dave Williams,Maple Leafs,77,39,19,20
300,Dave Williams,Maple Leafs,55,40,22,18
300,Dave Williams,Canucks,23,13,8,5
300,Dave Williams,Canucks,77,62,35,27
300,Dave Williams,Canucks,77,38,17,21
300,Dave Williams,Canucks,68,21,8,13
300,Dave Williams,Canucks,67,31,15,16
300,Dave Williams,Red Wings,55,11,3,8
300,Dave Williams,Kings,12,7,4,3
300,Dave Williams,Kings,72,49,20,29
300,Dave Williams,Kings,76,34,16,18
300,Dave Williams,Kings,2,0,0,0
300,Dave Williams,Whalers,26,6,6,0
301,Busher Jackson,Maple Leafs,31,18,12,6
301,Busher Jackson,Maple Leafs,43,31,18,13
301,Busher Jackson,Maple Leafs,48,53,28,25
301,Busher Jackson,Maple Leafs,48,44,27,17
301,Busher Jackson,Maple Leafs,38,38,20,18
301,Busher Jackson,Maple Leafs,42,44,22,22
301,Busher Jackson,Maple Leafs,47,22,11,11
301,Busher Jackson,Maple Leafs,46,40,21,19
301,Busher Jackson,Maple Leafs,48,34,17,17
301,Busher Jackson,Maple Leafs,41,27,10,17
301,Busher Jackson,Americans,43,20,12,8
301,Busher Jackson,Americans,46,26,8,18
301,Busher Jackson,Bruins,26,12,5,7
301,Busher Jackson,Bruins,44,34,19,15
301,Busher Jackson,Bruins,42,32,11,21
302,Rob Blake,Kings,4,0,0,0
302,Rob Blake,Kings,75,46,12,34
302,Rob Blake,Kings,57,20,7,13
302,Rob Blake,Kings,76,59,16,43
302,Rob Blake,Kings,84,68,20,48
302,Rob Blake,Kings,24,11,4,7
302,Rob Blake,Kings,6,3,1,2
302,Rob Blake,Kings,62,31,8,23
302,Rob Blake,Kings,81,50,23,27
302,Rob Blake,Kings,62,35,12,23
302,Rob Blake,Kings,77,57,18,39
302,Rob Blake,Kings,54,49,17,32
302,Rob Blake,Avalanche,13,10,2,8
302,Rob Blake,Avalanche,75,56,16,40
302,Rob Blake,Avalanche,79,45,17,28
302,Rob Blake,Avalanche,74,46,13,33
302,Rob Blake,Avalanche,81,51,14,37
302,Rob Blake,Kings,72,34,14,20
302,Rob Blake,Kings,71,31,9,22
302,Rob Blake,Sharks,73,45,10,35
302,Rob Blake,Sharks,70,30,7,23
303,Reginald MacAdam,Flyers,5,0,0,0
303,Reginald MacAdam,Seals,80,43,18,25
303,Reginald MacAdam,Seals,80,63,32,31
303,Reginald MacAdam,Barons,80,63,22,41
303,Reginald MacAdam,Barons,80,48,16,32
303,Reginald MacAdam,North Stars,69,58,24,34
303,Reginald MacAdam,North Stars,80,93,42,51
303,Reginald MacAdam,North Stars,78,60,21,39
303,Reginald MacAdam,North Stars,79,61,18,43
303,Reginald MacAdam,North Stars,73,33,11,22
303,Reginald MacAdam,North Stars,80,35,22,13
303,Reginald MacAdam,Canucks,80,34,14,20
304,Mike Sillinger,Red Wings,3,1,0,1
304,Mike Sillinger,Red Wings,51,21,4,17
304,Mike Sillinger,Red Wings,62,29,8,21
304,Mike Sillinger,Red Wings,13,8,2,6
304,Mike Sillinger,Ducks,15,7,2,5
304,Mike Sillinger,Ducks,62,34,13,21
304,Mike Sillinger,Canucks,12,4,1,3
304,Mike Sillinger,Canucks,78,37,17,20
304,Mike Sillinger,Canucks,48,19,10,9
304,Mike Sillinger,Flyers,27,22,11,11
304,Mike Sillinger,Flyers,25,3,0,3
304,Mike Sillinger,Lightning,54,10,8,2
304,Mike Sillinger,Lightning,67,44,19,25
304,Mike Sillinger,Panthers,13,8,4,4
304,Mike Sillinger,Panthers,55,34,13,21
304,Mike Sillinger,Senators,13,7,3,4
304,Mike Sillinger,Blue Jackets,80,43,20,23
304,Mike Sillinger,Blue Jackets,75,43,18,25
304,Mike Sillinger,Coyotes,60,14,8,6
304,Mike Sillinger,Blues,16,10,5,5
304,Mike Sillinger,Blues,48,41,22,19
304,Mike Sillinger,Predators,31,22,10,12
304,Mike Sillinger,Islanders,82,59,26,33
304,Mike Sillinger,Islanders,52,26,14,12
304,Mike Sillinger,Islanders,7,2,2,0
305,Robert Gainey,Canadiens,66,10,3,7
305,Robert Gainey,Canadiens,80,37,17,20
305,Robert Gainey,Canadiens,78,28,15,13
305,Robert Gainey,Canadiens,80,33,14,19
305,Robert Gainey,Canadiens,66,31,15,16
305,Robert Gainey,Canadiens,79,38,20,18
305,Robert Gainey,Canadiens,64,33,14,19
305,Robert Gainey,Canadiens,78,47,23,24
305,Robert Gainey,Canadiens,79,45,21,24
305,Robert Gainey,Canadiens,80,30,12,18
305,Robert Gainey,Canadiens,77,39,17,22
305,Robert Gainey,Canadiens,79,32,19,13
305,Robert Gainey,Canadiens,80,43,20,23
305,Robert Gainey,Canadiens,47,16,8,8
305,Robert Gainey,Canadiens,78,22,11,11
305,Robert Gainey,Canadiens,49,17,10,7
306,Eddie Shack,Rangers,67,21,7,14
306,Eddie Shack,Rangers,62,18,8,10
306,Eddie Shack,Rangers,12,3,1,2
306,Eddie Shack,Maple Leafs,55,28,14,14
306,Eddie Shack,Maple Leafs,44,21,7,14
306,Eddie Shack,Maple Leafs,63,25,16,9
306,Eddie Shack,Maple Leafs,64,21,11,10
306,Eddie Shack,Maple Leafs,67,14,5,9
306,Eddie Shack,Maple Leafs,63,43,26,17
306,Eddie Shack,Maple Leafs,63,25,11,14
306,Eddie Shack,Bruins,70,42,23,19
306,Eddie Shack,Bruins,50,22,11,11
306,Eddie Shack,Kings,73,34,22,12
306,Eddie Shack,Kings,11,4,2,2
306,Eddie Shack,Sabres,56,42,25,17
306,Eddie Shack,Sabres,50,25,11,14
306,Eddie Shack,Penguins,18,14,5,9
306,Eddie Shack,Penguins,74,45,25,20
306,Eddie Shack,Maple Leafs,59,15,7,8
306,Eddie Shack,Maple Leafs,26,3,2,1
307,Barry Pederson,Bruins,9,5,1,4
307,Barry Pederson,Bruins,80,92,44,48
307,Barry Pederson,Bruins,77,107,46,61
307,Barry Pederson,Bruins,80,116,39,77
307,Barry Pederson,Bruins,22,12,4,8
307,Barry Pederson,Bruins,79,76,29,47
307,Barry Pederson,Canucks,79,76,24,52
307,Barry Pederson,Canucks,76,71,19,52
307,Barry Pederson,Canucks,62,41,15,26
307,Barry Pederson,Canucks,16,9,2,7
307,Barry Pederson,Penguins,38,22,4,18
307,Barry Pederson,Penguins,46,14,6,8
307,Barry Pederson,Whalers,5,4,2,2
307,Barry Pederson,Bruins,32,9,3,6
308,Jean-Paul Parise,Bruins,3,0,0,0
308,Jean-Paul Parise,Bruins,18,4,2,2
308,Jean-Paul Parise,Maple Leafs,1,1,0,1
308,Jean-Paul Parise,North Stars,43,27,11,16
308,Jean-Paul Parise,North Stars,76,49,22,27
308,Jean-Paul Parise,North Stars,74,72,24,48
308,Jean-Paul Parise,North Stars,73,34,11,23
308,Jean-Paul Parise,North Stars,71,37,19,18
308,Jean-Paul Parise,North Stars,78,75,27,48
308,Jean-Paul Parise,North Stars,78,55,18,37
308,Jean-Paul Parise,North Stars,38,25,9,16
308,Jean-Paul Parise,Islanders,41,30,14,16
308,Jean-Paul Parise,Islanders,80,57,22,35
308,Jean-Paul Parise,Islanders,80,56,25,31
308,Jean-Paul Parise,Islanders,39,28,12,16
308,Jean-Paul Parise,Barons,40,22,9,13
308,Jean-Paul Parise,North Stars,57,22,13,9
309,Martin Havlat,Senators,73,42,19,23
309,Martin Havlat,Senators,72,50,22,28
309,Martin Havlat,Senators,67,59,24,35
309,Martin Havlat,Senators,68,68,31,37
309,Martin Havlat,Senators,18,16,9,7
309,Martin Havlat,Blackhawks,56,57,25,32
309,Martin Havlat,Blackhawks,35,27,10,17
309,Martin Havlat,Blackhawks,81,77,29,48
309,Martin Havlat,Wild,73,54,18,36
309,Martin Havlat,Wild,78,62,22,40
309,Martin Havlat,Sharks,39,27,7,20
309,Martin Havlat,Sharks,40,18,8,10
309,Martin Havlat,Sharks,48,22,12,10
309,Martin Havlat,Devils,13,6,2,4
310,Mike Murphy,Blues,63,43,20,23
310,Mike Murphy,Blues,64,45,18,27
310,Mike Murphy,Rangers,15,8,4,4
310,Mike Murphy,Rangers,16,3,2,1
310,Mike Murphy,Kings,53,29,13,16
310,Mike Murphy,Kings,78,68,30,38
310,Mike Murphy,Kings,80,68,26,42
310,Mike Murphy,Kings,76,61,25,36
310,Mike Murphy,Kings,72,56,20,36
310,Mike Murphy,Kings,64,45,16,29
310,Mike Murphy,Kings,80,49,27,22
310,Mike Murphy,Kings,68,39,16,23
310,Mike Murphy,Kings,28,15,5,10
310,Mike Murphy,Kings,74,27,16,11
311,Douglas Wilson,Blackhawks,77,34,14,20
311,Douglas Wilson,Blackhawks,56,26,5,21
311,Douglas Wilson,Blackhawks,73,61,12,49
311,Douglas Wilson,Blackhawks,76,51,12,39
311,Douglas Wilson,Blackhawks,76,85,39,46
311,Douglas Wilson,Blackhawks,74,69,18,51
311,Douglas Wilson,Blackhawks,66,58,13,45
311,Douglas Wilson,Blackhawks,78,76,22,54
311,Douglas Wilson,Blackhawks,79,64,17,47
311,Douglas Wilson,Blackhawks,69,48,16,32
311,Douglas Wilson,Blackhawks,27,32,8,24
311,Douglas Wilson,Blackhawks,66,62,15,47
311,Douglas Wilson,Blackhawks,70,73,23,50
311,Douglas Wilson,Blackhawks,51,40,11,29
311,Douglas Wilson,Sharks,44,28,9,19
311,Douglas Wilson,Sharks,42,20,3,17
312,Don McKenney,Bruins,69,42,22,20
312,Don McKenney,Bruins,65,34,10,24
312,Don McKenney,Bruins,69,60,21,39
312,Don McKenney,Bruins,70,58,28,30
312,Don McKenney,Bruins,70,62,32,30
312,Don McKenney,Bruins,70,69,20,49
312,Don McKenney,Bruins,68,49,26,23
312,Don McKenney,Bruins,70,55,22,33
312,Don McKenney,Bruins,41,33,14,19
312,Don McKenney,Rangers,21,24,8,16
312,Don McKenney,Rangers,55,26,9,17
312,Don McKenney,Maple Leafs,15,15,9,6
312,Don McKenney,Maple Leafs,52,19,6,13
312,Don McKenney,Red Wings,24,7,1,6
312,Don McKenney,Blues,39,29,9,20
313,Syd Howe,Senators (1917),12,2,1,1
313,Syd Howe,Quakers,44,20,9,11
313,Syd Howe,Maple Leafs,3,0,0,0
313,Syd Howe,Senators (1917),48,24,12,12
313,Syd Howe,Senators (1917),42,20,13,7
313,Syd Howe,Eagles,36,27,14,13
313,Syd Howe,Red Wings,14,20,8,12
313,Syd Howe,Red Wings,48,30,16,14
313,Syd Howe,Red Wings,45,27,17,10
313,Syd Howe,Red Wings,48,27,8,19
313,Syd Howe,Red Wings,48,36,16,20
313,Syd Howe,Red Wings,46,37,14,23
313,Syd Howe,Red Wings,48,44,20,24
313,Syd Howe,Red Wings,48,35,16,19
313,Syd Howe,Red Wings,50,55,20,35
313,Syd Howe,Red Wings,46,60,32,28
313,Syd Howe,Red Wings,46,53,17,36
313,Syd Howe,Red Wings,26,11,4,7
314,Lynn Libett,Red Wings,22,3,2,1
314,Lynn Libett,Red Wings,75,24,10,14
314,Lynn Libett,Red Wings,76,40,20,20
314,Lynn Libett,Red Wings,78,29,16,13
314,Lynn Libett,Red Wings,77,53,31,22
314,Lynn Libett,Red Wings,78,53,19,34
314,Lynn Libett,Red Wings,67,48,24,24
314,Lynn Libett,Red Wings,80,51,23,28
314,Lynn Libett,Red Wings,80,46,20,26
314,Lynn Libett,Red Wings,80,41,14,27
314,Lynn Libett,Red Wings,80,45,23,22
314,Lynn Libett,Red Wings,68,34,15,19
314,Lynn Libett,Penguins,78,26,14,12
314,Lynn Libett,Penguins,43,12,6,6
315,Jeff O'Neill,Whalers,65,27,8,19
315,Jeff O'Neill,Whalers,72,30,14,16
315,Jeff O'Neill,Hurricanes,74,39,19,20
315,Jeff O'Neill,Hurricanes,75,31,16,15
315,Jeff O'Neill,Hurricanes,80,63,25,38
315,Jeff O'Neill,Hurricanes,82,67,41,26
315,Jeff O'Neill,Hurricanes,76,64,31,33
315,Jeff O'Neill,Hurricanes,82,61,30,31
315,Jeff O'Neill,Hurricanes,67,34,14,20
315,Jeff O'Neill,Maple Leafs,74,38,19,19
315,Jeff O'Neill,Maple Leafs,74,42,20,22
316,Patrick Sharp,Flyers,3,0,0,0
316,Patrick Sharp,Flyers,41,7,5,2
316,Patrick Sharp,Flyers,22,8,5,3
316,Patrick Sharp,Blackhawks,50,23,9,14
316,Patrick Sharp,Blackhawks,80,35,20,15
316,Patrick Sharp,Blackhawks,80,62,36,26
316,Patrick Sharp,Blackhawks,61,44,26,18
316,Patrick Sharp,Blackhawks,82,66,25,41
316,Patrick Sharp,Blackhawks,74,71,34,37
316,Patrick Sharp,Blackhawks,74,69,33,36
316,Patrick Sharp,Blackhawks,28,20,6,14
316,Patrick Sharp,Blackhawks,82,78,34,44
316,Patrick Sharp,Blackhawks,13,9,3,6
317,Paul Henderson,Red Wings,2,0,0,0
317,Paul Henderson,Red Wings,32,6,3,3
317,Paul Henderson,Red Wings,70,21,8,13
317,Paul Henderson,Red Wings,69,46,22,24
317,Paul Henderson,Red Wings,46,40,21,19
317,Paul Henderson,Red Wings,50,33,13,20
317,Paul Henderson,Maple Leafs,13,11,5,6
317,Paul Henderson,Maple Leafs,74,59,27,32
317,Paul Henderson,Maple Leafs,67,42,20,22
317,Paul Henderson,Maple Leafs,72,60,30,30
317,Paul Henderson,Maple Leafs,73,57,38,19
317,Paul Henderson,Maple Leafs,40,34,18,16
317,Paul Henderson,Maple Leafs,69,55,24,31
317,Paul Henderson,Flames,30,13,7,6
318,Harry Watson,Americans,47,18,10,8
318,Harry Watson,Red Wings,50,31,13,18
318,Harry Watson,Red Wings,44,24,14,10
318,Harry Watson,Maple Leafs,44,34,19,15
318,Harry Watson,Maple Leafs,57,41,21,20
318,Harry Watson,Maple Leafs,60,45,26,19
318,Harry Watson,Maple Leafs,60,35,19,16
318,Harry Watson,Maple Leafs,68,37,18,19
318,Harry Watson,Maple Leafs,70,39,22,17
318,Harry Watson,Maple Leafs,63,24,16,8
318,Harry Watson,Maple Leafs,70,28,21,7
318,Harry Watson,Maple Leafs,8,2,1,1
318,Harry Watson,Blackhawks,43,30,14,16
318,Harry Watson,Blackhawks,55,25,11,14
318,Harry Watson,Blackhawks,70,30,11,19
319,Tom Fergus,Bruins,61,39,15,24
319,Tom Fergus,Bruins,80,63,28,35
319,Tom Fergus,Bruins,69,61,25,36
319,Tom Fergus,Bruins,79,73,30,43
319,Tom Fergus,Maple Leafs,78,73,31,42
319,Tom Fergus,Maple Leafs,57,49,21,28
319,Tom Fergus,Maple Leafs,63,50,19,31
319,Tom Fergus,Maple Leafs,80,67,22,45
319,Tom Fergus,Maple Leafs,54,45,19,26
319,Tom Fergus,Maple Leafs,14,9,5,4
319,Tom Fergus,Maple Leafs,11,4,1,3
319,Tom Fergus,Canucks,44,34,14,20
319,Tom Fergus,Canucks,36,14,5,9
320,Sergei Samsonov,Bruins,81,47,22,25
320,Sergei Samsonov,Bruins,79,51,25,26
320,Sergei Samsonov,Bruins,77,45,19,26
320,Sergei Samsonov,Bruins,82,75,29,46
320,Sergei Samsonov,Bruins,74,70,29,41
320,Sergei Samsonov,Bruins,8,11,5,6
320,Sergei Samsonov,Bruins,58,40,17,23
320,Sergei Samsonov,Bruins,55,37,18,19
320,Sergei Samsonov,Oilers,19,16,5,11
320,Sergei Samsonov,Canadiens,63,26,9,17
320,Sergei Samsonov,Blackhawks,23,4,0,4
320,Sergei Samsonov,Hurricanes,38,32,14,18
320,Sergei Samsonov,Hurricanes,81,48,16,32
320,Sergei Samsonov,Hurricanes,72,29,14,15
320,Sergei Samsonov,Hurricanes,58,26,10,16
320,Sergei Samsonov,Panthers,20,14,3,11
321,Mark Napier,Canadiens,54,31,11,20
321,Mark Napier,Canadiens,76,49,16,33
321,Mark Napier,Canadiens,79,71,35,36
321,Mark Napier,Canadiens,80,81,40,41
321,Mark Napier,Canadiens,73,67,40,27
321,Mark Napier,Canadiens,5,5,3,2
321,Mark Napier,North Stars,58,41,13,28
321,Mark Napier,North Stars,39,28,10,18
321,Mark Napier,Oilers,33,35,9,26
321,Mark Napier,Oilers,80,56,24,32
321,Mark Napier,Oilers,62,21,8,13
321,Mark Napier,Sabres,15,10,5,5
321,Mark Napier,Sabres,47,18,10,8
321,Mark Napier,Sabres,66,28,11,17
322,Toe Blake,Maroons,8,0,0,0
322,Toe Blake,Canadiens,11,3,1,2
322,Toe Blake,Canadiens,43,22,10,12
322,Toe Blake,Canadiens,43,33,17,16
322,Toe Blake,Canadiens,48,47,24,23
322,Toe Blake,Canadiens,48,36,17,19
322,Toe Blake,Canadiens,48,32,12,20
322,Toe Blake,Canadiens,48,45,17,28
322,Toe Blake,Canadiens,48,59,23,36
322,Toe Blake,Canadiens,41,59,26,33
322,Toe Blake,Canadiens,49,67,29,38
322,Toe Blake,Canadiens,50,50,29,21
322,Toe Blake,Canadiens,60,50,21,29
322,Toe Blake,Canadiens,32,24,9,15
323,Bobby Nystrom,Islanders,11,2,1,1
323,Bobby Nystrom,Islanders,77,41,21,20
323,Bobby Nystrom,Islanders,76,55,27,28
323,Bobby Nystrom,Islanders,80,48,23,25
323,Bobby Nystrom,Islanders,80,56,29,27
323,Bobby Nystrom,Islanders,80,59,30,29
323,Bobby Nystrom,Islanders,78,39,19,20
323,Bobby Nystrom,Islanders,67,39,21,18
323,Bobby Nystrom,Islanders,79,44,14,30
323,Bobby Nystrom,Islanders,74,47,22,25
323,Bobby Nystrom,Islanders,74,30,10,20
323,Bobby Nystrom,Islanders,74,44,15,29
323,Bobby Nystrom,Islanders,36,7,2,5
323,Bobby Nystrom,Islanders,14,2,1,1
324,Michael Ryder,Canadiens,81,63,25,38
324,Michael Ryder,Canadiens,81,55,30,25
324,Michael Ryder,Canadiens,82,58,30,28
324,Michael Ryder,Canadiens,70,31,14,17
324,Michael Ryder,Bruins,74,53,27,26
324,Michael Ryder,Bruins,82,33,18,15
324,Michael Ryder,Bruins,79,41,18,23
324,Michael Ryder,Stars,82,62,35,27
324,Michael Ryder,Stars,19,14,6,8
324,Michael Ryder,Canadiens,27,21,10,11
324,Michael Ryder,Devils,82,34,18,16
324,Michael Ryder,Devils,23,11,4,7
325,Joe Murphy,Red Wings,5,1,0,1
325,Joe Murphy,Red Wings,50,19,10,9
325,Joe Murphy,Red Wings,26,8,1,7
325,Joe Murphy,Red Wings,9,4,3,1
325,Joe Murphy,Oilers,62,25,7,18
325,Joe Murphy,Oilers,80,62,27,35
325,Joe Murphy,Oilers,80,82,35,47
325,Joe Murphy,Blackhawks,19,17,7,10
325,Joe Murphy,Blackhawks,81,70,31,39
325,Joe Murphy,Blackhawks,40,41,23,18
325,Joe Murphy,Blackhawks,70,51,22,29
325,Joe Murphy,Blues,75,45,20,25
325,Joe Murphy,Blues,27,13,4,9
325,Joe Murphy,Sharks,10,9,5,4
325,Joe Murphy,Sharks,76,48,25,23
325,Joe Murphy,Bruins,26,14,7,7
325,Joe Murphy,Capitals,29,13,5,8
325,Joe Murphy,Capitals,14,6,1,5
326,Phil Kessel,Bruins,70,29,11,18
326,Phil Kessel,Bruins,82,37,19,18
326,Phil Kessel,Bruins,70,60,36,24
326,Phil Kessel,Maple Leafs,70,55,30,25
326,Phil Kessel,Maple Leafs,82,64,32,32
326,Phil Kessel,Maple Leafs,82,82,37,45
326,Phil Kessel,Maple Leafs,48,52,20,32
326,Phil Kessel,Maple Leafs,82,80,37,43
326,Phil Kessel,Maple Leafs,22,23,11,12
327,Michael Redmond,Canadiens,41,11,6,5
327,Michael Redmond,Canadiens,65,24,9,15
327,Michael Redmond,Canadiens,75,54,27,27
327,Michael Redmond,Canadiens,40,29,14,15
327,Michael Redmond,Red Wings,21,14,6,8
327,Michael Redmond,Red Wings,78,71,42,29
327,Michael Redmond,Red Wings,76,93,52,41
327,Michael Redmond,Red Wings,76,77,51,26
327,Michael Redmond,Red Wings,29,27,15,12
327,Michael Redmond,Red Wings,37,28,11,17
328,Alexander Semin,Capitals,52,22,10,12
328,Alexander Semin,Capitals,77,73,38,35
328,Alexander Semin,Capitals,63,42,26,16
328,Alexander Semin,Capitals,62,79,34,45
328,Alexander Semin,Capitals,73,84,40,44
328,Alexander Semin,Capitals,65,54,28,26
328,Alexander Semin,Capitals,77,54,21,33
328,Alexander Semin,Hurricanes,44,44,13,31
328,Alexander Semin,Hurricanes,65,42,22,20
328,Alexander Semin,Hurricanes,17,5,0,5
329,Freddy Modin,Maple Leafs,76,13,6,7
329,Freddy Modin,Maple Leafs,74,32,16,16
329,Freddy Modin,Maple Leafs,67,31,16,15
329,Freddy Modin,Lightning,80,48,22,26
329,Freddy Modin,Lightning,76,56,32,24
329,Freddy Modin,Lightning,54,31,14,17
329,Freddy Modin,Lightning,76,40,17,23
329,Freddy Modin,Lightning,82,57,29,28
329,Freddy Modin,Lightning,77,54,31,23
329,Freddy Modin,Blue Jackets,79,42,22,20
329,Freddy Modin,Blue Jackets,23,12,6,6
329,Freddy Modin,Blue Jackets,50,25,9,16
329,Freddy Modin,Blue Jackets,24,6,2,4
329,Freddy Modin,Kings,20,5,3,2
329,Freddy Modin,Thrashers,36,10,7,3
329,Freddy Modin,Flames,4,0,0,0
330,Ed Westfall,Bruins,63,11,2,9
330,Ed Westfall,Bruins,48,12,1,11
330,Ed Westfall,Bruins,55,6,1,5
330,Ed Westfall,Bruins,68,27,12,15
330,Ed Westfall,Bruins,59,30,9,21
330,Ed Westfall,Bruins,70,36,12,24
330,Ed Westfall,Bruins,73,36,14,22
330,Ed Westfall,Bruins,70,42,18,24
330,Ed Westfall,Bruins,72,36,14,22
330,Ed Westfall,Bruins,78,59,25,34
330,Ed Westfall,Bruins,77,44,18,26
330,Ed Westfall,Islanders,67,46,15,31
330,Ed Westfall,Islanders,68,42,19,23
330,Ed Westfall,Islanders,73,55,22,33
330,Ed Westfall,Islanders,80,56,25,31
330,Ed Westfall,Islanders,79,47,14,33
330,Ed Westfall,Islanders,71,24,5,19
330,Ed Westfall,Islanders,55,16,5,11
331,Ted Kennedy,Maple Leafs,2,1,0,1
331,Ted Kennedy,Maple Leafs,49,49,26,23
331,Ted Kennedy,Maple Leafs,49,54,29,25
331,Ted Kennedy,Maple Leafs,21,5,3,2
331,Ted Kennedy,Maple Leafs,60,60,28,32
331,Ted Kennedy,Maple Leafs,60,46,25,21
331,Ted Kennedy,Maple Leafs,59,39,18,21
331,Ted Kennedy,Maple Leafs,53,44,20,24
331,Ted Kennedy,Maple Leafs,63,61,18,43
331,Ted Kennedy,Maple Leafs,70,52,19,33
331,Ted Kennedy,Maple Leafs,43,37,14,23
331,Ted Kennedy,Maple Leafs,67,38,15,23
331,Ted Kennedy,Maple Leafs,70,52,10,42
331,Ted Kennedy,Maple Leafs,30,22,6,16
332,Bill Harris,Islanders,78,50,28,22
332,Bill Harris,Islanders,78,50,23,27
332,Bill Harris,Islanders,80,62,25,37
332,Bill Harris,Islanders,80,70,32,38
332,Bill Harris,Islanders,80,67,24,43
332,Bill Harris,Islanders,80,60,22,38
332,Bill Harris,Islanders,80,54,15,39
332,Bill Harris,Islanders,67,30,15,15
332,Bill Harris,Kings,11,7,4,3
332,Bill Harris,Kings,80,49,20,29
332,Bill Harris,Kings,16,4,1,3
332,Bill Harris,Maple Leafs,20,2,2,0
332,Bill Harris,Maple Leafs,76,30,11,19
332,Bill Harris,Maple Leafs,50,17,7,10
332,Bill Harris,Kings,21,6,2,4
333,Troy Murray,Blackhawks,1,0,0,0
333,Troy Murray,Blackhawks,54,16,8,8
333,Troy Murray,Blackhawks,61,30,15,15
333,Troy Murray,Blackhawks,80,66,26,40
333,Troy Murray,Blackhawks,80,99,45,54
333,Troy Murray,Blackhawks,77,71,28,43
333,Troy Murray,Blackhawks,79,58,22,36
333,Troy Murray,Blackhawks,79,51,21,30
333,Troy Murray,Blackhawks,68,55,17,38
333,Troy Murray,Blackhawks,75,37,14,23
333,Troy Murray,Jets (1979),74,47,17,30
333,Troy Murray,Jets (1979),29,7,3,4
333,Troy Murray,Blackhawks,22,4,1,3
333,Troy Murray,Blackhawks,12,1,0,1
333,Troy Murray,Senators,15,5,2,3
333,Troy Murray,Senators,33,14,4,10
333,Troy Murray,Penguins,13,2,0,2
333,Troy Murray,Avalanche,63,21,7,14
334,Donald Marcotte,Bruins,1,0,0,0
334,Donald Marcotte,Bruins,7,1,1,0
334,Donald Marcotte,Bruins,35,12,9,3
334,Donald Marcotte,Bruins,75,28,15,13
334,Donald Marcotte,Bruins,47,10,6,4
334,Donald Marcotte,Bruins,78,55,24,31
334,Donald Marcotte,Bruins,78,50,24,26
334,Donald Marcotte,Bruins,80,64,31,33
334,Donald Marcotte,Bruins,58,36,16,20
334,Donald Marcotte,Bruins,80,45,27,18
334,Donald Marcotte,Bruins,77,54,20,34
334,Donald Marcotte,Bruins,79,47,20,27
334,Donald Marcotte,Bruins,32,15,4,11
334,Donald Marcotte,Bruins,72,33,20,13
334,Donald Marcotte,Bruins,69,34,13,21
335,Kelly Kisio,Red Wings,15,7,4,3
335,Kelly Kisio,Red Wings,70,60,23,37
335,Kelly Kisio,Red Wings,75,61,20,41
335,Kelly Kisio,Red Wings,76,69,21,48
335,Kelly Kisio,Rangers,70,64,24,40
335,Kelly Kisio,Rangers,77,78,23,55
335,Kelly Kisio,Rangers,70,62,26,36
335,Kelly Kisio,Rangers,68,66,22,44
335,Kelly Kisio,Rangers,51,35,15,20
335,Kelly Kisio,Sharks,48,37,11,26
335,Kelly Kisio,Sharks,78,78,26,52
335,Kelly Kisio,Flames,51,30,7,23
335,Kelly Kisio,Flames,12,11,7,4
336,Laurie Boschman,Maple Leafs,80,48,16,32
336,Laurie Boschman,Maple Leafs,53,33,14,19
336,Laurie Boschman,Maple Leafs,54,28,9,19
336,Laurie Boschman,Oilers,11,5,2,3
336,Laurie Boschman,Oilers,62,20,8,12
336,Laurie Boschman,Jets (1979),12,8,3,5
336,Laurie Boschman,Jets (1979),61,74,28,46
336,Laurie Boschman,Jets (1979),80,76,32,44
336,Laurie Boschman,Jets (1979),77,69,27,42
336,Laurie Boschman,Jets (1979),80,41,17,24
336,Laurie Boschman,Jets (1979),80,48,25,23
336,Laurie Boschman,Jets (1979),70,36,10,26
336,Laurie Boschman,Jets (1979),66,27,10,17
336,Laurie Boschman,Devils,78,20,11,9
336,Laurie Boschman,Devils,75,28,8,20
336,Laurie Boschman,Senators,70,16,9,7
337,Milt Schmidt,Bruins,26,10,2,8
337,Milt Schmidt,Bruins,44,27,13,14
337,Milt Schmidt,Bruins,41,32,15,17
337,Milt Schmidt,Bruins,48,52,22,30
337,Milt Schmidt,Bruins,45,38,13,25
337,Milt Schmidt,Bruins,36,35,14,21
337,Milt Schmidt,Bruins,48,31,13,18
337,Milt Schmidt,Bruins,59,62,27,35
337,Milt Schmidt,Bruins,33,26,9,17
337,Milt Schmidt,Bruins,44,32,10,22
337,Milt Schmidt,Bruins,68,41,19,22
337,Milt Schmidt,Bruins,62,61,22,39
337,Milt Schmidt,Bruins,69,50,21,29
337,Milt Schmidt,Bruins,68,34,11,23
337,Milt Schmidt,Bruins,62,32,14,18
337,Milt Schmidt,Bruins,23,12,4,8
338,Bill Cook,Rangers,44,37,33,4
338,Bill Cook,Rangers,43,24,18,6
338,Bill Cook,Rangers,43,23,15,8
338,Bill Cook,Rangers,44,59,29,30
338,Bill Cook,Rangers,43,42,30,12
338,Bill Cook,Rangers,48,48,34,14
338,Bill Cook,Rangers,48,50,28,22
338,Bill Cook,Rangers,48,26,13,13
338,Bill Cook,Rangers,48,36,21,15
338,Bill Cook,Rangers,44,17,7,10
338,Bill Cook,Rangers,21,5,1,4
339,Bob MacMillan,Rangers,22,3,1,2
339,Bob MacMillan,Blues,80,52,20,32
339,Bob MacMillan,Blues,80,58,19,39
339,Bob MacMillan,Blues,28,19,7,12
339,Bob MacMillan,Flames,52,52,31,21
339,Bob MacMillan,Flames,79,108,37,71
339,Bob MacMillan,Flames,77,61,22,39
339,Bob MacMillan,Flames,77,63,28,35
339,Bob MacMillan,Flames,23,11,4,7
339,Bob MacMillan,Rockies,57,50,18,32
339,Bob MacMillan,Devils,71,48,19,29
339,Bob MacMillan,Devils,71,40,17,23
339,Bob MacMillan,Blackhawks,36,12,5,7
340,Dit Clapper,Bruins,40,5,4,1
340,Dit Clapper,Bruins,40,11,9,2
340,Dit Clapper,Bruins,44,61,41,20
340,Dit Clapper,Bruins,43,30,22,8
340,Dit Clapper,Bruins,48,39,17,22
340,Dit Clapper,Bruins,48,28,14,14
340,Dit Clapper,Bruins,48,22,10,12
340,Dit Clapper,Bruins,48,37,21,16
340,Dit Clapper,Bruins,44,25,12,13
340,Dit Clapper,Bruins,48,25,17,8
340,Dit Clapper,Bruins,46,15,6,9
340,Dit Clapper,Bruins,42,26,13,13
340,Dit Clapper,Bruins,44,28,10,18
340,Dit Clapper,Bruins,48,26,8,18
340,Dit Clapper,Bruins,32,15,3,12
340,Dit Clapper,Bruins,38,23,5,18
340,Dit Clapper,Bruins,50,31,6,25
340,Dit Clapper,Bruins,46,22,8,14
340,Dit Clapper,Bruins,30,5,2,3
340,Dit Clapper,Bruins,6,0,0,0
341,Steven Payne,North Stars,70,40,23,17
341,Steven Payne,North Stars,80,85,42,43
341,Steven Payne,North Stars,76,58,30,28
341,Steven Payne,North Stars,74,78,33,45
341,Steven Payne,North Stars,80,69,30,39
341,Steven Payne,North Stars,78,59,28,31
341,Steven Payne,North Stars,76,51,29,22
341,Steven Payne,North Stars,22,12,8,4
341,Steven Payne,North Stars,48,10,4,6
341,Steven Payne,North Stars,9,4,1,3
342,Steve Duchesne,Kings,75,38,13,25
342,Steve Duchesne,Kings,71,55,16,39
342,Steve Duchesne,Kings,79,75,25,50
342,Steve Duchesne,Kings,79,62,20,42
342,Steve Duchesne,Kings,78,62,21,41
342,Steve Duchesne,Flyers,78,56,18,38
342,Steve Duchesne,Nordiques,82,82,20,62
342,Steve Duchesne,Blues,36,31,12,19
342,Steve Duchesne,Blues,47,38,12,26
342,Steve Duchesne,Senators,62,36,12,24
342,Steve Duchesne,Senators,78,47,19,28
342,Steve Duchesne,Blues,80,56,14,42
342,Steve Duchesne,Kings,60,23,4,19
342,Steve Duchesne,Flyers,11,7,2,5
342,Steve Duchesne,Red Wings,79,41,10,31
342,Steve Duchesne,Red Wings,54,25,6,19
342,Steve Duchesne,Red Wings,64,18,3,15
343,Walt Tkaczuk,Rangers,2,0,0,0
343,Walt Tkaczuk,Rangers,71,36,12,24
343,Walt Tkaczuk,Rangers,76,77,27,50
343,Walt Tkaczuk,Rangers,77,75,26,49
343,Walt Tkaczuk,Rangers,76,66,24,42
343,Walt Tkaczuk,Rangers,76,66,27,39
343,Walt Tkaczuk,Rangers,71,63,21,42
343,Walt Tkaczuk,Rangers,62,36,11,25
343,Walt Tkaczuk,Rangers,78,36,8,28
343,Walt Tkaczuk,Rangers,80,50,12,38
343,Walt Tkaczuk,Rangers,80,66,26,40
343,Walt Tkaczuk,Rangers,77,42,15,27
343,Walt Tkaczuk,Rangers,76,37,12,25
343,Walt Tkaczuk,Rangers,43,28,6,22
344,Kevin Hatcher,Capitals,2,1,1,0
344,Kevin Hatcher,Capitals,79,19,9,10
344,Kevin Hatcher,Capitals,78,24,8,16
344,Kevin Hatcher,Capitals,71,41,14,27
344,Kevin Hatcher,Capitals,62,40,13,27
344,Kevin Hatcher,Capitals,80,54,13,41
344,Kevin Hatcher,Capitals,79,74,24,50
344,Kevin Hatcher,Capitals,79,54,17,37
344,Kevin Hatcher,Capitals,83,79,34,45
344,Kevin Hatcher,Capitals,72,40,16,24
344,Kevin Hatcher,Stars,47,29,10,19
344,Kevin Hatcher,Stars,74,41,15,26
344,Kevin Hatcher,Penguins,80,54,15,39
344,Kevin Hatcher,Penguins,74,48,19,29
344,Kevin Hatcher,Penguins,66,38,11,27
344,Kevin Hatcher,Rangers,74,23,4,19
344,Kevin Hatcher,Hurricanes,57,18,4,14
345,Radek Dvorak,Panthers,77,27,13,14
345,Radek Dvorak,Panthers,78,39,18,21
345,Radek Dvorak,Panthers,64,36,12,24
345,Radek Dvorak,Panthers,82,43,19,24
345,Radek Dvorak,Panthers,35,17,7,10
345,Radek Dvorak,Rangers,46,33,11,22
345,Radek Dvorak,Rangers,82,67,31,36
345,Radek Dvorak,Rangers,65,37,17,20
345,Radek Dvorak,Rangers,63,27,6,21
345,Radek Dvorak,Oilers,12,8,4,4
345,Radek Dvorak,Oilers,78,50,15,35
345,Radek Dvorak,Oilers,64,28,8,20
345,Radek Dvorak,Blues,82,37,10,27
345,Radek Dvorak,Panthers,67,17,8,9
345,Radek Dvorak,Panthers,81,36,15,21
345,Radek Dvorak,Panthers,76,32,14,18
345,Radek Dvorak,Panthers,53,21,7,14
345,Radek Dvorak,Thrashers,13,1,0,1
345,Radek Dvorak,Stars,73,21,4,17
345,Radek Dvorak,Ducks,9,4,4,0
345,Radek Dvorak,Hurricanes,60,9,4,5
346,Keith Acton,Canadiens,2,1,0,1
346,Keith Acton,Canadiens,61,39,15,24
346,Keith Acton,Canadiens,78,88,36,52
346,Keith Acton,Canadiens,78,50,24,26
346,Keith Acton,Canadiens,9,10,3,7
346,Keith Acton,North Stars,62,55,17,38
346,Keith Acton,North Stars,78,58,20,38
346,Keith Acton,North Stars,79,58,26,32
346,Keith Acton,North Stars,78,45,16,29
346,Keith Acton,North Stars,46,19,8,11
346,Keith Acton,Oilers,26,9,3,6
346,Keith Acton,Oilers,46,26,11,15
346,Keith Acton,Flyers,25,13,3,10
346,Keith Acton,Flyers,69,27,13,14
346,Keith Acton,Flyers,76,37,14,23
346,Keith Acton,Flyers,50,17,7,10
346,Keith Acton,Flyers,83,23,8,15
346,Keith Acton,Capitals,6,0,0,0
346,Keith Acton,Islanders,71,9,2,7
347,Claude Larose,Canadiens,4,0,0,0
347,Claude Larose,Canadiens,21,2,1,1
347,Claude Larose,Canadiens,68,37,21,16
347,Claude Larose,Canadiens,64,33,15,18
347,Claude Larose,Canadiens,69,35,19,16
347,Claude Larose,Canadiens,42,11,2,9
347,Claude Larose,North Stars,67,62,25,37
347,Claude Larose,North Stars,75,47,24,23
347,Claude Larose,Canadiens,64,23,10,13
347,Claude Larose,Canadiens,77,38,20,18
347,Claude Larose,Canadiens,73,34,11,23
347,Claude Larose,Canadiens,39,24,17,7
347,Claude Larose,Canadiens,8,3,1,2
347,Claude Larose,Blues,56,27,10,17
347,Claude Larose,Blues,67,38,13,25
347,Claude Larose,Blues,80,48,29,19
347,Claude Larose,Blues,69,21,8,13
348,Mike Fisher,Senators,32,9,4,5
348,Mike Fisher,Senators,60,19,7,12
348,Mike Fisher,Senators,58,24,15,9
348,Mike Fisher,Senators,74,38,18,20
348,Mike Fisher,Senators,24,10,4,6
348,Mike Fisher,Senators,68,44,22,22
348,Mike Fisher,Senators,68,48,22,26
348,Mike Fisher,Senators,79,47,23,24
348,Mike Fisher,Senators,78,32,13,19
348,Mike Fisher,Senators,79,53,25,28
348,Mike Fisher,Senators,55,24,14,10
348,Mike Fisher,Predators,27,12,5,7
348,Mike Fisher,Predators,72,51,24,27
348,Mike Fisher,Predators,38,21,10,11
348,Mike Fisher,Predators,75,49,20,29
348,Mike Fisher,Predators,1,0,0,0
349,Roy Conacher,Bruins,47,37,26,11
349,Roy Conacher,Bruins,31,30,18,12
349,Roy Conacher,Bruins,41,38,24,14
349,Roy Conacher,Bruins,43,37,24,13
349,Roy Conacher,Bruins,4,3,2,1
349,Roy Conacher,Red Wings,60,54,30,24
349,Roy Conacher,Blackhawks,52,49,22,27
349,Roy Conacher,Blackhawks,60,68,26,42
349,Roy Conacher,Blackhawks,70,56,25,31
349,Roy Conacher,Blackhawks,70,50,26,24
349,Roy Conacher,Blackhawks,12,4,3,1
350,Eric Daze,Blackhawks,4,2,1,1
350,Eric Daze,Blackhawks,80,53,30,23
350,Eric Daze,Blackhawks,71,41,22,19
350,Eric Daze,Blackhawks,80,42,31,11
350,Eric Daze,Blackhawks,72,42,22,20
350,Eric Daze,Blackhawks,59,36,23,13
350,Eric Daze,Blackhawks,79,57,33,24
350,Eric Daze,Blackhawks,82,70,38,32
350,Eric Daze,Blackhawks,54,44,22,22
350,Eric Daze,Blackhawks,19,11,4,7
350,Eric Daze,Blackhawks,1,0,0,0
351,Don Luce,Rangers,12,3,1,2
351,Don Luce,Rangers,9,1,0,1
351,Don Luce,Red Wings,58,14,3,11
351,Don Luce,Sabres,78,19,11,8
351,Don Luce,Sabres,78,43,18,25
351,Don Luce,Sabres,75,57,26,31
351,Don Luce,Sabres,80,76,33,43
351,Don Luce,Sabres,77,70,21,49
351,Don Luce,Sabres,80,69,26,43
351,Don Luce,Sabres,78,61,26,35
351,Don Luce,Sabres,79,61,26,35
351,Don Luce,Sabres,80,43,14,29
351,Don Luce,Sabres,61,28,15,13
351,Don Luce,Kings,10,1,1,0
351,Don Luce,Maple Leafs,39,8,4,4
352,Radim Vrbata,Avalanche,52,30,18,12
352,Radim Vrbata,Avalanche,66,30,11,19
352,Radim Vrbata,Hurricanes,10,5,5,0
352,Radim Vrbata,Hurricanes,80,25,12,13
352,Radim Vrbata,Hurricanes,16,5,2,3
352,Radim Vrbata,Blackhawks,45,34,13,21
352,Radim Vrbata,Blackhawks,77,41,14,27
352,Radim Vrbata,Coyotes,76,56,27,29
352,Radim Vrbata,Lightning,18,6,3,3
352,Radim Vrbata,Coyotes,82,43,24,19
352,Radim Vrbata,Coyotes,79,48,19,29
352,Radim Vrbata,Coyotes,77,62,35,27
352,Radim Vrbata,Coyotes,34,28,12,16
352,Radim Vrbata,Coyotes,80,51,20,31
352,Radim Vrbata,Canucks,21,18,10,8
353,Charlie Conacher,Maple Leafs,38,29,20,9
353,Charlie Conacher,Maple Leafs,37,43,31,12
353,Charlie Conacher,Maple Leafs,44,48,34,14
353,Charlie Conacher,Maple Leafs,40,33,14,19
353,Charlie Conacher,Maple Leafs,42,52,32,20
353,Charlie Conacher,Maple Leafs,47,57,36,21
353,Charlie Conacher,Maple Leafs,44,38,23,15
353,Charlie Conacher,Maple Leafs,15,8,3,5
353,Charlie Conacher,Maple Leafs,19,16,7,9
353,Charlie Conacher,Red Wings,40,23,8,15
353,Charlie Conacher,Americans,47,28,10,18
353,Charlie Conacher,Americans,46,23,7,16
354,Mathieu Schneider,Canadiens,4,0,0,0
354,Mathieu Schneider,Canadiens,44,21,7,14
354,Mathieu Schneider,Canadiens,69,30,10,20
354,Mathieu Schneider,Canadiens,78,32,8,24
354,Mathieu Schneider,Canadiens,60,44,13,31
354,Mathieu Schneider,Canadiens,75,52,20,32
354,Mathieu Schneider,Canadiens,30,20,5,15
354,Mathieu Schneider,Islanders,13,9,3,6
354,Mathieu Schneider,Islanders,65,47,11,36
354,Mathieu Schneider,Maple Leafs,13,7,2,5
354,Mathieu Schneider,Maple Leafs,26,12,5,7
354,Mathieu Schneider,Maple Leafs,76,37,11,26
354,Mathieu Schneider,Rangers,75,34,10,24
354,Mathieu Schneider,Rangers,80,30,10,20
354,Mathieu Schneider,Kings,73,51,16,35
354,Mathieu Schneider,Kings,55,30,7,23
354,Mathieu Schneider,Kings,65,43,14,29
354,Mathieu Schneider,Red Wings,13,7,2,5
354,Mathieu Schneider,Red Wings,78,46,14,32
354,Mathieu Schneider,Red Wings,72,59,21,38
354,Mathieu Schneider,Red Wings,68,52,11,41
354,Mathieu Schneider,Ducks,65,39,12,27
354,Mathieu Schneider,Thrashers,44,15,4,11
354,Mathieu Schneider,Canadiens,23,17,5,12
354,Mathieu Schneider,Canucks,17,5,2,3
354,Mathieu Schneider,Coyotes,8,4,0,4
355,Dainius Zubrus,Flyers,68,21,8,13
355,Dainius Zubrus,Flyers,69,33,8,25
355,Dainius Zubrus,Flyers,63,8,3,5
355,Dainius Zubrus,Canadiens,17,8,3,5
355,Dainius Zubrus,Canadiens,73,42,14,28
355,Dainius Zubrus,Canadiens,49,24,12,12
355,Dainius Zubrus,Capitals,12,2,1,1
355,Dainius Zubrus,Capitals,71,43,17,26
355,Dainius Zubrus,Capitals,63,35,13,22
355,Dainius Zubrus,Capitals,54,27,12,15
355,Dainius Zubrus,Capitals,71,57,23,34
355,Dainius Zubrus,Capitals,60,52,20,32
355,Dainius Zubrus,Sabres,19,8,4,4
355,Dainius Zubrus,Devils,82,38,13,25
355,Dainius Zubrus,Devils,82,40,15,25
355,Dainius Zubrus,Devils,51,27,10,17
355,Dainius Zubrus,Devils,79,30,13,17
355,Dainius Zubrus,Devils,82,44,17,27
355,Dainius Zubrus,Devils,22,9,2,7
355,Dainius Zubrus,Devils,82,26,13,13
355,Dainius Zubrus,Devils,23,2,2,0
356,Jason Pominville,Sabres,1,0,0,0
356,Jason Pominville,Sabres,57,30,18,12
356,Jason Pominville,Sabres,82,68,34,34
356,Jason Pominville,Sabres,82,80,27,53
356,Jason Pominville,Sabres,82,66,20,46
356,Jason Pominville,Sabres,82,62,24,38
356,Jason Pominville,Sabres,73,52,22,30
356,Jason Pominville,Sabres,82,73,30,43
356,Jason Pominville,Sabres,37,25,10,15
356,Jason Pominville,Wild,10,9,4,5
356,Jason Pominville,Wild,82,60,30,30
356,Jason Pominville,Wild,22,14,4,10
357,Keith Crowder,Bruins,47,25,13,12
357,Keith Crowder,Bruins,71,44,23,21
357,Keith Crowder,Bruins,74,74,35,39
357,Keith Crowder,Bruins,63,52,24,28
357,Keith Crowder,Bruins,79,70,32,38
357,Keith Crowder,Bruins,78,84,38,46
357,Keith Crowder,Bruins,58,52,22,30
357,Keith Crowder,Bruins,68,43,17,26
357,Keith Crowder,Bruins,69,33,15,18
357,Keith Crowder,Kings,55,17,4,13
358,Reed Larson,Red Wings,14,1,0,1
358,Reed Larson,Red Wings,75,60,19,41
358,Reed Larson,Red Wings,79,67,18,49
358,Reed Larson,Red Wings,80,66,22,44
358,Reed Larson,Red Wings,78,58,27,31
358,Reed Larson,Red Wings,80,60,21,39
358,Reed Larson,Red Wings,80,74,22,52
358,Reed Larson,Red Wings,78,62,23,39
358,Reed Larson,Red Wings,77,62,17,45
358,Reed Larson,Red Wings,67,60,19,41
358,Reed Larson,Bruins,13,7,3,4
358,Reed Larson,Bruins,66,36,12,24
358,Reed Larson,Bruins,62,34,10,24
358,Reed Larson,Oilers,10,9,2,7
358,Reed Larson,Islanders,33,20,7,13
358,Reed Larson,North Stars,11,9,0,9
358,Reed Larson,Sabres,1,0,0,0
359,Benoit Hogue,Sabres,3,2,1,1
359,Benoit Hogue,Sabres,69,44,14,30
359,Benoit Hogue,Sabres,45,18,11,7
359,Benoit Hogue,Sabres,76,47,19,28
359,Benoit Hogue,Sabres,3,1,0,1
359,Benoit Hogue,Islanders,72,75,30,45
359,Benoit Hogue,Islanders,70,75,33,42
359,Benoit Hogue,Islanders,83,69,36,33
359,Benoit Hogue,Islanders,33,10,6,4
359,Benoit Hogue,Maple Leafs,12,6,3,3
359,Benoit Hogue,Maple Leafs,44,37,12,25
359,Benoit Hogue,Stars,34,27,7,20
359,Benoit Hogue,Stars,73,43,19,24
359,Benoit Hogue,Stars,53,22,6,16
359,Benoit Hogue,Lightning,62,25,11,14
359,Benoit Hogue,Stars,12,4,1,3
359,Benoit Hogue,Coyotes,27,13,3,10
359,Benoit Hogue,Stars,34,10,3,7
359,Benoit Hogue,Stars,32,6,3,3
359,Benoit Hogue,Bruins,17,8,4,4
359,Benoit Hogue,Capitals,9,1,0,1
360,Willi Plett,Flames,4,0,0,0
360,Willi Plett,Flames,64,56,33,23
360,Willi Plett,Flames,78,43,22,21
360,Willi Plett,Flames,74,43,23,20
360,Willi Plett,Flames,76,32,13,19
360,Willi Plett,Flames,78,68,38,30
360,Willi Plett,Flames,78,57,21,36
360,Willi Plett,North Stars,71,39,25,14
360,Willi Plett,North Stars,73,38,15,23
360,Willi Plett,North Stars,47,28,14,14
360,Willi Plett,North Stars,59,17,10,7
360,Willi Plett,North Stars,67,11,6,5
360,Willi Plett,Bruins,65,5,2,3
361,Guy Charron,Canadiens,5,0,0,0
361,Guy Charron,Canadiens,15,4,2,2
361,Guy Charron,Red Wings,24,12,8,4
361,Guy Charron,Red Wings,64,25,9,16
361,Guy Charron,Red Wings,75,36,18,18
361,Guy Charron,Red Wings,76,55,25,30
361,Guy Charron,Red Wings,26,11,1,10
361,Guy Charron,Scouts,51,42,13,29
361,Guy Charron,Scouts,78,71,27,44
361,Guy Charron,Capitals,80,82,36,46
361,Guy Charron,Capitals,80,73,38,35
361,Guy Charron,Capitals,80,70,28,42
361,Guy Charron,Capitals,33,31,11,20
361,Guy Charron,Capitals,47,18,5,13
362,Tod Sloan,Maple Leafs,1,0,0,0
362,Tod Sloan,Maple Leafs,29,7,3,4
362,Tod Sloan,Maple Leafs,70,56,31,25
362,Tod Sloan,Maple Leafs,68,48,25,23
362,Tod Sloan,Maple Leafs,70,25,15,10
362,Tod Sloan,Maple Leafs,67,43,11,32
362,Tod Sloan,Maple Leafs,63,28,13,15
362,Tod Sloan,Maple Leafs,70,66,37,29
362,Tod Sloan,Maple Leafs,52,35,14,21
362,Tod Sloan,Maple Leafs,59,38,13,25
362,Tod Sloan,Blackhawks,59,62,27,35
362,Tod Sloan,Blackhawks,70,40,20,20
362,Tod Sloan,Blackhawks,67,34,11,23
363,Sergei Gonchar,Capitals,31,7,2,5
363,Sergei Gonchar,Capitals,78,41,15,26
363,Sergei Gonchar,Capitals,57,30,13,17
363,Sergei Gonchar,Capitals,72,21,5,16
363,Sergei Gonchar,Capitals,53,31,21,10
363,Sergei Gonchar,Capitals,73,54,18,36
363,Sergei Gonchar,Capitals,76,57,19,38
363,Sergei Gonchar,Capitals,76,59,26,33
363,Sergei Gonchar,Capitals,82,67,18,49
363,Sergei Gonchar,Capitals,56,49,7,42
363,Sergei Gonchar,Bruins,15,9,4,5
363,Sergei Gonchar,Penguins,75,58,12,46
363,Sergei Gonchar,Penguins,82,67,13,54
363,Sergei Gonchar,Penguins,78,65,12,53
363,Sergei Gonchar,Penguins,25,19,6,13
363,Sergei Gonchar,Penguins,62,50,11,39
363,Sergei Gonchar,Senators,67,27,7,20
363,Sergei Gonchar,Senators,74,37,5,32
363,Sergei Gonchar,Senators,45,27,3,24
363,Sergei Gonchar,Stars,76,22,2,20
363,Sergei Gonchar,Stars,3,1,0,1
363,Sergei Gonchar,Canadiens,8,2,0,2
364,Peter Zezel,Flyers,65,61,15,46
364,Peter Zezel,Flyers,79,54,17,37
364,Peter Zezel,Flyers,71,72,33,39
364,Peter Zezel,Flyers,69,57,22,35
364,Peter Zezel,Flyers,26,17,4,13
364,Peter Zezel,Blues,52,53,17,36
364,Peter Zezel,Blues,73,72,25,47
364,Peter Zezel,Capitals,20,12,7,5
364,Peter Zezel,Maple Leafs,32,28,14,14
364,Peter Zezel,Maple Leafs,64,49,16,33
364,Peter Zezel,Maple Leafs,70,35,12,23
364,Peter Zezel,Maple Leafs,41,16,8,8
364,Peter Zezel,Stars,30,11,6,5
364,Peter Zezel,Blues,57,21,8,13
364,Peter Zezel,Blues,35,13,4,9
364,Peter Zezel,Devils,18,3,0,3
364,Peter Zezel,Devils,5,3,0,3
364,Peter Zezel,Canucks,25,17,5,12
364,Peter Zezel,Canucks,41,14,6,8
365,Patrik Sundstrom,Canucks,74,46,23,23
365,Patrik Sundstrom,Canucks,78,91,38,53
365,Patrik Sundstrom,Canucks,71,68,25,43
365,Patrik Sundstrom,Canucks,79,66,18,48
365,Patrik Sundstrom,Canucks,72,71,29,42
365,Patrik Sundstrom,Devils,78,51,15,36
365,Patrik Sundstrom,Devils,65,69,28,41
365,Patrik Sundstrom,Devils,74,76,27,49
365,Patrik Sundstrom,Devils,71,46,15,31
365,Patrik Sundstrom,Devils,17,4,1,3
366,Doug Bentley,Blackhawks,39,19,12,7
366,Doug Bentley,Blackhawks,47,28,8,20
366,Doug Bentley,Blackhawks,38,26,12,14
366,Doug Bentley,Blackhawks,50,73,33,40
366,Doug Bentley,Blackhawks,50,77,38,39
366,Doug Bentley,Blackhawks,36,40,19,21
366,Doug Bentley,Blackhawks,52,55,21,34
366,Doug Bentley,Blackhawks,60,57,20,37
366,Doug Bentley,Blackhawks,58,66,23,43
366,Doug Bentley,Blackhawks,64,53,20,33
366,Doug Bentley,Blackhawks,44,32,9,23
366,Doug Bentley,Blackhawks,8,5,2,3
366,Doug Bentley,Rangers,20,12,2,10
367,Dirk Graham,North Stars,6,2,1,1
367,Dirk Graham,North Stars,36,23,12,11
367,Dirk Graham,North Stars,80,55,22,33
367,Dirk Graham,North Stars,76,54,25,29
367,Dirk Graham,North Stars,28,12,7,5
367,Dirk Graham,Blackhawks,42,36,17,19
367,Dirk Graham,Blackhawks,80,78,33,45
367,Dirk Graham,Blackhawks,73,54,22,32
367,Dirk Graham,Blackhawks,80,45,24,21
367,Dirk Graham,Blackhawks,80,47,17,30
367,Dirk Graham,Blackhawks,84,37,20,17
367,Dirk Graham,Blackhawks,67,33,15,18
367,Dirk Graham,Blackhawks,40,13,4,9
368,Jeff Friesen,Sharks,48,25,15,10
368,Jeff Friesen,Sharks,79,46,15,31
368,Jeff Friesen,Sharks,82,62,28,34
368,Jeff Friesen,Sharks,79,63,31,32
368,Jeff Friesen,Sharks,78,57,22,35
368,Jeff Friesen,Sharks,82,61,26,35
368,Jeff Friesen,Sharks,64,36,12,24
368,Jeff Friesen,Ducks,15,12,2,10
368,Jeff Friesen,Ducks,81,43,17,26
368,Jeff Friesen,Devils,81,51,23,28
368,Jeff Friesen,Devils,81,37,17,20
368,Jeff Friesen,Capitals,33,7,3,4
368,Jeff Friesen,Ducks,18,4,1,3
368,Jeff Friesen,Flames,72,12,6,6
369,David Legwand,Predators,1,0,0,0
369,David Legwand,Predators,71,28,13,15
369,David Legwand,Predators,81,41,13,28
369,David Legwand,Predators,63,30,11,19
369,David Legwand,Predators,64,48,17,31
369,David Legwand,Predators,82,47,18,29
369,David Legwand,Predators,44,26,7,19
369,David Legwand,Predators,78,63,27,36
369,David Legwand,Predators,65,44,15,29
369,David Legwand,Predators,73,42,20,22
369,David Legwand,Predators,82,38,11,27
369,David Legwand,Predators,64,41,17,24
369,David Legwand,Predators,78,53,19,34
369,David Legwand,Predators,48,25,12,13
369,David Legwand,Predators,62,40,10,30
369,David Legwand,Red Wings,21,11,4,7
369,David Legwand,Senators,22,7,2,5
370,Eric Vail,Flames,23,11,2,9
370,Eric Vail,Flames,72,60,39,21
370,Eric Vail,Flames,60,47,16,31
370,Eric Vail,Flames,78,71,32,39
370,Eric Vail,Flames,79,58,22,36
370,Eric Vail,Flames,80,83,35,48
370,Eric Vail,Flames,77,53,28,25
370,Eric Vail,Flames,64,64,28,36
370,Eric Vail,Flames,6,5,4,1
370,Eric Vail,Red Wings,52,24,10,14
371,Mark Parrish,Panthers,73,37,24,13
371,Mark Parrish,Panthers,81,44,26,18
371,Mark Parrish,Islanders,70,30,17,13
371,Mark Parrish,Islanders,78,60,30,30
371,Mark Parrish,Islanders,81,48,23,25
371,Mark Parrish,Islanders,59,35,24,11
371,Mark Parrish,Islanders,57,41,24,17
371,Mark Parrish,Kings,19,8,5,3
371,Mark Parrish,Wild,76,39,19,20
371,Mark Parrish,Wild,66,30,16,14
371,Mark Parrish,Stars,44,13,8,5
371,Mark Parrish,Lightning,16,2,0,2
371,Mark Parrish,Sabres,2,0,0,0
372,Elmer Lach,Canadiens,43,21,7,14
372,Elmer Lach,Canadiens,1,1,0,1
372,Elmer Lach,Canadiens,45,58,18,40
372,Elmer Lach,Canadiens,48,72,24,48
372,Elmer Lach,Canadiens,50,80,26,54
372,Elmer Lach,Canadiens,50,47,13,34
372,Elmer Lach,Canadiens,31,30,14,16
372,Elmer Lach,Canadiens,60,61,30,31
372,Elmer Lach,Canadiens,36,29,11,18
372,Elmer Lach,Canadiens,64,48,15,33
372,Elmer Lach,Canadiens,65,45,21,24
372,Elmer Lach,Canadiens,70,65,15,50
372,Elmer Lach,Canadiens,53,41,16,25
372,Elmer Lach,Canadiens,48,25,5,20
373,Matt Cullen,Ducks,61,27,6,21
373,Matt Cullen,Ducks,75,25,11,14
373,Matt Cullen,Ducks,80,39,13,26
373,Matt Cullen,Ducks,82,40,10,30
373,Matt Cullen,Ducks,79,48,18,30
373,Matt Cullen,Ducks,50,21,7,14
373,Matt Cullen,Panthers,30,12,6,6
373,Matt Cullen,Panthers,56,19,6,13
373,Matt Cullen,Hurricanes,78,49,25,24
373,Matt Cullen,Rangers,80,41,16,25
373,Matt Cullen,Hurricanes,59,49,13,36
373,Matt Cullen,Hurricanes,69,43,22,21
373,Matt Cullen,Hurricanes,60,40,12,28
373,Matt Cullen,Senators,21,8,4,4
373,Matt Cullen,Wild,78,39,12,27
373,Matt Cullen,Wild,73,35,14,21
373,Matt Cullen,Wild,42,27,7,20
373,Matt Cullen,Predators,77,39,10,29
373,Matt Cullen,Predators,13,7,3,4
374,Chris Kunitz,Ducks,21,6,0,6
374,Chris Kunitz,Thrashers,2,0,0,0
374,Chris Kunitz,Ducks,67,41,19,22
374,Chris Kunitz,Ducks,81,60,25,35
374,Chris Kunitz,Ducks,82,50,21,29
374,Chris Kunitz,Ducks,62,35,16,19
374,Chris Kunitz,Penguins,20,18,7,11
374,Chris Kunitz,Penguins,50,32,13,19
374,Chris Kunitz,Penguins,66,48,23,25
374,Chris Kunitz,Penguins,82,61,26,35
374,Chris Kunitz,Penguins,48,52,22,30
374,Chris Kunitz,Penguins,78,68,35,33
374,Chris Kunitz,Penguins,22,19,8,11
375,Darcy Tucker,Canadiens,3,0,0,0
375,Darcy Tucker,Canadiens,73,20,7,13
375,Darcy Tucker,Canadiens,39,6,1,5
375,Darcy Tucker,Lightning,35,14,6,8
375,Darcy Tucker,Lightning,82,43,21,22
375,Darcy Tucker,Lightning,50,34,14,20
375,Darcy Tucker,Maple Leafs,27,17,7,10
375,Darcy Tucker,Maple Leafs,82,37,16,21
375,Darcy Tucker,Maple Leafs,77,59,24,35
375,Darcy Tucker,Maple Leafs,77,36,10,26
375,Darcy Tucker,Maple Leafs,64,32,21,11
375,Darcy Tucker,Maple Leafs,74,61,28,33
375,Darcy Tucker,Maple Leafs,56,43,24,19
375,Darcy Tucker,Maple Leafs,74,34,18,16
375,Darcy Tucker,Avalanche,63,16,8,8
375,Darcy Tucker,Avalanche,71,24,10,14
376,Mariusz Czerkawski,Bruins,4,3,2,1
376,Mariusz Czerkawski,Bruins,47,26,12,14
376,Mariusz Czerkawski,Bruins,33,11,5,6
376,Mariusz Czerkawski,Oilers,37,29,12,17
376,Mariusz Czerkawski,Oilers,76,47,26,21
376,Mariusz Czerkawski,Islanders,68,25,12,13
376,Mariusz Czerkawski,Islanders,78,38,21,17
376,Mariusz Czerkawski,Islanders,79,70,35,35
376,Mariusz Czerkawski,Islanders,82,62,30,32
376,Mariusz Czerkawski,Islanders,82,51,22,29
376,Mariusz Czerkawski,Canadiens,43,14,5,9
376,Mariusz Czerkawski,Islanders,81,49,25,24
376,Mariusz Czerkawski,Maple Leafs,19,5,4,1
376,Mariusz Czerkawski,Bruins,16,5,4,1
377,Walter McKechnie,North Stars,4,0,0,0
377,Walter McKechnie,North Stars,58,14,5,9
377,Walter McKechnie,North Stars,20,4,1,3
377,Walter McKechnie,North Stars,30,4,3,1
377,Walter McKechnie,Seals,56,31,11,20
377,Walter McKechnie,Seals,78,54,16,38
377,Walter McKechnie,Seals,63,52,23,29
377,Walter McKechnie,Bruins,53,6,3,3
377,Walter McKechnie,Red Wings,23,17,6,11
377,Walter McKechnie,Red Wings,80,82,26,56
377,Walter McKechnie,Red Wings,80,59,25,34
377,Walter McKechnie,Capitals,16,5,4,1
377,Walter McKechnie,Barons,53,34,12,22
377,Walter McKechnie,Maple Leafs,79,61,25,36
377,Walter McKechnie,Maple Leafs,54,43,7,36
377,Walter McKechnie,Rockies,17,4,0,4
377,Walter McKechnie,Rockies,53,38,15,23
377,Walter McKechnie,Red Wings,74,55,18,37
377,Walter McKechnie,Red Wings,64,43,14,29
378,Chris Gratton,Lightning,84,42,13,29
378,Chris Gratton,Lightning,46,27,7,20
378,Chris Gratton,Lightning,82,38,17,21
378,Chris Gratton,Lightning,82,62,30,32
378,Chris Gratton,Flyers,82,62,22,40
378,Chris Gratton,Flyers,26,8,1,7
378,Chris Gratton,Lightning,52,26,7,19
378,Chris Gratton,Lightning,58,41,14,27
378,Chris Gratton,Sabres,14,8,1,7
378,Chris Gratton,Sabres,82,40,19,21
378,Chris Gratton,Sabres,82,39,15,24
378,Chris Gratton,Sabres,66,44,15,29
378,Chris Gratton,Coyotes,14,1,0,1
378,Chris Gratton,Coyotes,68,29,11,18
378,Chris Gratton,Avalanche,13,3,2,1
378,Chris Gratton,Panthers,76,39,17,22
378,Chris Gratton,Panthers,81,35,13,22
378,Chris Gratton,Lightning,60,21,10,11
378,Chris Gratton,Lightning,18,2,0,2
378,Chris Gratton,Blue Jackets,6,1,0,1
379,Don Maloney,Rangers,28,26,9,17
379,Don Maloney,Rangers,79,73,25,48
379,Don Maloney,Rangers,61,52,29,23
379,Don Maloney,Rangers,54,58,22,36
379,Don Maloney,Rangers,78,69,29,40
379,Don Maloney,Rangers,79,66,24,42
379,Don Maloney,Rangers,37,27,11,16
379,Don Maloney,Rangers,68,28,11,17
379,Don Maloney,Rangers,72,57,19,38
379,Don Maloney,Rangers,66,33,12,21
379,Don Maloney,Rangers,31,13,4,9
379,Don Maloney,Whalers,21,14,3,11
379,Don Maloney,Islanders,79,43,16,27
379,Don Maloney,Islanders,12,5,0,5
380,Justin Williams,Flyers,63,25,12,13
380,Justin Williams,Flyers,75,40,17,23
380,Justin Williams,Flyers,41,24,8,16
380,Justin Williams,Flyers,47,26,6,20
380,Justin Williams,Hurricanes,32,18,5,13
380,Justin Williams,Hurricanes,82,76,31,45
380,Justin Williams,Hurricanes,82,67,33,34
380,Justin Williams,Hurricanes,37,30,9,21
380,Justin Williams,Hurricanes,32,10,3,7
380,Justin Williams,Kings,12,4,1,3
380,Justin Williams,Kings,49,29,10,19
380,Justin Williams,Kings,73,57,22,35
380,Justin Williams,Kings,82,59,22,37
380,Justin Williams,Kings,48,33,11,22
380,Justin Williams,Kings,82,43,19,24
380,Justin Williams,Kings,22,11,5,6
381,Gary Dornhoefer,Bruins,32,22,12,10
381,Gary Dornhoefer,Bruins,20,1,0,1
381,Gary Dornhoefer,Bruins,10,1,0,1
381,Gary Dornhoefer,Flyers,65,43,13,30
381,Gary Dornhoefer,Flyers,60,24,8,16
381,Gary Dornhoefer,Flyers,65,55,26,29
381,Gary Dornhoefer,Flyers,57,40,20,20
381,Gary Dornhoefer,Flyers,75,49,17,32
381,Gary Dornhoefer,Flyers,77,79,30,49
381,Gary Dornhoefer,Flyers,57,50,11,39
381,Gary Dornhoefer,Flyers,69,44,17,27
381,Gary Dornhoefer,Flyers,74,63,28,35
381,Gary Dornhoefer,Flyers,79,59,25,34
381,Gary Dornhoefer,Flyers,47,12,7,5
382,J-P Dumont,Blackhawks,25,15,9,6
382,J-P Dumont,Blackhawks,47,18,10,8
382,J-P Dumont,Sabres,79,51,23,28
382,J-P Dumont,Sabres,76,44,23,21
382,J-P Dumont,Sabres,76,35,14,21
382,J-P Dumont,Sabres,77,53,22,31
382,J-P Dumont,Sabres,54,40,20,20
382,J-P Dumont,Predators,82,66,21,45
382,J-P Dumont,Predators,80,72,29,43
382,J-P Dumont,Predators,82,65,16,49
382,J-P Dumont,Predators,74,45,17,28
382,J-P Dumont,Predators,70,19,10,9
383,Brad Park,Rangers,54,26,3,23
383,Brad Park,Rangers,60,37,11,26
383,Brad Park,Rangers,68,44,7,37
383,Brad Park,Rangers,75,73,24,49
383,Brad Park,Rangers,52,53,10,43
383,Brad Park,Rangers,78,82,25,57
383,Brad Park,Rangers,65,57,13,44
383,Brad Park,Rangers,13,6,2,4
383,Brad Park,Bruins,43,53,16,37
383,Brad Park,Bruins,77,67,12,55
383,Brad Park,Bruins,80,79,22,57
383,Brad Park,Bruins,40,39,7,32
383,Brad Park,Bruins,32,21,5,16
383,Brad Park,Bruins,78,66,14,52
383,Brad Park,Bruins,75,56,14,42
383,Brad Park,Bruins,76,36,10,26
383,Brad Park,Red Wings,80,58,5,53
383,Brad Park,Red Wings,67,43,13,30
384,Jason Blake,Kings,1,1,1,0
384,Jason Blake,Kings,64,23,5,18
384,Jason Blake,Kings,17,4,1,3
384,Jason Blake,Islanders,30,12,4,8
384,Jason Blake,Islanders,82,18,8,10
384,Jason Blake,Islanders,81,55,25,30
384,Jason Blake,Islanders,75,47,22,25
384,Jason Blake,Islanders,76,57,28,29
384,Jason Blake,Islanders,82,69,40,29
384,Jason Blake,Maple Leafs,82,52,15,37
384,Jason Blake,Maple Leafs,78,63,25,38
384,Jason Blake,Maple Leafs,56,26,10,16
384,Jason Blake,Ducks,26,15,6,9
384,Jason Blake,Ducks,76,32,16,16
384,Jason Blake,Ducks,45,12,7,5
385,Craig MacTavish,Bruins,46,28,11,17
385,Craig MacTavish,Bruins,24,8,3,5
385,Craig MacTavish,Bruins,2,1,0,1
385,Craig MacTavish,Bruins,75,30,10,20
385,Craig MacTavish,Bruins,70,43,20,23
385,Craig MacTavish,Oilers,74,47,23,24
385,Craig MacTavish,Oilers,79,39,20,19
385,Craig MacTavish,Oilers,80,32,15,17
385,Craig MacTavish,Oilers,80,52,21,31
385,Craig MacTavish,Oilers,80,43,21,22
385,Craig MacTavish,Oilers,80,32,17,15
385,Craig MacTavish,Oilers,80,30,12,18
385,Craig MacTavish,Oilers,82,30,10,20
385,Craig MacTavish,Oilers,66,26,16,10
385,Craig MacTavish,Rangers,12,6,4,2
385,Craig MacTavish,Flyers,45,12,3,9
385,Craig MacTavish,Flyers,55,13,5,8
385,Craig MacTavish,Blues,13,1,0,1
385,Craig MacTavish,Blues,50,7,2,5
386,Bruce MacGregor,Red Wings,12,1,0,1
386,Bruce MacGregor,Red Wings,65,18,6,12
386,Bruce MacGregor,Red Wings,67,22,11,11
386,Bruce MacGregor,Red Wings,63,32,11,21
386,Bruce MacGregor,Red Wings,66,41,21,20
386,Bruce MacGregor,Red Wings,70,34,20,14
386,Bruce MacGregor,Red Wings,70,47,28,19
386,Bruce MacGregor,Red Wings,71,39,15,24
386,Bruce MacGregor,Red Wings,69,41,18,23
386,Bruce MacGregor,Red Wings,73,38,15,23
386,Bruce MacGregor,Red Wings,47,22,6,16
386,Bruce MacGregor,Rangers,27,25,12,13
386,Bruce MacGregor,Rangers,75,40,19,21
386,Bruce MacGregor,Rangers,52,26,14,12
386,Bruce MacGregor,Rangers,66,44,17,27
387,Mark Hunter,Canadiens,71,29,18,11
387,Mark Hunter,Canadiens,31,16,8,8
387,Mark Hunter,Canadiens,22,10,6,4
387,Mark Hunter,Canadiens,72,33,21,12
387,Mark Hunter,Blues,78,74,44,30
387,Mark Hunter,Blues,74,69,36,33
387,Mark Hunter,Blues,66,63,32,31
387,Mark Hunter,Flames,66,30,22,8
387,Mark Hunter,Flames,10,5,2,3
387,Mark Hunter,Flames,57,25,10,15
387,Mark Hunter,Whalers,11,7,4,3
387,Mark Hunter,Whalers,63,23,10,13
387,Mark Hunter,Capitals,7,0,0,0
388,Mark Osborne,Red Wings,80,67,26,41
388,Mark Osborne,Red Wings,80,43,19,24
388,Mark Osborne,Rangers,73,51,23,28
388,Mark Osborne,Rangers,23,8,4,4
388,Mark Osborne,Rangers,62,40,16,24
388,Mark Osborne,Rangers,58,32,17,15
388,Mark Osborne,Maple Leafs,16,15,5,10
388,Mark Osborne,Maple Leafs,79,60,23,37
388,Mark Osborne,Maple Leafs,75,46,16,30
388,Mark Osborne,Maple Leafs,78,73,23,50
388,Mark Osborne,Maple Leafs,18,6,3,3
388,Mark Osborne,Jets (1979),37,16,8,8
388,Mark Osborne,Jets (1979),43,16,4,12
388,Mark Osborne,Maple Leafs,11,4,3,1
388,Mark Osborne,Maple Leafs,76,26,12,14
388,Mark Osborne,Maple Leafs,73,24,9,15
388,Mark Osborne,Rangers,37,4,1,3
389,Fred Stanfield,Blackhawks,58,17,7,10
389,Fred Stanfield,Blackhawks,39,4,2,2
389,Fred Stanfield,Blackhawks,10,1,1,0
389,Fred Stanfield,Bruins,73,64,20,44
389,Fred Stanfield,Bruins,71,54,25,29
389,Fred Stanfield,Bruins,73,58,23,35
389,Fred Stanfield,Bruins,75,76,24,52
389,Fred Stanfield,Bruins,78,79,23,56
389,Fred Stanfield,Bruins,78,78,20,58
389,Fred Stanfield,North Stars,71,44,16,28
389,Fred Stanfield,North Stars,40,26,8,18
389,Fred Stanfield,Sabres,32,33,12,21
389,Fred Stanfield,Sabres,80,48,18,30
389,Fred Stanfield,Sabres,79,23,9,14
389,Fred Stanfield,Sabres,57,11,3,8
390,Andre Savard,Bruins,72,30,16,14
390,Andre Savard,Bruins,77,44,19,25
390,Andre Savard,Bruins,79,40,17,23
390,Andre Savard,Sabres,80,60,25,35
390,Andre Savard,Sabres,80,39,19,20
390,Andre Savard,Sabres,65,40,18,22
390,Andre Savard,Sabres,33,13,3,10
390,Andre Savard,Sabres,79,74,31,43
390,Andre Savard,Sabres,62,38,18,20
390,Andre Savard,Sabres,68,41,16,25
390,Andre Savard,Nordiques,60,44,20,24
390,Andre Savard,Nordiques,35,19,9,10
391,Gerard Gallant,Red Wings,32,18,6,12
391,Gerard Gallant,Red Wings,52,39,20,19
391,Gerard Gallant,Red Wings,80,72,38,34
391,Gerard Gallant,Red Wings,73,73,34,39
391,Gerard Gallant,Red Wings,76,93,39,54
391,Gerard Gallant,Red Wings,69,80,36,44
391,Gerard Gallant,Red Wings,45,26,10,16
391,Gerard Gallant,Red Wings,69,36,14,22
391,Gerard Gallant,Red Wings,67,30,10,20
391,Gerard Gallant,Lightning,51,13,4,9
391,Gerard Gallant,Lightning,1,0,0,0
392,Woody Dumart,Bruins,1,0,0,0
392,Woody Dumart,Bruins,17,8,4,4
392,Woody Dumart,Bruins,48,27,13,14
392,Woody Dumart,Bruins,46,29,14,15
392,Woody Dumart,Bruins,48,43,22,21
392,Woody Dumart,Bruins,40,33,18,15
392,Woody Dumart,Bruins,35,29,14,15
392,Woody Dumart,Bruins,50,34,22,12
392,Woody Dumart,Bruins,60,52,24,28
392,Woody Dumart,Bruins,59,37,21,16
392,Woody Dumart,Bruins,59,23,11,12
392,Woody Dumart,Bruins,69,39,14,25
392,Woody Dumart,Bruins,70,41,20,21
392,Woody Dumart,Bruins,39,13,5,8
392,Woody Dumart,Bruins,62,14,5,9
392,Woody Dumart,Bruins,69,7,4,3
393,Douglas Smail,Jets (1979),30,18,10,8
393,Douglas Smail,Jets (1979),72,35,17,18
393,Douglas Smail,Jets (1979),80,44,15,29
393,Douglas Smail,Jets (1979),66,37,20,17
393,Douglas Smail,Jets (1979),80,66,31,35
393,Douglas Smail,Jets (1979),73,42,16,26
393,Douglas Smail,Jets (1979),78,43,25,18
393,Douglas Smail,Jets (1979),71,31,15,16
393,Douglas Smail,Jets (1979),47,29,14,15
393,Douglas Smail,Jets (1979),79,49,25,24
393,Douglas Smail,Jets (1979),15,3,1,2
393,Douglas Smail,North Stars,57,20,7,13
393,Douglas Smail,Nordiques,46,28,10,18
393,Douglas Smail,Senators,51,14,4,10
394,Michael Nylander,Whalers,59,33,11,22
394,Michael Nylander,Whalers,58,44,11,33
394,Michael Nylander,Flames,15,11,2,9
394,Michael Nylander,Flames,6,1,0,1
394,Michael Nylander,Flames,73,55,17,38
394,Michael Nylander,Flames,65,36,13,23
394,Michael Nylander,Flames,9,5,2,3
394,Michael Nylander,Lightning,24,9,2,7
394,Michael Nylander,Lightning,11,3,1,2
394,Michael Nylander,Blackhawks,66,51,23,28
394,Michael Nylander,Blackhawks,82,64,25,39
394,Michael Nylander,Blackhawks,82,61,15,46
394,Michael Nylander,Blackhawks,9,4,0,4
394,Michael Nylander,Capitals,71,56,17,39
394,Michael Nylander,Capitals,3,2,0,2
394,Michael Nylander,Bruins,15,12,1,11
394,Michael Nylander,Rangers,81,79,23,56
394,Michael Nylander,Rangers,79,83,26,57
394,Michael Nylander,Capitals,40,37,11,26
394,Michael Nylander,Capitals,72,33,9,24
395,Thomas Gradin,Canucks,76,51,20,31
395,Thomas Gradin,Canucks,80,75,30,45
395,Thomas Gradin,Canucks,79,69,21,48
395,Thomas Gradin,Canucks,76,86,37,49
395,Thomas Gradin,Canucks,80,86,32,54
395,Thomas Gradin,Canucks,75,78,21,57
395,Thomas Gradin,Canucks,76,64,22,42
395,Thomas Gradin,Canucks,71,41,14,27
395,Thomas Gradin,Bruins,64,43,12,31
396,Larry Robinson,Canadiens,36,6,2,4
396,Larry Robinson,Canadiens,78,26,6,20
396,Larry Robinson,Canadiens,80,61,14,47
396,Larry Robinson,Canadiens,80,40,10,30
396,Larry Robinson,Canadiens,77,85,19,66
396,Larry Robinson,Canadiens,80,65,13,52
396,Larry Robinson,Canadiens,67,61,16,45
396,Larry Robinson,Canadiens,72,75,14,61
396,Larry Robinson,Canadiens,65,50,12,38
396,Larry Robinson,Canadiens,71,59,12,47
396,Larry Robinson,Canadiens,71,63,14,49
396,Larry Robinson,Canadiens,74,43,9,34
396,Larry Robinson,Canadiens,76,47,14,33
396,Larry Robinson,Canadiens,78,82,19,63
396,Larry Robinson,Canadiens,70,50,13,37
396,Larry Robinson,Canadiens,53,40,6,34
396,Larry Robinson,Canadiens,74,30,4,26
396,Larry Robinson,Kings,64,39,7,32
396,Larry Robinson,Kings,62,23,1,22
396,Larry Robinson,Kings,56,13,3,10
397,Clifford Koroll,Blackhawks,73,37,18,19
397,Clifford Koroll,Blackhawks,72,50,16,34
397,Clifford Koroll,Blackhawks,76,45,22,23
397,Clifford Koroll,Blackhawks,77,57,33,24
397,Clifford Koroll,Blackhawks,78,46,21,25
397,Clifford Koroll,Blackhawks,80,59,27,32
397,Clifford Koroll,Blackhawks,80,58,25,33
397,Clifford Koroll,Blackhawks,80,41,15,26
397,Clifford Koroll,Blackhawks,73,31,16,15
397,Clifford Koroll,Blackhawks,78,31,12,19
397,Clifford Koroll,Blackhawks,47,7,3,4
398,Loran Thompson,Maple Leafs,1,0,0,0
398,Loran Thompson,Maple Leafs,68,32,13,19
398,Loran Thompson,Maple Leafs,56,15,7,8
398,Loran Thompson,Maple Leafs,65,42,25,17
398,Loran Thompson,Maple Leafs,75,80,43,37
398,Loran Thompson,Maple Leafs,41,37,21,16
398,Loran Thompson,Maple Leafs,59,39,17,22
398,Loran Thompson,Red Wings,14,6,5,1
398,Loran Thompson,Red Wings,70,54,23,31
398,Loran Thompson,Red Wings,77,48,34,14
398,Loran Thompson,Red Wings,39,26,14,12
398,Loran Thompson,Penguins,34,14,6,8
399,Marc Savard,Rangers,28,6,1,5
399,Marc Savard,Rangers,70,45,9,36
399,Marc Savard,Flames,78,53,22,31
399,Marc Savard,Flames,77,65,23,42
399,Marc Savard,Flames,56,33,14,19
399,Marc Savard,Flames,10,3,1,2
399,Marc Savard,Thrashers,57,47,16,31
399,Marc Savard,Thrashers,45,52,19,33
399,Marc Savard,Thrashers,82,97,28,69
399,Marc Savard,Bruins,82,96,22,74
399,Marc Savard,Bruins,74,78,15,63
399,Marc Savard,Bruins,82,88,25,63
399,Marc Savard,Bruins,41,33,10,23
399,Marc Savard,Bruins,25,10,2,8
400,Phil Goyette,Canadiens,14,7,3,4
400,Phil Goyette,Canadiens,70,46,9,37
400,Phil Goyette,Canadiens,63,28,10,18
400,Phil Goyette,Canadiens,65,43,21,22
400,Phil Goyette,Canadiens,62,11,7,4
400,Phil Goyette,Canadiens,69,34,7,27
400,Phil Goyette,Canadiens,32,13,5,8
400,Phil Goyette,Rangers,67,65,24,41
400,Phil Goyette,Rangers,52,46,12,34
400,Phil Goyette,Rangers,60,42,11,31
400,Phil Goyette,Rangers,70,61,12,49
400,Phil Goyette,Rangers,73,65,25,40
400,Phil Goyette,Rangers,67,45,13,32
400,Phil Goyette,Blues,72,78,29,49
400,Phil Goyette,Sabres,60,61,15,46
400,Phil Goyette,Sabres,37,24,3,21
400,Phil Goyette,Rangers,8,5,1,4
401,Mike Ribeiro,Canadiens,19,2,1,1
401,Mike Ribeiro,Canadiens,2,0,0,0
401,Mike Ribeiro,Canadiens,43,18,8,10
401,Mike Ribeiro,Canadiens,52,17,5,12
401,Mike Ribeiro,Canadiens,81,65,20,45
401,Mike Ribeiro,Canadiens,79,51,16,35
401,Mike Ribeiro,Stars,81,59,18,41
401,Mike Ribeiro,Stars,76,83,27,56
401,Mike Ribeiro,Stars,82,78,22,56
401,Mike Ribeiro,Stars,66,53,19,34
401,Mike Ribeiro,Stars,82,71,19,52
401,Mike Ribeiro,Stars,74,63,18,45
401,Mike Ribeiro,Capitals,48,49,13,36
401,Mike Ribeiro,Coyotes,80,47,16,31
401,Mike Ribeiro,Predators,22,17,5,12
402,Anze Kopitar,Kings,72,61,20,41
402,Anze Kopitar,Kings,82,77,32,45
402,Anze Kopitar,Kings,82,66,27,39
402,Anze Kopitar,Kings,82,81,34,47
402,Anze Kopitar,Kings,75,73,25,48
402,Anze Kopitar,Kings,82,76,25,51
402,Anze Kopitar,Kings,47,42,10,32
402,Anze Kopitar,Kings,82,70,29,41
402,Anze Kopitar,Kings,20,10,5,5
403,Pete Stemkowski,Maple Leafs,1,0,0,0
403,Pete Stemkowski,Maple Leafs,36,20,5,15
403,Pete Stemkowski,Maple Leafs,56,16,4,12
403,Pete Stemkowski,Maple Leafs,68,35,13,22
403,Pete Stemkowski,Maple Leafs,60,22,7,15
403,Pete Stemkowski,Red Wings,13,9,3,6
403,Pete Stemkowski,Red Wings,71,52,21,31
403,Pete Stemkowski,Red Wings,76,49,25,24
403,Pete Stemkowski,Red Wings,10,4,2,2
403,Pete Stemkowski,Rangers,68,45,16,29
403,Pete Stemkowski,Rangers,59,28,11,17
403,Pete Stemkowski,Rangers,78,59,22,37
403,Pete Stemkowski,Rangers,78,70,25,45
403,Pete Stemkowski,Rangers,77,59,24,35
403,Pete Stemkowski,Rangers,75,41,13,28
403,Pete Stemkowski,Rangers,61,15,2,13
403,Pete Stemkowski,Kings,80,31,13,18
404,Yvon Lambert,Canadiens,1,0,0,0
404,Yvon Lambert,Canadiens,60,16,6,10
404,Yvon Lambert,Canadiens,80,67,32,35
404,Yvon Lambert,Canadiens,80,67,32,35
404,Yvon Lambert,Canadiens,79,52,24,28
404,Yvon Lambert,Canadiens,77,40,18,22
404,Yvon Lambert,Canadiens,79,66,26,40
404,Yvon Lambert,Canadiens,77,53,21,32
404,Yvon Lambert,Canadiens,73,54,22,32
404,Yvon Lambert,Sabres,77,64,25,39
405,John McKenzie,Blackhawks,32,7,3,4
405,John McKenzie,Red Wings,59,20,8,12
405,John McKenzie,Red Wings,16,4,3,1
405,John McKenzie,Blackhawks,45,18,9,9
405,John McKenzie,Blackhawks,51,18,8,10
405,John McKenzie,Rangers,35,11,6,5
405,John McKenzie,Bruins,36,22,13,9
405,John McKenzie,Bruins,69,36,17,19
405,John McKenzie,Bruins,74,66,28,38
405,John McKenzie,Bruins,60,56,29,27
405,John McKenzie,Bruins,72,70,29,41
405,John McKenzie,Bruins,65,77,31,46
405,John McKenzie,Bruins,77,69,22,47
406,Herb Cain,Maroons,30,9,4,5
406,Herb Cain,Maroons,44,27,20,7
406,Herb Cain,Maroons,48,18,5,13
406,Herb Cain,Maroons,42,30,13,17
406,Herb Cain,Maroons,47,30,11,19
406,Herb Cain,Canadiens,45,27,13,14
406,Herb Cain,Bruins,48,31,21,10
406,Herb Cain,Bruins,41,18,8,10
406,Herb Cain,Bruins,34,18,8,10
406,Herb Cain,Bruins,45,36,18,18
406,Herb Cain,Bruins,48,82,36,46
406,Herb Cain,Bruins,50,45,32,13
406,Herb Cain,Bruins,48,29,17,12
407,Guy Chouinard,Flames,5,0,0,0
407,Guy Chouinard,Flames,4,2,0,2
407,Guy Chouinard,Flames,80,50,17,33
407,Guy Chouinard,Flames,73,58,28,30
407,Guy Chouinard,Flames,80,107,50,57
407,Guy Chouinard,Flames,76,77,31,46
407,Guy Chouinard,Flames,52,83,31,52
407,Guy Chouinard,Flames,64,80,23,57
407,Guy Chouinard,Flames,80,72,13,59
407,Guy Chouinard,Blues,64,46,12,34
408,Ronald Sutter,Flyers,10,2,1,1
408,Ronald Sutter,Flyers,79,51,19,32
408,Ronald Sutter,Flyers,73,45,16,29
408,Ronald Sutter,Flyers,75,60,18,42
408,Ronald Sutter,Flyers,39,28,10,18
408,Ronald Sutter,Flyers,69,33,8,25
408,Ronald Sutter,Flyers,55,48,26,22
408,Ronald Sutter,Flyers,75,48,22,26
408,Ronald Sutter,Flyers,80,45,17,28
408,Ronald Sutter,Blues,68,46,19,27
408,Ronald Sutter,Blues,59,27,12,15
408,Ronald Sutter,Blues,36,18,6,12
408,Ronald Sutter,Nordiques,37,22,9,13
408,Ronald Sutter,Islanders,27,5,1,4
408,Ronald Sutter,Bruins,18,12,5,7
408,Ronald Sutter,Sharks,78,12,5,7
408,Ronald Sutter,Sharks,57,9,2,7
408,Ronald Sutter,Sharks,59,9,3,6
408,Ronald Sutter,Sharks,78,11,5,6
408,Ronald Sutter,Flames,21,4,1,3
409,David Poulin,Flyers,2,2,2,0
409,David Poulin,Flyers,73,76,31,45
409,David Poulin,Flyers,73,74,30,44
409,David Poulin,Flyers,79,69,27,42
409,David Poulin,Flyers,75,70,25,45
409,David Poulin,Flyers,68,51,19,32
409,David Poulin,Flyers,69,35,18,17
409,David Poulin,Flyers,28,17,9,8
409,David Poulin,Bruins,32,25,6,19
409,David Poulin,Bruins,31,20,8,12
409,David Poulin,Bruins,18,8,4,4
409,David Poulin,Bruins,84,49,16,33
409,David Poulin,Capitals,63,25,6,19
409,David Poulin,Capitals,29,9,4,5
410,Gregory Sheppard,Bruins,64,50,24,26
410,Gregory Sheppard,Bruins,75,47,16,31
410,Gregory Sheppard,Bruins,76,78,30,48
410,Gregory Sheppard,Bruins,70,74,31,43
410,Gregory Sheppard,Bruins,77,67,31,36
410,Gregory Sheppard,Bruins,54,59,23,36
410,Gregory Sheppard,Penguins,60,37,15,22
410,Gregory Sheppard,Penguins,76,37,13,24
410,Gregory Sheppard,Penguins,47,28,11,17
410,Gregory Sheppard,Penguins,58,21,11,10
411,Ron Murphy,Rangers,15,4,3,1
411,Ron Murphy,Rangers,27,4,1,3
411,Ron Murphy,Rangers,66,30,14,16
411,Ron Murphy,Rangers,66,44,16,28
411,Ron Murphy,Rangers,33,19,7,12
411,Ron Murphy,Blackhawks,69,28,11,17
411,Ron Murphy,Blackhawks,59,47,17,30
411,Ron Murphy,Blackhawks,63,36,15,21
411,Ron Murphy,Blackhawks,70,40,21,19
411,Ron Murphy,Blackhawks,60,28,12,16
411,Ron Murphy,Blackhawks,68,34,18,16
411,Ron Murphy,Blackhawks,70,19,11,8
411,Ron Murphy,Red Wings,58,39,20,19
411,Ron Murphy,Red Wings,32,17,10,7
411,Ron Murphy,Bruins,2,1,0,1
411,Ron Murphy,Bruins,39,27,11,16
411,Ron Murphy,Bruins,12,1,0,1
411,Ron Murphy,Bruins,60,54,16,38
411,Ron Murphy,Bruins,20,7,2,5
412,Jonathan Toews,Blackhawks,64,54,24,30
412,Jonathan Toews,Blackhawks,82,69,34,35
412,Jonathan Toews,Blackhawks,76,68,25,43
412,Jonathan Toews,Blackhawks,80,76,32,44
412,Jonathan Toews,Blackhawks,59,57,29,28
412,Jonathan Toews,Blackhawks,47,48,23,25
412,Jonathan Toews,Blackhawks,76,68,28,40
412,Jonathan Toews,Blackhawks,23,19,10,9
413,Andrew Cassels,Canadiens,6,2,2,0
413,Andrew Cassels,Canadiens,54,25,6,19
413,Andrew Cassels,Whalers,67,41,11,30
413,Andrew Cassels,Whalers,84,85,21,64
413,Andrew Cassels,Whalers,79,58,16,42
413,Andrew Cassels,Whalers,46,37,7,30
413,Andrew Cassels,Whalers,81,63,20,43
413,Andrew Cassels,Whalers,81,66,22,44
413,Andrew Cassels,Flames,81,44,17,27
413,Andrew Cassels,Flames,70,37,12,25
413,Andrew Cassels,Canucks,79,62,17,45
413,Andrew Cassels,Canucks,66,56,12,44
413,Andrew Cassels,Canucks,53,50,11,39
413,Andrew Cassels,Blue Jackets,79,68,20,48
413,Andrew Cassels,Blue Jackets,58,26,6,20
413,Andrew Cassels,Capitals,31,12,4,8
414,Terry O'Reilly,Bruins,1,1,1,0
414,Terry O'Reilly,Bruins,72,27,5,22
414,Terry O'Reilly,Bruins,76,35,11,24
414,Terry O'Reilly,Bruins,68,35,15,20
414,Terry O'Reilly,Bruins,80,50,23,27
414,Terry O'Reilly,Bruins,79,55,14,41
414,Terry O'Reilly,Bruins,77,90,29,61
414,Terry O'Reilly,Bruins,80,77,26,51
414,Terry O'Reilly,Bruins,71,61,19,42
414,Terry O'Reilly,Bruins,77,43,8,35
414,Terry O'Reilly,Bruins,70,52,22,30
414,Terry O'Reilly,Bruins,19,20,6,14
414,Terry O'Reilly,Bruins,58,30,12,18
414,Terry O'Reilly,Bruins,63,30,13,17
415,Ilkka Sinisalo,Flyers,66,37,15,22
415,Ilkka Sinisalo,Flyers,61,50,21,29
415,Ilkka Sinisalo,Flyers,73,46,29,17
415,Ilkka Sinisalo,Flyers,70,73,36,37
415,Ilkka Sinisalo,Flyers,74,76,39,37
415,Ilkka Sinisalo,Flyers,42,31,10,21
415,Ilkka Sinisalo,Flyers,68,42,25,17
415,Ilkka Sinisalo,Flyers,13,7,1,6
415,Ilkka Sinisalo,Flyers,59,46,23,23
415,Ilkka Sinisalo,North Stars,46,17,5,12
415,Ilkka Sinisalo,Kings,7,0,0,0
415,Ilkka Sinisalo,Kings,3,1,0,1
416,Lorne Carr,Rangers,14,0,0,0
416,Lorne Carr,Americans,48,31,17,14
416,Lorne Carr,Americans,44,18,8,10
416,Lorne Carr,Americans,48,34,18,16
416,Lorne Carr,Americans,48,23,16,7
416,Lorne Carr,Americans,46,37,19,18
416,Lorne Carr,Americans,48,25,8,17
416,Lorne Carr,Americans,48,32,13,19
416,Lorne Carr,Maple Leafs,47,33,16,17
416,Lorne Carr,Maple Leafs,50,60,27,33
416,Lorne Carr,Maple Leafs,50,74,36,38
416,Lorne Carr,Maple Leafs,47,46,21,25
416,Lorne Carr,Maple Leafs,42,13,5,8
417,Gary Suter,Flames,80,68,18,50
417,Gary Suter,Flames,68,48,9,39
417,Gary Suter,Flames,75,91,21,70
417,Gary Suter,Flames,63,62,13,49
417,Gary Suter,Flames,76,76,16,60
417,Gary Suter,Flames,79,70,12,58
417,Gary Suter,Flames,70,55,12,43
417,Gary Suter,Flames,81,81,23,58
417,Gary Suter,Flames,25,13,4,9
417,Gary Suter,Blackhawks,16,5,2,3
417,Gary Suter,Blackhawks,48,37,10,27
417,Gary Suter,Blackhawks,82,67,20,47
417,Gary Suter,Blackhawks,82,28,7,21
417,Gary Suter,Blackhawks,73,42,14,28
417,Gary Suter,Sharks,1,0,0,0
417,Gary Suter,Sharks,76,34,6,28
417,Gary Suter,Sharks,68,34,10,24
417,Gary Suter,Sharks,82,33,6,27
418,Mark Johnson,Penguins,17,8,3,5
418,Mark Johnson,Penguins,73,33,10,23
418,Mark Johnson,Penguins,46,21,10,11
418,Mark Johnson,North Stars,10,4,2,2
418,Mark Johnson,Whalers,73,69,31,38
418,Mark Johnson,Whalers,79,87,35,52
418,Mark Johnson,Whalers,49,47,19,28
418,Mark Johnson,Blues,17,10,4,6
418,Mark Johnson,Devils,80,62,21,41
418,Mark Johnson,Devils,68,51,25,26
418,Mark Johnson,Devils,54,33,14,19
418,Mark Johnson,Devils,40,38,13,25
418,Mark Johnson,Devils,63,45,16,29
419,Nathan Horton,Panthers,55,22,14,8
419,Nathan Horton,Panthers,71,47,28,19
419,Nathan Horton,Panthers,82,62,31,31
419,Nathan Horton,Panthers,82,62,27,35
419,Nathan Horton,Panthers,67,45,22,23
419,Nathan Horton,Panthers,65,57,20,37
419,Nathan Horton,Bruins,80,53,26,27
419,Nathan Horton,Bruins,46,32,17,15
419,Nathan Horton,Bruins,43,22,13,9
419,Nathan Horton,Blue Jackets,36,19,5,14
420,Mike Rogers,Whalers,80,105,44,61
420,Mike Rogers,Whalers,80,105,40,65
420,Mike Rogers,Rangers,80,103,38,65
420,Mike Rogers,Rangers,71,76,29,47
420,Mike Rogers,Rangers,78,61,23,38
420,Mike Rogers,Rangers,78,64,26,38
420,Mike Rogers,Rangers,9,4,1,3
420,Mike Rogers,Oilers,8,1,1,0
421,Derek Sanderson,Bruins,2,0,0,0
421,Derek Sanderson,Bruins,2,0,0,0
421,Derek Sanderson,Bruins,71,49,24,25
421,Derek Sanderson,Bruins,61,48,26,22
421,Derek Sanderson,Bruins,50,41,18,23
421,Derek Sanderson,Bruins,71,63,29,34
421,Derek Sanderson,Bruins,78,58,25,33
421,Derek Sanderson,Bruins,25,15,5,10
421,Derek Sanderson,Bruins,29,20,8,12
421,Derek Sanderson,Rangers,75,50,25,25
421,Derek Sanderson,Rangers,8,0,0,0
421,Derek Sanderson,Blues,65,67,24,43
421,Derek Sanderson,Blues,32,21,8,13
421,Derek Sanderson,Canucks,16,16,7,9
421,Derek Sanderson,Penguins,13,4,3,1
422,Anson Carter,Capitals,19,5,3,2
422,Anson Carter,Bruins,19,13,8,5
422,Anson Carter,Bruins,78,43,16,27
422,Anson Carter,Bruins,55,40,24,16
422,Anson Carter,Bruins,59,47,22,25
422,Anson Carter,Oilers,61,42,16,26
422,Anson Carter,Oilers,82,60,28,32
422,Anson Carter,Oilers,68,55,25,30
422,Anson Carter,Rangers,11,5,1,4
422,Anson Carter,Rangers,43,17,10,7
422,Anson Carter,Capitals,19,10,5,5
422,Anson Carter,Kings,15,1,0,1
422,Anson Carter,Canucks,81,55,33,22
422,Anson Carter,Blue Jackets,54,27,10,17
422,Anson Carter,Hurricanes,10,1,1,0
423,William Flett,Kings,73,46,26,20
423,William Flett,Kings,72,49,24,25
423,William Flett,Kings,69,32,14,18
423,William Flett,Kings,64,37,13,24
423,William Flett,Kings,45,19,7,12
423,William Flett,Flyers,31,21,11,10
423,William Flett,Flyers,69,74,43,31
423,William Flett,Flyers,67,44,17,27
423,William Flett,Maple Leafs,77,40,15,25
423,William Flett,Flames,78,40,23,17
423,William Flett,Flames,24,8,4,4
423,William Flett,Oilers,20,7,5,2
424,Mike Walton,Maple Leafs,6,4,1,3
424,Mike Walton,Maple Leafs,31,17,7,10
424,Mike Walton,Maple Leafs,73,59,30,29
424,Mike Walton,Maple Leafs,66,43,22,21
424,Mike Walton,Maple Leafs,58,55,21,34
424,Mike Walton,Maple Leafs,23,13,3,10
424,Mike Walton,Bruins,22,8,3,5
424,Mike Walton,Bruins,76,56,28,28
424,Mike Walton,Bruins,56,47,25,22
424,Mike Walton,Canucks,10,16,8,8
424,Mike Walton,Canucks,40,31,7,24
424,Mike Walton,Canucks,65,66,29,37
424,Mike Walton,Blues,22,18,7,11
424,Mike Walton,Bruins,14,6,4,2
424,Mike Walton,Blackhawks,26,9,6,3
425,Syl Apps,Maple Leafs,48,45,16,29
425,Syl Apps,Maple Leafs,47,50,21,29
425,Syl Apps,Maple Leafs,44,40,15,25
425,Syl Apps,Maple Leafs,27,30,13,17
425,Syl Apps,Maple Leafs,41,44,20,24
425,Syl Apps,Maple Leafs,38,41,18,23
425,Syl Apps,Maple Leafs,29,40,23,17
425,Syl Apps,Maple Leafs,40,40,24,16
425,Syl Apps,Maple Leafs,54,49,25,24
425,Syl Apps,Maple Leafs,55,53,26,27
426,Sweeney Schriner,Americans,48,40,18,22
426,Sweeney Schriner,Americans,48,45,19,26
426,Sweeney Schriner,Americans,48,46,21,25
426,Sweeney Schriner,Americans,48,38,21,17
426,Sweeney Schriner,Americans,48,44,13,31
426,Sweeney Schriner,Maple Leafs,39,26,11,15
426,Sweeney Schriner,Maple Leafs,48,38,24,14
426,Sweeney Schriner,Maple Leafs,47,36,20,16
426,Sweeney Schriner,Maple Leafs,37,36,19,17
426,Sweeney Schriner,Maple Leafs,26,37,22,15
426,Sweeney Schriner,Maple Leafs,47,19,13,6
427,Paul Gardner,Rockies,60,59,30,29
427,Paul Gardner,Rockies,46,52,30,22
427,Paul Gardner,Rockies,64,49,23,26
427,Paul Gardner,Maple Leafs,11,9,7,2
427,Paul Gardner,Maple Leafs,45,24,11,13
427,Paul Gardner,Penguins,62,74,34,40
427,Paul Gardner,Penguins,59,69,36,33
427,Paul Gardner,Penguins,70,55,28,27
427,Paul Gardner,Penguins,16,5,0,5
427,Paul Gardner,Capitals,12,6,2,4
427,Paul Gardner,Sabres,2,0,0,0
428,Babe Dye,Saint Patricks,23,14,11,3
428,Babe Dye,Tigers,1,2,2,0
428,Babe Dye,Saint Patricks,23,38,33,5
428,Babe Dye,Saint Patricks,24,38,31,7
428,Babe Dye,Saint Patricks,22,37,26,11
428,Babe Dye,Saint Patricks,19,19,16,3
428,Babe Dye,Saint Patricks,29,46,38,8
428,Babe Dye,Saint Patricks,31,23,18,5
428,Babe Dye,Blackhawks,41,30,25,5
428,Babe Dye,Blackhawks,10,0,0,0
428,Babe Dye,Americans,42,1,1,0
428,Babe Dye,Maple Leafs,6,0,0,0
429,Brendan Morrison,Devils,11,9,5,4
429,Brendan Morrison,Devils,76,46,13,33
429,Brendan Morrison,Devils,44,26,5,21
429,Brendan Morrison,Canucks,12,9,2,7
429,Brendan Morrison,Canucks,82,54,16,38
429,Brendan Morrison,Canucks,82,67,23,44
429,Brendan Morrison,Canucks,82,71,25,46
429,Brendan Morrison,Canucks,82,60,22,38
429,Brendan Morrison,Canucks,82,56,19,37
429,Brendan Morrison,Canucks,82,51,20,31
429,Brendan Morrison,Canucks,39,25,9,16
429,Brendan Morrison,Ducks,62,22,10,12
429,Brendan Morrison,Stars,19,9,6,3
429,Brendan Morrison,Capitals,74,42,12,30
429,Brendan Morrison,Flames,66,43,9,34
429,Brendan Morrison,Flames,28,11,4,7
429,Brendan Morrison,Blackhawks,11,0,0,0
430,Valeri Kamensky,Nordiques,23,21,7,14
430,Valeri Kamensky,Nordiques,32,37,15,22
430,Valeri Kamensky,Nordiques,76,65,28,37
430,Valeri Kamensky,Nordiques,40,30,10,20
430,Valeri Kamensky,Avalanche,81,85,38,47
430,Valeri Kamensky,Avalanche,68,66,28,38
430,Valeri Kamensky,Avalanche,75,66,26,40
430,Valeri Kamensky,Avalanche,65,44,14,30
430,Valeri Kamensky,Rangers,58,32,13,19
430,Valeri Kamensky,Rangers,65,34,14,20
430,Valeri Kamensky,Stars,24,9,3,6
430,Valeri Kamensky,Devils,30,12,4,8
431,Joe Pavelski,Sharks,46,28,14,14
431,Joe Pavelski,Sharks,82,40,19,21
431,Joe Pavelski,Sharks,80,59,25,34
431,Joe Pavelski,Sharks,67,51,25,26
431,Joe Pavelski,Sharks,74,66,20,46
431,Joe Pavelski,Sharks,82,61,31,30
431,Joe Pavelski,Sharks,48,31,16,15
431,Joe Pavelski,Sharks,82,79,41,38
431,Joe Pavelski,Sharks,24,19,9,10
432,Hooley Smith,Senators (1917),30,23,10,13
432,Hooley Smith,Senators (1917),28,25,16,9
432,Hooley Smith,Senators (1917),43,15,9,6
432,Hooley Smith,Maroons,34,19,14,5
432,Hooley Smith,Maroons,41,19,10,9
432,Hooley Smith,Maroons,42,30,21,9
432,Hooley Smith,Maroons,39,26,12,14
432,Hooley Smith,Maroons,43,44,11,33
432,Hooley Smith,Maroons,48,41,20,21
432,Hooley Smith,Maroons,47,37,18,19
432,Hooley Smith,Maroons,46,27,5,22
432,Hooley Smith,Maroons,47,38,19,19
432,Hooley Smith,Bruins,44,18,8,10
432,Hooley Smith,Americans,47,20,10,10
432,Hooley Smith,Americans,48,19,8,11
432,Hooley Smith,Americans,47,15,7,8
432,Hooley Smith,Americans,41,9,2,7
433,Dustin Brown,Kings,31,5,1,4
433,Dustin Brown,Kings,79,28,14,14
433,Dustin Brown,Kings,81,46,17,29
433,Dustin Brown,Kings,78,60,33,27
433,Dustin Brown,Kings,80,53,24,29
433,Dustin Brown,Kings,82,56,24,32
433,Dustin Brown,Kings,82,57,28,29
433,Dustin Brown,Kings,82,54,22,32
433,Dustin Brown,Kings,46,29,18,11
433,Dustin Brown,Kings,79,27,15,12
433,Dustin Brown,Kings,23,7,4,3
434,Michael McPhee,Canadiens,14,7,5,2
434,Michael McPhee,Canadiens,70,39,17,22
434,Michael McPhee,Canadiens,70,40,19,21
434,Michael McPhee,Canadiens,79,39,18,21
434,Michael McPhee,Canadiens,77,43,23,20
434,Michael McPhee,Canadiens,73,41,19,22
434,Michael McPhee,Canadiens,56,41,23,18
434,Michael McPhee,Canadiens,64,43,22,21
434,Michael McPhee,Canadiens,78,31,16,15
434,Michael McPhee,North Stars,84,40,18,22
434,Michael McPhee,Stars,79,35,20,15
435,Richard Zednik,Capitals,1,0,0,0
435,Richard Zednik,Capitals,11,3,2,1
435,Richard Zednik,Capitals,65,26,17,9
435,Richard Zednik,Capitals,49,17,9,8
435,Richard Zednik,Capitals,69,35,19,16
435,Richard Zednik,Capitals,62,35,16,19
435,Richard Zednik,Canadiens,12,9,3,6
435,Richard Zednik,Canadiens,82,44,22,22
435,Richard Zednik,Canadiens,80,50,31,19
435,Richard Zednik,Canadiens,81,50,26,24
435,Richard Zednik,Canadiens,67,30,16,14
435,Richard Zednik,Capitals,32,18,6,12
435,Richard Zednik,Islanders,10,3,1,2
435,Richard Zednik,Panthers,54,26,15,11
435,Richard Zednik,Panthers,70,33,17,16
436,Henrik Sedin,Canucks,82,29,9,20
436,Henrik Sedin,Canucks,82,36,16,20
436,Henrik Sedin,Canucks,78,39,8,31
436,Henrik Sedin,Canucks,76,42,11,31
436,Henrik Sedin,Canucks,82,75,18,57
436,Henrik Sedin,Canucks,82,81,10,71
436,Henrik Sedin,Canucks,82,76,15,61
436,Henrik Sedin,Canucks,82,82,22,60
436,Henrik Sedin,Canucks,82,112,29,83
436,Henrik Sedin,Canucks,82,94,19,75
436,Henrik Sedin,Canucks,82,81,14,67
436,Henrik Sedin,Canucks,48,45,11,34
436,Henrik Sedin,Canucks,70,50,11,39
436,Henrik Sedin,Canucks,23,22,6,16
437,Gary Leeman,Maple Leafs,52,12,4,8
437,Gary Leeman,Maple Leafs,53,31,5,26
437,Gary Leeman,Maple Leafs,53,32,9,23
437,Gary Leeman,Maple Leafs,80,52,21,31
437,Gary Leeman,Maple Leafs,80,61,30,31
437,Gary Leeman,Maple Leafs,61,75,32,43
437,Gary Leeman,Maple Leafs,80,95,51,44
437,Gary Leeman,Maple Leafs,52,29,17,12
437,Gary Leeman,Maple Leafs,34,20,7,13
437,Gary Leeman,Flames,29,9,2,7
437,Gary Leeman,Flames,30,14,9,5
437,Gary Leeman,Canadiens,20,18,6,12
437,Gary Leeman,Canadiens,31,15,4,11
437,Gary Leeman,Canucks,10,2,2,0
437,Gary Leeman,Blues,2,1,0,1
438,Randy Burridge,Bruins,52,42,17,25
438,Randy Burridge,Bruins,23,5,1,4
438,Randy Burridge,Bruins,79,55,27,28
438,Randy Burridge,Bruins,80,61,31,30
438,Randy Burridge,Bruins,63,32,17,15
438,Randy Burridge,Bruins,62,28,15,13
438,Randy Burridge,Capitals,66,67,23,44
438,Randy Burridge,Capitals,4,0,0,0
438,Randy Burridge,Capitals,78,42,25,17
438,Randy Burridge,Capitals,2,0,0,0
438,Randy Burridge,Kings,38,19,4,15
438,Randy Burridge,Sabres,74,58,25,33
438,Randy Burridge,Sabres,55,31,10,21
438,Randy Burridge,Sabres,30,10,4,6
439,Morris Lukowich,Jets (1979),78,74,35,39
439,Morris Lukowich,Jets (1979),80,67,33,34
439,Morris Lukowich,Jets (1979),77,92,43,49
439,Morris Lukowich,Jets (1979),69,43,22,21
439,Morris Lukowich,Jets (1979),80,55,30,25
439,Morris Lukowich,Jets (1979),47,14,5,9
439,Morris Lukowich,Bruins,22,13,5,8
439,Morris Lukowich,Bruins,14,5,1,4
439,Morris Lukowich,Kings,55,20,11,9
439,Morris Lukowich,Kings,60,35,14,21
440,Viktor Kozlov,Sharks,16,2,2,0
440,Viktor Kozlov,Sharks,62,19,6,13
440,Viktor Kozlov,Sharks,78,41,16,25
440,Viktor Kozlov,Sharks,18,7,5,2
440,Viktor Kozlov,Panthers,46,23,12,11
440,Viktor Kozlov,Panthers,65,51,16,35
440,Viktor Kozlov,Panthers,80,70,17,53
440,Viktor Kozlov,Panthers,51,37,14,23
440,Viktor Kozlov,Panthers,50,27,9,18
440,Viktor Kozlov,Panthers,74,56,22,34
440,Viktor Kozlov,Panthers,48,27,11,16
440,Viktor Kozlov,Devils,11,6,2,4
440,Viktor Kozlov,Devils,69,25,12,13
440,Viktor Kozlov,Islanders,81,51,25,26
440,Viktor Kozlov,Capitals,81,54,16,38
440,Viktor Kozlov,Capitals,67,41,13,28
441,Mark Howe,Whalers,74,80,24,56
441,Mark Howe,Whalers,63,65,19,46
441,Mark Howe,Whalers,76,53,8,45
441,Mark Howe,Flyers,76,67,20,47
441,Mark Howe,Flyers,71,53,19,34
441,Mark Howe,Flyers,73,57,18,39
441,Mark Howe,Flyers,77,82,24,58
441,Mark Howe,Flyers,69,58,15,43
441,Mark Howe,Flyers,75,62,19,43
441,Mark Howe,Flyers,52,38,9,29
441,Mark Howe,Flyers,40,28,7,21
441,Mark Howe,Flyers,19,10,0,10
441,Mark Howe,Flyers,42,25,7,18
441,Mark Howe,Red Wings,60,34,3,31
441,Mark Howe,Red Wings,44,24,4,20
441,Mark Howe,Red Wings,18,6,1,5
442,Scott Stevens,Capitals,77,25,9,16
442,Scott Stevens,Capitals,78,45,13,32
442,Scott Stevens,Capitals,80,65,21,44
442,Scott Stevens,Capitals,73,53,15,38
442,Scott Stevens,Capitals,77,61,10,51
442,Scott Stevens,Capitals,80,72,12,60
442,Scott Stevens,Capitals,80,68,7,61
442,Scott Stevens,Capitals,56,40,11,29
442,Scott Stevens,Blues,78,49,5,44
442,Scott Stevens,Devils,68,59,17,42
442,Scott Stevens,Devils,81,57,12,45
442,Scott Stevens,Devils,83,78,18,60
442,Scott Stevens,Devils,48,22,2,20
442,Scott Stevens,Devils,82,28,5,23
442,Scott Stevens,Devils,79,24,5,19
442,Scott Stevens,Devils,80,26,4,22
442,Scott Stevens,Devils,75,27,5,22
442,Scott Stevens,Devils,78,29,8,21
442,Scott Stevens,Devils,81,31,9,22
442,Scott Stevens,Devils,82,17,1,16
442,Scott Stevens,Devils,81,20,4,16
442,Scott Stevens,Devils,38,12,3,9
443,Jozef Stumpel,Bruins,4,1,1,0
443,Jozef Stumpel,Bruins,13,4,1,3
443,Jozef Stumpel,Bruins,59,23,8,15
443,Jozef Stumpel,Bruins,44,18,5,13
443,Jozef Stumpel,Bruins,76,54,18,36
443,Jozef Stumpel,Bruins,78,76,21,55
443,Jozef Stumpel,Kings,77,79,21,58
443,Jozef Stumpel,Kings,64,34,13,21
443,Jozef Stumpel,Kings,57,58,17,41
443,Jozef Stumpel,Kings,63,55,16,39
443,Jozef Stumpel,Kings,9,4,1,3
443,Jozef Stumpel,Bruins,72,54,7,47
443,Jozef Stumpel,Bruins,78,51,14,37
443,Jozef Stumpel,Kings,64,37,8,29
443,Jozef Stumpel,Panthers,74,52,15,37
443,Jozef Stumpel,Panthers,73,57,23,34
443,Jozef Stumpel,Panthers,52,20,7,13
444,Bengt-Ake Gustafsson,Capitals,80,60,22,38
444,Bengt-Ake Gustafsson,Capitals,72,55,21,34
444,Bengt-Ake Gustafsson,Capitals,70,60,26,34
444,Bengt-Ake Gustafsson,Capitals,67,64,22,42
444,Bengt-Ake Gustafsson,Capitals,69,75,32,43
444,Bengt-Ake Gustafsson,Capitals,51,43,14,29
444,Bengt-Ake Gustafsson,Capitals,70,75,23,52
444,Bengt-Ake Gustafsson,Capitals,78,54,18,36
444,Bengt-Ake Gustafsson,Capitals,72,69,18,51
445,Bill Cowley,Eagles,41,12,5,7
445,Bill Cowley,Bruins,48,21,11,10
445,Bill Cowley,Bruins,46,35,13,22
445,Bill Cowley,Bruins,48,39,17,22
445,Bill Cowley,Bruins,34,42,8,34
445,Bill Cowley,Bruins,48,40,13,27
445,Bill Cowley,Bruins,46,62,17,45
445,Bill Cowley,Bruins,28,27,4,23
445,Bill Cowley,Bruins,48,72,27,45
445,Bill Cowley,Bruins,36,71,30,41
445,Bill Cowley,Bruins,49,65,25,40
445,Bill Cowley,Bruins,26,24,12,12
445,Bill Cowley,Bruins,51,38,13,25
446,Timothy Young,North Stars,63,51,18,33
446,Timothy Young,North Stars,80,95,29,66
446,Timothy Young,North Stars,78,58,23,35
446,Timothy Young,North Stars,73,56,24,32
446,Timothy Young,North Stars,77,74,31,43
446,Timothy Young,North Stars,74,66,25,41
446,Timothy Young,North Stars,49,41,10,31
446,Timothy Young,North Stars,70,53,18,35
446,Timothy Young,Jets (1979),44,34,15,19
446,Timothy Young,Flyers,20,8,2,6
447,Joel Otto,Flames,17,12,4,8
447,Joel Otto,Flames,79,59,25,34
447,Joel Otto,Flames,68,50,19,31
447,Joel Otto,Flames,62,52,13,39
447,Joel Otto,Flames,72,53,23,30
447,Joel Otto,Flames,75,33,13,20
447,Joel Otto,Flames,76,39,19,20
447,Joel Otto,Flames,78,34,13,21
447,Joel Otto,Flames,75,52,19,33
447,Joel Otto,Flames,81,23,11,12
447,Joel Otto,Flames,47,21,8,13
447,Joel Otto,Flyers,67,41,12,29
447,Joel Otto,Flyers,78,32,13,19
447,Joel Otto,Flyers,68,7,3,4
448,Nelson Emerson,Blues,4,3,0,3
448,Nelson Emerson,Blues,79,59,23,36
448,Nelson Emerson,Blues,82,73,22,51
448,Nelson Emerson,Jets (1979),83,74,33,41
448,Nelson Emerson,Jets (1979),48,37,14,23
448,Nelson Emerson,Whalers,81,58,29,29
448,Nelson Emerson,Whalers,66,38,9,29
448,Nelson Emerson,Hurricanes,81,45,21,24
448,Nelson Emerson,Hurricanes,35,21,8,13
448,Nelson Emerson,Blackhawks,27,14,4,10
448,Nelson Emerson,Senators,3,2,1,1
448,Nelson Emerson,Thrashers,58,33,14,19
448,Nelson Emerson,Kings,5,2,1,1
448,Nelson Emerson,Kings,78,22,11,11
448,Nelson Emerson,Kings,41,7,5,2
449,Darren Turcotte,Rangers,20,10,7,3
449,Darren Turcotte,Rangers,76,66,32,34
449,Darren Turcotte,Rangers,74,67,26,41
449,Darren Turcotte,Rangers,71,53,30,23
449,Darren Turcotte,Rangers,71,53,25,28
449,Darren Turcotte,Rangers,13,6,2,4
449,Darren Turcotte,Whalers,19,13,2,11
449,Darren Turcotte,Whalers,47,35,17,18
449,Darren Turcotte,Jets (1979),59,32,16,16
449,Darren Turcotte,Sharks,9,11,6,5
449,Darren Turcotte,Sharks,65,37,16,21
449,Darren Turcotte,Blues,62,18,12,6
449,Darren Turcotte,Predators,40,9,4,5
449,Darren Turcotte,Predators,9,1,0,1
450,Marty Barry,Americans,9,1,1,0
450,Marty Barry,Bruins,44,33,18,15
450,Marty Barry,Bruins,44,31,20,11
450,Marty Barry,Bruins,48,38,21,17
450,Marty Barry,Bruins,47,37,24,13
450,Marty Barry,Bruins,48,39,27,12
450,Marty Barry,Bruins,48,40,20,20
450,Marty Barry,Red Wings,48,40,21,19
450,Marty Barry,Red Wings,47,44,17,27
450,Marty Barry,Red Wings,48,29,9,20
450,Marty Barry,Red Wings,48,41,13,28
450,Marty Barry,Canadiens,30,14,4,10
451,Radek Bonk,Senators,42,11,3,8
451,Radek Bonk,Senators,76,35,16,19
451,Radek Bonk,Senators,53,18,5,13
451,Radek Bonk,Senators,65,16,7,9
451,Radek Bonk,Senators,81,32,16,16
451,Radek Bonk,Senators,80,60,23,37
451,Radek Bonk,Senators,74,59,23,36
451,Radek Bonk,Senators,82,70,25,45
451,Radek Bonk,Senators,70,54,22,32
451,Radek Bonk,Senators,66,44,12,32
451,Radek Bonk,Canadiens,61,21,6,15
451,Radek Bonk,Canadiens,74,23,13,10
451,Radek Bonk,Predators,79,29,14,15
451,Radek Bonk,Predators,66,25,9,16
452,Dale McCourt,Red Wings,76,72,33,39
452,Dale McCourt,Red Wings,79,71,28,43
452,Dale McCourt,Red Wings,80,81,30,51
452,Dale McCourt,Red Wings,80,86,30,56
452,Dale McCourt,Red Wings,26,27,13,14
452,Dale McCourt,Sabres,52,42,20,22
452,Dale McCourt,Sabres,62,52,20,32
452,Dale McCourt,Sabres,5,4,1,3
452,Dale McCourt,Maple Leafs,72,43,19,24
453,Pierre Mondou,Canadiens,71,49,19,30
453,Pierre Mondou,Canadiens,77,72,31,41
453,Pierre Mondou,Canadiens,75,66,30,36
453,Pierre Mondou,Canadiens,57,41,17,24
453,Pierre Mondou,Canadiens,73,68,35,33
453,Pierre Mondou,Canadiens,76,66,29,37
453,Pierre Mondou,Canadiens,52,37,15,22
453,Pierre Mondou,Canadiens,67,57,18,39
454,Marc Tardif,Canadiens,18,5,3,2
454,Marc Tardif,Canadiens,76,49,19,30
454,Marc Tardif,Canadiens,75,53,31,22
454,Marc Tardif,Canadiens,76,50,25,25
454,Marc Tardif,Nordiques,58,68,33,35
454,Marc Tardif,Nordiques,63,54,23,31
454,Marc Tardif,Nordiques,75,70,39,31
454,Marc Tardif,Nordiques,76,52,21,31
455,Nik Antropov,Maple Leafs,66,30,12,18
455,Nik Antropov,Maple Leafs,52,17,6,11
455,Nik Antropov,Maple Leafs,11,2,1,1
455,Nik Antropov,Maple Leafs,72,45,16,29
455,Nik Antropov,Maple Leafs,62,31,13,18
455,Nik Antropov,Maple Leafs,57,31,12,19
455,Nik Antropov,Maple Leafs,54,33,18,15
455,Nik Antropov,Maple Leafs,72,56,26,30
455,Nik Antropov,Maple Leafs,63,46,21,25
455,Nik Antropov,Rangers,18,13,7,6
455,Nik Antropov,Thrashers,76,67,24,43
455,Nik Antropov,Thrashers,76,41,16,25
455,Nik Antropov,Jets,69,35,15,20
455,Nik Antropov,Jets,40,18,6,12
456,Travis Green,Islanders,61,25,7,18
456,Travis Green,Islanders,83,40,18,22
456,Travis Green,Islanders,42,12,5,7
456,Travis Green,Islanders,69,70,25,45
456,Travis Green,Islanders,79,64,23,41
456,Travis Green,Islanders,54,26,14,12
456,Travis Green,Ducks,22,16,5,11
456,Travis Green,Ducks,79,30,13,17
456,Travis Green,Coyotes,78,46,25,21
456,Travis Green,Coyotes,69,28,13,15
456,Travis Green,Maple Leafs,82,34,11,23
456,Travis Green,Maple Leafs,75,24,12,12
456,Travis Green,Bruins,64,16,11,5
456,Travis Green,Bruins,82,22,10,12
456,Travis Green,Ducks,7,2,1,1
456,Travis Green,Maple Leafs,24,0,0,0
457,Brad Boyes,Sharks,1,0,0,0
457,Brad Boyes,Bruins,82,69,26,43
457,Brad Boyes,Bruins,62,34,13,21
457,Brad Boyes,Blues,19,12,4,8
457,Brad Boyes,Blues,82,65,43,22
457,Brad Boyes,Blues,82,72,33,39
457,Brad Boyes,Blues,82,42,14,28
457,Brad Boyes,Blues,62,41,12,29
457,Brad Boyes,Sabres,21,14,5,9
457,Brad Boyes,Sabres,65,23,8,15
457,Brad Boyes,Islanders,48,35,10,25
457,Brad Boyes,Panthers,78,36,21,15
457,Brad Boyes,Panthers,21,10,4,6
458,Curt Fraser,Canucks,78,35,16,19
458,Curt Fraser,Canucks,78,42,17,25
458,Curt Fraser,Canucks,77,49,25,24
458,Curt Fraser,Canucks,79,67,28,39
458,Curt Fraser,Canucks,36,13,6,7
458,Curt Fraser,Blackhawks,38,19,6,13
458,Curt Fraser,Blackhawks,29,17,5,12
458,Curt Fraser,Blackhawks,73,50,25,25
458,Curt Fraser,Blackhawks,61,68,29,39
458,Curt Fraser,Blackhawks,75,50,25,25
458,Curt Fraser,Blackhawks,27,10,4,6
458,Curt Fraser,North Stars,10,2,1,1
458,Curt Fraser,North Stars,35,10,5,5
458,Curt Fraser,North Stars,8,1,1,0
459,Hakan Loob,Flames,77,55,30,25
459,Hakan Loob,Flames,78,72,37,35
459,Hakan Loob,Flames,68,67,31,36
459,Hakan Loob,Flames,68,44,18,26
459,Hakan Loob,Flames,80,106,50,56
459,Hakan Loob,Flames,79,85,27,58
460,Daniel Maloney,Blackhawks,74,26,12,14
460,Daniel Maloney,Blackhawks,57,30,13,17
460,Daniel Maloney,Kings,14,11,4,7
460,Daniel Maloney,Kings,65,32,15,17
460,Daniel Maloney,Kings,80,66,27,39
460,Daniel Maloney,Red Wings,77,66,27,39
460,Daniel Maloney,Red Wings,34,26,13,13
460,Daniel Maloney,Red Wings,66,45,16,29
460,Daniel Maloney,Maple Leafs,13,7,3,4
460,Daniel Maloney,Maple Leafs,77,53,17,36
460,Daniel Maloney,Maple Leafs,71,33,17,16
460,Daniel Maloney,Maple Leafs,65,41,20,21
460,Daniel Maloney,Maple Leafs,44,15,8,7
461,Wayne Babych,Blues,67,63,27,36
461,Wayne Babych,Blues,59,61,26,35
461,Wayne Babych,Blues,78,96,54,42
461,Wayne Babych,Blues,51,44,19,25
461,Wayne Babych,Blues,71,39,16,23
461,Wayne Babych,Blues,70,42,13,29
461,Wayne Babych,Penguins,65,54,20,34
461,Wayne Babych,Penguins,2,0,0,0
461,Wayne Babych,Nordiques,15,11,6,5
461,Wayne Babych,Whalers,37,28,11,17
461,Wayne Babych,Whalers,4,0,0,0
462,Dave Balon,Rangers,3,0,0,0
462,Dave Balon,Rangers,13,3,1,2
462,Dave Balon,Rangers,30,15,4,11
462,Dave Balon,Rangers,70,24,11,13
462,Dave Balon,Canadiens,70,42,24,18
462,Dave Balon,Canadiens,63,41,18,23
462,Dave Balon,Canadiens,45,10,3,7
462,Dave Balon,Canadiens,48,19,11,8
462,Dave Balon,North Stars,73,47,15,32
462,Dave Balon,Rangers,75,31,10,21
462,Dave Balon,Rangers,76,70,33,37
462,Dave Balon,Rangers,78,60,36,24
462,Dave Balon,Rangers,16,9,4,5
462,Dave Balon,Canucks,59,38,19,19
462,Dave Balon,Canucks,57,5,3,2
463,Pat Hickey,Rangers,70,36,14,22
463,Pat Hickey,Rangers,80,40,23,17
463,Pat Hickey,Rangers,80,73,40,33
463,Pat Hickey,Rangers,80,75,34,41
463,Pat Hickey,Rangers,7,4,2,2
463,Pat Hickey,Rockies,24,16,7,9
463,Pat Hickey,Maple Leafs,45,38,22,16
463,Pat Hickey,Maple Leafs,72,49,16,33
463,Pat Hickey,Maple Leafs,1,0,0,0
463,Pat Hickey,Rangers,53,29,15,14
463,Pat Hickey,Nordiques,7,1,0,1
463,Pat Hickey,Blues,1,0,0,0
463,Pat Hickey,Blues,69,20,9,11
463,Pat Hickey,Blues,57,23,10,13
464,Brian Savage,Canadiens,3,1,1,0
464,Brian Savage,Canadiens,37,19,12,7
464,Brian Savage,Canadiens,75,33,25,8
464,Brian Savage,Canadiens,81,60,23,37
464,Brian Savage,Canadiens,64,43,26,17
464,Brian Savage,Canadiens,54,26,16,10
464,Brian Savage,Canadiens,38,29,17,12
464,Brian Savage,Canadiens,62,45,21,24
464,Brian Savage,Canadiens,47,29,14,15
464,Brian Savage,Coyotes,30,12,6,6
464,Brian Savage,Coyotes,43,16,6,10
464,Brian Savage,Coyotes,61,25,12,13
464,Brian Savage,Blues,13,7,4,3
464,Brian Savage,Flyers,66,14,9,5
465,William Malone,Penguins,66,37,18,19
465,William Malone,Penguins,78,61,18,43
465,William Malone,Penguins,80,65,35,30
465,William Malone,Penguins,51,51,19,32
465,William Malone,Penguins,62,50,21,29
465,William Malone,Penguins,78,39,15,24
465,William Malone,Penguins,80,61,17,44
465,William Malone,Whalers,78,54,17,37
465,William Malone,Whalers,76,61,22,39
465,William Malone,Whalers,22,13,6,7
465,William Malone,Nordiques,27,8,3,5
465,William Malone,Nordiques,6,1,0,1
466,Wayne Merrick,Blues,50,21,10,11
466,Wayne Merrick,Blues,64,43,20,23
466,Wayne Merrick,Blues,76,65,28,37
466,Wayne Merrick,Blues,19,15,7,8
466,Wayne Merrick,Seals,56,52,25,27
466,Wayne Merrick,Barons,80,56,18,38
466,Wayne Merrick,Barons,18,7,2,5
466,Wayne Merrick,Islanders,37,24,10,14
466,Wayne Merrick,Islanders,75,41,20,21
466,Wayne Merrick,Islanders,70,35,13,22
466,Wayne Merrick,Islanders,71,31,16,15
466,Wayne Merrick,Islanders,68,39,12,27
466,Wayne Merrick,Islanders,59,16,4,12
466,Wayne Merrick,Islanders,31,11,6,5
467,Mikael Renberg,Flyers,83,82,38,44
467,Mikael Renberg,Flyers,47,57,26,31
467,Mikael Renberg,Flyers,51,43,23,20
467,Mikael Renberg,Flyers,77,59,22,37
467,Mikael Renberg,Lightning,68,38,16,22
467,Mikael Renberg,Lightning,20,12,4,8
467,Mikael Renberg,Flyers,46,26,11,15
467,Mikael Renberg,Flyers,62,29,8,21
467,Mikael Renberg,Coyotes,10,6,2,4
467,Mikael Renberg,Maple Leafs,71,52,14,38
467,Mikael Renberg,Maple Leafs,67,35,14,21
467,Mikael Renberg,Maple Leafs,59,25,12,13
468,Kristian Huselius,Panthers,79,45,23,22
468,Kristian Huselius,Panthers,78,43,20,23
468,Kristian Huselius,Panthers,76,31,10,21
468,Kristian Huselius,Panthers,24,8,5,3
468,Kristian Huselius,Flames,54,39,15,24
468,Kristian Huselius,Flames,81,77,34,43
468,Kristian Huselius,Flames,81,66,25,41
468,Kristian Huselius,Blue Jackets,74,56,21,35
468,Kristian Huselius,Blue Jackets,74,63,23,40
468,Kristian Huselius,Blue Jackets,39,23,14,9
468,Kristian Huselius,Blue Jackets,2,0,0,0
469,Robert Brown,Penguins,51,44,24,20
469,Robert Brown,Penguins,68,115,49,66
469,Robert Brown,Penguins,80,80,33,47
469,Robert Brown,Penguins,25,16,6,10
469,Robert Brown,Whalers,44,42,18,24
469,Robert Brown,Whalers,42,31,16,15
469,Robert Brown,Blackhawks,25,16,5,11
469,Robert Brown,Blackhawks,15,7,1,6
469,Robert Brown,Stars,1,0,0,0
469,Robert Brown,Kings,2,0,0,0
469,Robert Brown,Penguins,82,40,15,25
469,Robert Brown,Penguins,58,24,13,11
469,Robert Brown,Penguins,50,23,10,13
470,Ryan Getzlaf,Ducks,57,39,14,25
470,Ryan Getzlaf,Ducks,82,58,25,33
470,Ryan Getzlaf,Ducks,77,82,24,58
470,Ryan Getzlaf,Ducks,81,91,25,66
470,Ryan Getzlaf,Ducks,66,69,19,50
470,Ryan Getzlaf,Ducks,67,76,19,57
470,Ryan Getzlaf,Ducks,82,57,11,46
470,Ryan Getzlaf,Ducks,44,49,15,34
470,Ryan Getzlaf,Ducks,77,87,31,56
470,Ryan Getzlaf,Ducks,23,19,6,13
471,Sid Abel,Red Wings,15,2,1,1
471,Sid Abel,Red Wings,24,6,1,5
471,Sid Abel,Red Wings,47,33,11,22
471,Sid Abel,Red Wings,48,49,18,31
471,Sid Abel,Red Wings,49,42,18,24
471,Sid Abel,Red Wings,7,2,0,2
471,Sid Abel,Red Wings,60,48,19,29
471,Sid Abel,Red Wings,60,44,14,30
471,Sid Abel,Red Wings,60,54,28,26
471,Sid Abel,Red Wings,69,69,34,35
471,Sid Abel,Red Wings,69,61,23,38
471,Sid Abel,Red Wings,62,53,17,36
471,Sid Abel,Blackhawks,39,9,5,4
471,Sid Abel,Blackhawks,3,0,0,0
472,Sami Kapanen,Whalers,35,9,5,4
472,Sami Kapanen,Whalers,45,25,13,12
472,Sami Kapanen,Hurricanes,81,63,26,37
472,Sami Kapanen,Hurricanes,81,59,24,35
472,Sami Kapanen,Hurricanes,76,48,24,24
472,Sami Kapanen,Hurricanes,82,57,20,37
472,Sami Kapanen,Hurricanes,77,69,27,42
472,Sami Kapanen,Hurricanes,43,18,6,12
472,Sami Kapanen,Flyers,28,13,4,9
472,Sami Kapanen,Flyers,74,30,12,18
472,Sami Kapanen,Flyers,58,34,12,22
472,Sami Kapanen,Flyers,77,25,11,14
472,Sami Kapanen,Flyers,74,8,5,3
473,William Derlago,Canucks,9,8,4,4
473,William Derlago,Canucks,54,26,11,15
473,William Derlago,Maple Leafs,23,17,5,12
473,William Derlago,Maple Leafs,80,74,35,39
473,William Derlago,Maple Leafs,75,84,34,50
473,William Derlago,Maple Leafs,58,37,13,24
473,William Derlago,Maple Leafs,79,60,40,20
473,William Derlago,Maple Leafs,62,62,31,31
473,William Derlago,Maple Leafs,1,0,0,0
473,William Derlago,Bruins,39,21,5,16
473,William Derlago,Jets (1979),27,10,5,5
473,William Derlago,Jets (1979),30,9,3,6
473,William Derlago,Nordiques,18,8,3,5
474,Randy Cunneyworth,Sabres,1,0,0,0
474,Randy Cunneyworth,Sabres,20,6,2,4
474,Randy Cunneyworth,Penguins,75,45,15,30
474,Randy Cunneyworth,Penguins,79,53,26,27
474,Randy Cunneyworth,Penguins,71,74,35,39
474,Randy Cunneyworth,Penguins,70,44,25,19
474,Randy Cunneyworth,Jets (1979),28,11,5,6
474,Randy Cunneyworth,Whalers,43,18,9,9
474,Randy Cunneyworth,Whalers,32,14,9,5
474,Randy Cunneyworth,Whalers,39,17,7,10
474,Randy Cunneyworth,Whalers,39,9,5,4
474,Randy Cunneyworth,Whalers,63,17,9,8
474,Randy Cunneyworth,Blackhawks,16,7,4,3
474,Randy Cunneyworth,Senators,48,10,5,5
474,Randy Cunneyworth,Senators,81,36,17,19
474,Randy Cunneyworth,Senators,76,36,12,24
474,Randy Cunneyworth,Senators,71,13,2,11
474,Randy Cunneyworth,Sabres,14,4,2,2
475,Milan Michalek,Sharks,2,1,1,0
475,Milan Michalek,Sharks,81,35,17,18
475,Milan Michalek,Sharks,78,66,26,40
475,Milan Michalek,Sharks,79,55,24,31
475,Milan Michalek,Sharks,77,57,23,34
475,Milan Michalek,Senators,66,34,22,12
475,Milan Michalek,Senators,66,33,18,15
475,Milan Michalek,Senators,77,60,35,25
475,Milan Michalek,Senators,23,14,4,10
475,Milan Michalek,Senators,82,39,17,22
475,Milan Michalek,Senators,21,7,2,5
476,Alan Haworth,Sabres,49,36,16,20
476,Alan Haworth,Sabres,57,39,21,18
476,Alan Haworth,Capitals,74,50,23,27
476,Alan Haworth,Capitals,75,55,24,31
476,Alan Haworth,Capitals,76,49,23,26
476,Alan Haworth,Capitals,71,73,34,39
476,Alan Haworth,Capitals,50,41,25,16
476,Alan Haworth,Nordiques,72,57,23,34
477,Andy Hebenton,Rangers,70,38,24,14
477,Andy Hebenton,Rangers,70,44,21,23
477,Andy Hebenton,Rangers,70,45,21,24
477,Andy Hebenton,Rangers,70,62,33,29
477,Andy Hebenton,Rangers,70,46,19,27
477,Andy Hebenton,Rangers,70,54,26,28
477,Andy Hebenton,Rangers,70,42,18,24
477,Andy Hebenton,Rangers,70,37,15,22
477,Andy Hebenton,Bruins,70,23,12,11
478,Craig Janney,Bruins,15,16,7,9
478,Craig Janney,Bruins,62,62,16,46
478,Craig Janney,Bruins,55,62,24,38
478,Craig Janney,Bruins,77,92,26,66
478,Craig Janney,Bruins,53,51,12,39
478,Craig Janney,Blues,25,36,6,30
478,Craig Janney,Blues,84,106,24,82
478,Craig Janney,Blues,69,84,16,68
478,Craig Janney,Blues,8,7,2,5
478,Craig Janney,Sharks,27,20,5,15
478,Craig Janney,Sharks,71,62,13,49
478,Craig Janney,Jets (1979),13,20,7,13
478,Craig Janney,Coyotes,77,53,15,38
478,Craig Janney,Coyotes,68,53,10,43
478,Craig Janney,Lightning,38,22,4,18
478,Craig Janney,Islanders,18,5,1,4
479,Patrick Kane,Blackhawks,82,72,21,51
479,Patrick Kane,Blackhawks,80,70,25,45
479,Patrick Kane,Blackhawks,82,88,30,58
479,Patrick Kane,Blackhawks,73,73,27,46
479,Patrick Kane,Blackhawks,82,66,23,43
479,Patrick Kane,Blackhawks,47,55,23,32
479,Patrick Kane,Blackhawks,69,69,29,40
479,Patrick Kane,Blackhawks,23,23,10,13
480,Patrice Bergeron,Bruins,71,39,16,23
480,Patrice Bergeron,Bruins,81,73,31,42
480,Patrice Bergeron,Bruins,77,70,22,48
480,Patrice Bergeron,Bruins,10,7,3,4
480,Patrice Bergeron,Bruins,64,39,8,31
480,Patrice Bergeron,Bruins,73,52,19,33
480,Patrice Bergeron,Bruins,80,57,22,35
480,Patrice Bergeron,Bruins,81,64,22,42
480,Patrice Bergeron,Bruins,42,32,10,22
480,Patrice Bergeron,Bruins,80,62,30,32
480,Patrice Bergeron,Bruins,24,16,5,11
481,Ryan Kesler,Canucks,28,5,2,3
481,Ryan Kesler,Canucks,82,23,10,13
481,Ryan Kesler,Canucks,48,16,6,10
481,Ryan Kesler,Canucks,80,37,21,16
481,Ryan Kesler,Canucks,82,59,26,33
481,Ryan Kesler,Canucks,82,75,25,50
481,Ryan Kesler,Canucks,82,73,41,32
481,Ryan Kesler,Canucks,77,49,22,27
481,Ryan Kesler,Canucks,17,13,4,9
481,Ryan Kesler,Canucks,77,43,25,18
481,Ryan Kesler,Ducks,24,18,6,12
482,Pascal Dupuis,Wild,4,1,1,0
482,Pascal Dupuis,Wild,76,27,15,12
482,Pascal Dupuis,Wild,80,48,20,28
482,Pascal Dupuis,Wild,59,26,11,15
482,Pascal Dupuis,Wild,67,26,10,16
482,Pascal Dupuis,Wild,48,13,10,3
482,Pascal Dupuis,Rangers,6,1,1,0
482,Pascal Dupuis,Thrashers,17,5,3,2
482,Pascal Dupuis,Thrashers,62,15,10,5
482,Pascal Dupuis,Penguins,16,12,2,10
482,Pascal Dupuis,Penguins,71,28,12,16
482,Pascal Dupuis,Penguins,81,38,18,20
482,Pascal Dupuis,Penguins,81,37,17,20
482,Pascal Dupuis,Penguins,82,59,25,34
482,Pascal Dupuis,Penguins,48,38,20,18
482,Pascal Dupuis,Penguins,39,20,7,13
482,Pascal Dupuis,Penguins,16,11,6,5
483,Perry Turnbull,Blues,80,35,16,19
483,Perry Turnbull,Blues,75,56,34,22
483,Perry Turnbull,Blues,79,59,33,26
483,Perry Turnbull,Blues,79,47,32,15
483,Perry Turnbull,Blues,32,22,14,8
483,Perry Turnbull,Canadiens,40,13,6,7
483,Perry Turnbull,Jets (1979),66,43,22,21
483,Perry Turnbull,Jets (1979),80,51,20,31
483,Perry Turnbull,Jets (1979),26,6,1,5
483,Perry Turnbull,Blues,51,19,10,9
484,John Cullen,Penguins,79,49,12,37
484,John Cullen,Penguins,72,92,32,60
484,John Cullen,Penguins,65,94,31,63
484,John Cullen,Whalers,13,16,8,8
484,John Cullen,Whalers,77,77,26,51
484,John Cullen,Whalers,19,9,5,4
484,John Cullen,Maple Leafs,47,41,13,28
484,John Cullen,Maple Leafs,53,30,13,17
484,John Cullen,Penguins,46,37,13,24
484,John Cullen,Lightning,76,50,16,34
484,John Cullen,Lightning,70,55,18,37
484,John Cullen,Lightning,4,0,0,0
485,Antoine Vermette,Senators,57,14,7,7
485,Antoine Vermette,Senators,82,33,21,12
485,Antoine Vermette,Senators,77,39,19,20
485,Antoine Vermette,Senators,81,53,24,29
485,Antoine Vermette,Senators,62,28,9,19
485,Antoine Vermette,Blue Jackets,17,13,7,6
485,Antoine Vermette,Blue Jackets,82,65,27,38
485,Antoine Vermette,Blue Jackets,82,47,19,28
485,Antoine Vermette,Blue Jackets,60,27,8,19
485,Antoine Vermette,Coyotes,22,10,3,7
485,Antoine Vermette,Coyotes,48,21,13,8
485,Antoine Vermette,Coyotes,82,45,24,21
485,Antoine Vermette,Coyotes,23,16,6,10
486,Adam Creighton,Sabres,7,4,2,2
486,Adam Creighton,Sabres,30,10,2,8
486,Adam Creighton,Sabres,19,2,1,1
486,Adam Creighton,Sabres,56,40,18,22
486,Adam Creighton,Sabres,36,27,10,17
486,Adam Creighton,Sabres,24,17,7,10
486,Adam Creighton,Blackhawks,43,29,15,14
486,Adam Creighton,Blackhawks,80,70,34,36
486,Adam Creighton,Blackhawks,72,51,22,29
486,Adam Creighton,Blackhawks,11,12,6,6
486,Adam Creighton,Islanders,66,24,15,9
486,Adam Creighton,Lightning,83,39,19,20
486,Adam Creighton,Lightning,53,20,10,10
486,Adam Creighton,Blues,48,34,14,20
486,Adam Creighton,Blues,61,21,11,10
486,Adam Creighton,Blackhawks,19,3,1,2
487,Gregory Paslawski,Canadiens,26,5,1,4
487,Gregory Paslawski,Blues,34,14,8,6
487,Gregory Paslawski,Blues,72,42,22,20
487,Gregory Paslawski,Blues,56,33,22,11
487,Gregory Paslawski,Blues,76,64,29,35
487,Gregory Paslawski,Blues,17,3,2,1
487,Gregory Paslawski,Blues,75,52,26,26
487,Gregory Paslawski,Jets (1979),71,48,18,30
487,Gregory Paslawski,Jets (1979),43,19,9,10
487,Gregory Paslawski,Sabres,12,3,2,1
487,Gregory Paslawski,Nordiques,80,45,28,17
487,Gregory Paslawski,Flyers,60,33,14,19
487,Gregory Paslawski,Flames,13,9,4,5
487,Gregory Paslawski,Flames,15,2,2,0
488,Bryan Hextall Sr.,Rangers,3,1,0,1
488,Bryan Hextall Sr.,Rangers,48,21,17,4
488,Bryan Hextall Sr.,Rangers,48,35,20,15
488,Bryan Hextall Sr.,Rangers,48,39,24,15
488,Bryan Hextall Sr.,Rangers,48,44,26,18
488,Bryan Hextall Sr.,Rangers,48,56,24,32
488,Bryan Hextall Sr.,Rangers,50,59,27,32
488,Bryan Hextall Sr.,Rangers,50,54,21,33
488,Bryan Hextall Sr.,Rangers,3,1,0,1
488,Bryan Hextall Sr.,Rangers,60,30,20,10
488,Bryan Hextall Sr.,Rangers,43,22,8,14
489,Aaron Broten,Rockies,2,0,0,0
489,Aaron Broten,Rockies,58,39,15,24
489,Aaron Broten,Devils,73,55,16,39
489,Aaron Broten,Devils,80,36,13,23
489,Aaron Broten,Devils,80,57,22,35
489,Aaron Broten,Devils,66,43,18,25
489,Aaron Broten,Devils,80,79,26,53
489,Aaron Broten,Devils,80,83,26,57
489,Aaron Broten,Devils,80,59,16,43
489,Aaron Broten,Devils,42,18,10,8
489,Aaron Broten,North Stars,35,18,9,9
489,Aaron Broten,Nordiques,20,9,5,4
489,Aaron Broten,Maple Leafs,27,10,6,4
489,Aaron Broten,Jets (1979),25,9,4,5
490,Todd Marchant,Rangers,1,0,0,0
490,Todd Marchant,Oilers,3,1,0,1
490,Todd Marchant,Oilers,45,27,13,14
490,Todd Marchant,Oilers,81,38,19,19
490,Todd Marchant,Oilers,79,33,14,19
490,Todd Marchant,Oilers,76,35,14,21
490,Todd Marchant,Oilers,82,36,14,22
490,Todd Marchant,Oilers,82,40,17,23
490,Todd Marchant,Oilers,71,39,13,26
490,Todd Marchant,Oilers,82,34,12,22
490,Todd Marchant,Oilers,77,60,20,40
490,Todd Marchant,Blue Jackets,77,34,9,25
490,Todd Marchant,Blue Jackets,18,9,3,6
490,Todd Marchant,Ducks,61,25,6,19
490,Todd Marchant,Ducks,56,23,8,15
490,Todd Marchant,Ducks,75,16,9,7
490,Todd Marchant,Ducks,72,18,5,13
490,Todd Marchant,Ducks,78,22,9,13
490,Todd Marchant,Ducks,79,8,1,7
491,James Fox,Kings,71,43,18,25
491,James Fox,Kings,77,68,30,38
491,James Fox,Kings,77,68,28,40
491,James Fox,Kings,80,72,30,42
491,James Fox,Kings,79,83,30,53
491,James Fox,Kings,39,31,14,17
491,James Fox,Kings,76,61,19,42
491,James Fox,Kings,68,51,16,35
491,James Fox,Kings,11,2,1,1
492,Rob Niedermayer,Panthers,65,26,9,17
492,Rob Niedermayer,Panthers,48,10,4,6
492,Rob Niedermayer,Panthers,82,61,26,35
492,Rob Niedermayer,Panthers,60,38,14,24
492,Rob Niedermayer,Panthers,33,15,8,7
492,Rob Niedermayer,Panthers,82,51,18,33
492,Rob Niedermayer,Panthers,81,33,10,23
492,Rob Niedermayer,Panthers,67,32,12,20
492,Rob Niedermayer,Flames,57,20,6,14
492,Rob Niedermayer,Flames,54,18,8,10
492,Rob Niedermayer,Ducks,12,4,2,2
492,Rob Niedermayer,Ducks,55,28,12,16
492,Rob Niedermayer,Ducks,76,39,15,24
492,Rob Niedermayer,Ducks,82,16,5,11
492,Rob Niedermayer,Ducks,78,16,8,8
492,Rob Niedermayer,Ducks,79,21,14,7
492,Rob Niedermayer,Devils,71,22,10,12
492,Rob Niedermayer,Sabres,71,19,5,14
493,Jochen Hecht,Blues,3,0,0,0
493,Jochen Hecht,Blues,63,34,13,21
493,Jochen Hecht,Blues,72,44,19,25
493,Jochen Hecht,Oilers,82,40,16,24
493,Jochen Hecht,Sabres,49,26,10,16
493,Jochen Hecht,Sabres,64,52,15,37
493,Jochen Hecht,Sabres,64,42,18,24
493,Jochen Hecht,Sabres,76,56,19,37
493,Jochen Hecht,Sabres,75,49,22,27
493,Jochen Hecht,Sabres,70,27,12,15
493,Jochen Hecht,Sabres,79,42,21,21
493,Jochen Hecht,Sabres,67,29,12,17
493,Jochen Hecht,Sabres,22,8,4,4
493,Jochen Hecht,Sabres,47,14,5,9
494,Dean McAmmond,Blackhawks,5,2,0,2
494,Dean McAmmond,Oilers,45,27,6,21
494,Dean McAmmond,Oilers,6,0,0,0
494,Dean McAmmond,Oilers,53,30,15,15
494,Dean McAmmond,Oilers,57,29,12,17
494,Dean McAmmond,Oilers,77,50,19,31
494,Dean McAmmond,Oilers,65,25,9,16
494,Dean McAmmond,Blackhawks,12,5,1,4
494,Dean McAmmond,Blackhawks,76,32,14,18
494,Dean McAmmond,Blackhawks,61,26,10,16
494,Dean McAmmond,Flyers,10,2,1,1
494,Dean McAmmond,Flames,73,51,21,30
494,Dean McAmmond,Avalanche,41,18,10,8
494,Dean McAmmond,Flames,64,30,17,13
494,Dean McAmmond,Blues,78,37,15,22
494,Dean McAmmond,Senators,81,29,14,15
494,Dean McAmmond,Senators,68,22,9,13
494,Dean McAmmond,Senators,44,7,3,4
494,Dean McAmmond,Islanders,18,9,2,7
494,Dean McAmmond,Devils,62,17,8,9
495,Joffrey Lupul,Ducks,75,34,13,21
495,Joffrey Lupul,Ducks,81,53,28,25
495,Joffrey Lupul,Oilers,81,28,16,12
495,Joffrey Lupul,Flyers,56,46,20,26
495,Joffrey Lupul,Flyers,79,50,25,25
495,Joffrey Lupul,Ducks,23,14,10,4
495,Joffrey Lupul,Ducks,26,13,5,8
495,Joffrey Lupul,Maple Leafs,28,18,9,9
495,Joffrey Lupul,Maple Leafs,66,67,25,42
495,Joffrey Lupul,Maple Leafs,16,18,11,7
495,Joffrey Lupul,Maple Leafs,69,44,22,22
495,Joffrey Lupul,Maple Leafs,10,3,2,1
496,Sid Smith,Maple Leafs,14,3,2,1
496,Sid Smith,Maple Leafs,31,17,7,10
496,Sid Smith,Maple Leafs,1,0,0,0
496,Sid Smith,Maple Leafs,68,45,22,23
496,Sid Smith,Maple Leafs,70,51,30,21
496,Sid Smith,Maple Leafs,70,57,27,30
496,Sid Smith,Maple Leafs,70,39,20,19
496,Sid Smith,Maple Leafs,70,38,22,16
496,Sid Smith,Maple Leafs,70,54,33,21
496,Sid Smith,Maple Leafs,55,21,4,17
496,Sid Smith,Maple Leafs,70,41,17,24
496,Sid Smith,Maple Leafs,12,3,2,1
497,Johan Franzen,Red Wings,80,16,12,4
497,Johan Franzen,Red Wings,69,30,10,20
497,Johan Franzen,Red Wings,72,38,27,11
497,Johan Franzen,Red Wings,71,59,34,25
497,Johan Franzen,Red Wings,27,21,10,11
497,Johan Franzen,Red Wings,76,55,28,27
497,Johan Franzen,Red Wings,77,56,29,27
497,Johan Franzen,Red Wings,41,31,14,17
497,Johan Franzen,Red Wings,54,41,16,25
497,Johan Franzen,Red Wings,17,14,6,8
498,Chris Chelios,Canadiens,12,2,0,2
498,Chris Chelios,Canadiens,74,64,9,55
498,Chris Chelios,Canadiens,41,34,8,26
498,Chris Chelios,Canadiens,71,44,11,33
498,Chris Chelios,Canadiens,71,61,20,41
498,Chris Chelios,Canadiens,80,73,15,58
498,Chris Chelios,Canadiens,53,31,9,22
498,Chris Chelios,Blackhawks,77,64,12,52
498,Chris Chelios,Blackhawks,80,56,9,47
498,Chris Chelios,Blackhawks,84,73,15,58
498,Chris Chelios,Blackhawks,76,60,16,44
498,Chris Chelios,Blackhawks,48,38,5,33
498,Chris Chelios,Blackhawks,81,72,14,58
498,Chris Chelios,Blackhawks,72,48,10,38
498,Chris Chelios,Blackhawks,81,42,3,39
498,Chris Chelios,Blackhawks,65,34,8,26
498,Chris Chelios,Red Wings,10,2,1,1
498,Chris Chelios,Red Wings,81,34,3,31
498,Chris Chelios,Red Wings,24,3,0,3
498,Chris Chelios,Red Wings,79,39,6,33
498,Chris Chelios,Red Wings,66,19,2,17
498,Chris Chelios,Red Wings,69,21,2,19
498,Chris Chelios,Red Wings,81,11,4,7
498,Chris Chelios,Red Wings,71,11,0,11
498,Chris Chelios,Red Wings,69,12,3,9
498,Chris Chelios,Red Wings,28,0,0,0
498,Chris Chelios,Thrashers,7,0,0,0
499,Michal Handzus,Blues,66,16,4,12
499,Michal Handzus,Blues,81,53,25,28
499,Michal Handzus,Blues,36,24,10,14
499,Michal Handzus,Coyotes,10,8,4,4
499,Michal Handzus,Coyotes,79,45,15,30
499,Michal Handzus,Flyers,82,44,23,21
499,Michal Handzus,Flyers,82,58,20,38
499,Michal Handzus,Flyers,73,44,11,33
499,Michal Handzus,Blackhawks,8,8,3,5
499,Michal Handzus,Kings,82,21,7,14
499,Michal Handzus,Kings,82,42,18,24
499,Michal Handzus,Kings,81,42,20,22
499,Michal Handzus,Kings,82,30,12,18
499,Michal Handzus,Sharks,67,24,7,17
499,Michal Handzus,Sharks,28,2,1,1
499,Michal Handzus,Blackhawks,11,6,1,5
499,Michal Handzus,Blackhawks,59,16,4,12
500,Douglas Risebrough,Canadiens,64,47,15,32
500,Douglas Risebrough,Canadiens,80,44,16,28
500,Douglas Risebrough,Canadiens,78,60,22,38
500,Douglas Risebrough,Canadiens,72,41,18,23
500,Douglas Risebrough,Canadiens,48,25,10,15
500,Douglas Risebrough,Canadiens,44,18,8,10
500,Douglas Risebrough,Canadiens,48,34,13,21
500,Douglas Risebrough,Canadiens,59,33,15,18
500,Douglas Risebrough,Flames,71,58,21,37
500,Douglas Risebrough,Flames,77,51,23,28
500,Douglas Risebrough,Flames,15,12,7,5
500,Douglas Risebrough,Flames,62,43,15,28
500,Douglas Risebrough,Flames,22,5,2,3
501,Gaye Stewart,Maple Leafs,48,47,24,23
501,Gaye Stewart,Maple Leafs,50,52,37,15
501,Gaye Stewart,Maple Leafs,60,33,19,14
501,Gaye Stewart,Maple Leafs,7,1,1,0
501,Gaye Stewart,Blackhawks,54,55,26,29
501,Gaye Stewart,Blackhawks,54,38,20,18
501,Gaye Stewart,Blackhawks,70,43,24,19
501,Gaye Stewart,Red Wings,67,31,18,13
501,Gaye Stewart,Rangers,69,40,15,25
501,Gaye Stewart,Rangers,18,2,1,1
501,Gaye Stewart,Canadiens,5,2,0,2
502,Tomas Plekanec,Canadiens,2,0,0,0
502,Tomas Plekanec,Canadiens,67,29,9,20
502,Tomas Plekanec,Canadiens,81,47,20,27
502,Tomas Plekanec,Canadiens,81,69,29,40
502,Tomas Plekanec,Canadiens,80,39,20,19
502,Tomas Plekanec,Canadiens,82,70,25,45
502,Tomas Plekanec,Canadiens,77,57,22,35
502,Tomas Plekanec,Canadiens,81,52,17,35
502,Tomas Plekanec,Canadiens,47,33,14,19
502,Tomas Plekanec,Canadiens,81,43,20,23
502,Tomas Plekanec,Canadiens,24,17,8,9
503,Walt Poddubny,Oilers,4,0,0,0
503,Walt Poddubny,Maple Leafs,11,7,3,4
503,Walt Poddubny,Maple Leafs,72,59,28,31
503,Walt Poddubny,Maple Leafs,38,25,11,14
503,Walt Poddubny,Maple Leafs,32,20,5,15
503,Walt Poddubny,Maple Leafs,33,34,12,22
503,Walt Poddubny,Rangers,75,87,40,47
503,Walt Poddubny,Rangers,77,88,38,50
503,Walt Poddubny,Nordiques,72,75,38,37
503,Walt Poddubny,Devils,33,14,4,10
503,Walt Poddubny,Devils,14,10,4,6
503,Walt Poddubny,Devils,7,3,1,2
504,Adam Deadmarsh,Nordiques,48,17,9,8
504,Adam Deadmarsh,Avalanche,78,48,21,27
504,Adam Deadmarsh,Avalanche,78,60,33,27
504,Adam Deadmarsh,Avalanche,73,43,22,21
504,Adam Deadmarsh,Avalanche,66,49,22,27
504,Adam Deadmarsh,Avalanche,71,45,18,27
504,Adam Deadmarsh,Avalanche,39,26,13,13
504,Adam Deadmarsh,Kings,18,6,4,2
504,Adam Deadmarsh,Kings,76,62,29,33
504,Adam Deadmarsh,Kings,20,17,13,4
505,Syl Apps Jr.,Rangers,31,3,1,2
505,Syl Apps Jr.,Penguins,31,25,9,16
505,Syl Apps Jr.,Penguins,72,59,15,44
505,Syl Apps Jr.,Penguins,77,85,29,56
505,Syl Apps Jr.,Penguins,75,85,24,61
505,Syl Apps Jr.,Penguins,79,79,24,55
505,Syl Apps Jr.,Penguins,80,99,32,67
505,Syl Apps Jr.,Penguins,72,61,18,43
505,Syl Apps Jr.,Penguins,9,7,0,7
505,Syl Apps Jr.,Kings,70,45,19,26
505,Syl Apps Jr.,Kings,80,37,7,30
505,Syl Apps Jr.,Kings,51,21,5,16
506,Vic Stasiuk,Blackhawks,17,2,1,1
506,Vic Stasiuk,Blackhawks,20,8,5,3
506,Vic Stasiuk,Red Wings,50,13,3,10
506,Vic Stasiuk,Red Wings,58,14,5,9
506,Vic Stasiuk,Red Wings,3,0,0,0
506,Vic Stasiuk,Red Wings,42,7,5,2
506,Vic Stasiuk,Red Wings,59,19,8,11
506,Vic Stasiuk,Bruins,59,37,19,18
506,Vic Stasiuk,Bruins,64,40,24,16
506,Vic Stasiuk,Bruins,70,56,21,35
506,Vic Stasiuk,Bruins,70,60,27,33
506,Vic Stasiuk,Bruins,69,68,29,39
506,Vic Stasiuk,Bruins,46,30,5,25
506,Vic Stasiuk,Red Wings,23,23,10,13
506,Vic Stasiuk,Red Wings,59,43,15,28
506,Vic Stasiuk,Red Wings,36,17,6,11
507,Petri Skriko,Canucks,72,35,21,14
507,Petri Skriko,Canucks,80,78,38,40
507,Petri Skriko,Canucks,76,74,33,41
507,Petri Skriko,Canucks,73,64,30,34
507,Petri Skriko,Canucks,74,66,30,36
507,Petri Skriko,Canucks,77,48,15,33
507,Petri Skriko,Canucks,20,8,4,4
507,Petri Skriko,Bruins,28,19,5,14
507,Petri Skriko,Bruins,9,1,1,0
507,Petri Skriko,Jets (1979),15,5,2,3
507,Petri Skriko,Sharks,17,7,4,3
508,Craig Conroy,Canadiens,6,1,1,0
508,Craig Conroy,Canadiens,7,0,0,0
508,Craig Conroy,Blues,61,17,6,11
508,Craig Conroy,Blues,81,43,14,29
508,Craig Conroy,Blues,69,39,14,25
508,Craig Conroy,Blues,79,27,12,15
508,Craig Conroy,Blues,69,25,11,14
508,Craig Conroy,Flames,14,7,3,4
508,Craig Conroy,Flames,81,75,27,48
508,Craig Conroy,Flames,79,59,22,37
508,Craig Conroy,Flames,63,47,8,39
508,Craig Conroy,Kings,78,66,22,44
508,Craig Conroy,Kings,52,16,5,11
508,Craig Conroy,Flames,28,21,8,13
508,Craig Conroy,Flames,79,34,12,22
508,Craig Conroy,Flames,82,48,12,36
508,Craig Conroy,Flames,63,15,3,12
508,Craig Conroy,Flames,18,2,2,0
509,Brian Bradley,Flames,5,1,0,1
509,Brian Bradley,Flames,40,28,10,18
509,Brian Bradley,Canucks,11,8,3,5
509,Brian Bradley,Canucks,71,45,18,27
509,Brian Bradley,Canucks,67,48,19,29
509,Brian Bradley,Canucks,44,31,11,20
509,Brian Bradley,Maple Leafs,26,11,0,11
509,Brian Bradley,Maple Leafs,59,31,10,21
509,Brian Bradley,Lightning,80,86,42,44
509,Brian Bradley,Lightning,78,64,24,40
509,Brian Bradley,Lightning,46,40,13,27
509,Brian Bradley,Lightning,75,79,23,56
509,Brian Bradley,Lightning,35,24,7,17
509,Brian Bradley,Lightning,14,7,2,5
510,Andy McDonald,Ducks,16,1,1,0
510,Andy McDonald,Ducks,53,28,7,21
510,Andy McDonald,Ducks,46,21,10,11
510,Andy McDonald,Ducks,79,30,9,21
510,Andy McDonald,Ducks,82,85,34,51
510,Andy McDonald,Ducks,82,78,27,51
510,Andy McDonald,Ducks,33,16,4,12
510,Andy McDonald,Blues,49,36,14,22
510,Andy McDonald,Blues,46,44,15,29
510,Andy McDonald,Blues,79,57,24,33
510,Andy McDonald,Blues,58,50,20,30
510,Andy McDonald,Blues,25,22,10,12
510,Andy McDonald,Blues,37,21,7,14
511,Ab McDonald,Canadiens,69,36,13,23
511,Ab McDonald,Canadiens,68,22,9,13
511,Ab McDonald,Blackhawks,61,33,17,16
511,Ab McDonald,Blackhawks,65,40,22,18
511,Ab McDonald,Blackhawks,69,61,20,41
511,Ab McDonald,Blackhawks,70,46,14,32
511,Ab McDonald,Bruins,60,18,9,9
511,Ab McDonald,Red Wings,43,22,6,16
511,Ab McDonald,Red Wings,12,2,2,0
511,Ab McDonald,Penguins,74,43,22,21
511,Ab McDonald,Blues,68,42,21,21
511,Ab McDonald,Blues,64,55,25,30
511,Ab McDonald,Blues,20,5,0,5
511,Ab McDonald,Red Wings,19,5,2,3
512,Guy Gendron,Rangers,63,12,5,7
512,Guy Gendron,Rangers,70,15,9,6
512,Guy Gendron,Rangers,70,27,10,17
512,Guy Gendron,Bruins,60,24,15,9
512,Guy Gendron,Bruins,67,35,24,11
512,Guy Gendron,Bruins,13,8,1,7
512,Guy Gendron,Canadiens,53,21,9,12
512,Guy Gendron,Rangers,69,25,14,11
512,Guy Gendron,Bruins,66,43,21,22
512,Guy Gendron,Bruins,54,18,5,13
512,Guy Gendron,Flyers,1,1,0,1
512,Guy Gendron,Flyers,74,55,20,35
512,Guy Gendron,Flyers,71,44,23,21
512,Guy Gendron,Flyers,76,36,20,16
512,Guy Gendron,Flyers,56,19,6,13
513,Bert Olmstead,Blackhawks,9,2,0,2
513,Bert Olmstead,Blackhawks,70,49,20,29
513,Bert Olmstead,Blackhawks,15,3,2,1
513,Bert Olmstead,Canadiens,39,38,16,22
513,Bert Olmstead,Canadiens,69,35,7,28
513,Bert Olmstead,Canadiens,69,45,17,28
513,Bert Olmstead,Canadiens,70,52,15,37
513,Bert Olmstead,Canadiens,70,58,10,48
513,Bert Olmstead,Canadiens,70,70,14,56
513,Bert Olmstead,Canadiens,64,48,15,33
513,Bert Olmstead,Canadiens,57,37,9,28
513,Bert Olmstead,Maple Leafs,70,41,10,31
513,Bert Olmstead,Maple Leafs,53,36,15,21
513,Bert Olmstead,Maple Leafs,67,52,18,34
513,Bert Olmstead,Maple Leafs,56,36,13,23
514,Michal Pivonka,Capitals,73,43,18,25
514,Michal Pivonka,Capitals,71,34,11,23
514,Michal Pivonka,Capitals,52,27,8,19
514,Michal Pivonka,Capitals,77,64,25,39
514,Michal Pivonka,Capitals,79,70,20,50
514,Michal Pivonka,Capitals,80,80,23,57
514,Michal Pivonka,Capitals,69,74,21,53
514,Michal Pivonka,Capitals,82,50,14,36
514,Michal Pivonka,Capitals,46,33,10,23
514,Michal Pivonka,Capitals,73,81,16,65
514,Michal Pivonka,Capitals,54,23,7,16
514,Michal Pivonka,Capitals,33,9,3,6
514,Michal Pivonka,Capitals,36,11,5,6
515,Kelly Miller,Rangers,5,2,0,2
515,Kelly Miller,Rangers,74,33,13,20
515,Kelly Miller,Rangers,38,20,6,14
515,Kelly Miller,Capitals,39,22,10,12
515,Kelly Miller,Capitals,80,32,9,23
515,Kelly Miller,Capitals,78,40,19,21
515,Kelly Miller,Capitals,80,40,18,22
515,Kelly Miller,Capitals,80,50,24,26
515,Kelly Miller,Capitals,78,52,14,38
515,Kelly Miller,Capitals,84,45,18,27
515,Kelly Miller,Capitals,84,39,14,25
515,Kelly Miller,Capitals,48,23,10,13
515,Kelly Miller,Capitals,74,20,7,13
515,Kelly Miller,Capitals,77,24,10,14
515,Kelly Miller,Capitals,76,14,7,7
515,Kelly Miller,Capitals,62,7,2,5
516,Shawn Burr,Red Wings,9,0,0,0
516,Shawn Burr,Red Wings,5,1,1,0
516,Shawn Burr,Red Wings,80,47,22,25
516,Shawn Burr,Red Wings,78,40,17,23
516,Shawn Burr,Red Wings,79,46,19,27
516,Shawn Burr,Red Wings,76,56,24,32
516,Shawn Burr,Red Wings,80,50,20,30
516,Shawn Burr,Red Wings,79,51,19,32
516,Shawn Burr,Red Wings,80,35,10,25
516,Shawn Burr,Red Wings,51,22,10,12
516,Shawn Burr,Red Wings,42,14,6,8
516,Shawn Burr,Lightning,81,28,13,15
516,Shawn Burr,Lightning,74,35,14,21
516,Shawn Burr,Sharks,42,12,6,6
516,Shawn Burr,Sharks,18,1,0,1
516,Shawn Burr,Lightning,4,2,0,2
517,Martin Lapointe,Red Wings,4,1,0,1
517,Martin Lapointe,Red Wings,3,0,0,0
517,Martin Lapointe,Red Wings,50,16,8,8
517,Martin Lapointe,Red Wings,39,10,4,6
517,Martin Lapointe,Red Wings,58,9,6,3
517,Martin Lapointe,Red Wings,78,33,16,17
517,Martin Lapointe,Red Wings,79,34,15,19
517,Martin Lapointe,Red Wings,77,29,16,13
517,Martin Lapointe,Red Wings,82,41,16,25
517,Martin Lapointe,Red Wings,82,57,27,30
517,Martin Lapointe,Bruins,68,40,17,23
517,Martin Lapointe,Bruins,59,18,8,10
517,Martin Lapointe,Bruins,78,25,15,10
517,Martin Lapointe,Blackhawks,82,31,14,17
517,Martin Lapointe,Blackhawks,82,24,13,11
517,Martin Lapointe,Blackhawks,52,7,3,4
517,Martin Lapointe,Senators,18,6,3,3
518,Gerry Meehan,Maple Leafs,25,2,0,2
518,Gerry Meehan,Flyers,12,3,0,3
518,Gerry Meehan,Sabres,77,55,24,31
518,Gerry Meehan,Sabres,77,46,19,27
518,Gerry Meehan,Sabres,77,60,31,29
518,Gerry Meehan,Sabres,72,46,20,26
518,Gerry Meehan,Sabres,3,1,0,1
518,Gerry Meehan,Canucks,57,25,10,15
518,Gerry Meehan,Flames,14,14,4,10
518,Gerry Meehan,Flames,48,27,7,20
518,Gerry Meehan,Capitals,32,31,16,15
518,Gerry Meehan,Capitals,80,64,28,36
518,Gerry Meehan,Capitals,78,43,19,24
518,Gerry Meehan,Capitals,18,6,2,4
519,Lowell MacDonald,Red Wings,1,0,0,0
519,Lowell MacDonald,Red Wings,26,3,2,1
519,Lowell MacDonald,Red Wings,10,5,1,4
519,Lowell MacDonald,Red Wings,9,3,2,1
519,Lowell MacDonald,Kings,74,45,21,24
519,Lowell MacDonald,Kings,58,28,14,14
519,Lowell MacDonald,Penguins,10,1,0,1
519,Lowell MacDonald,Penguins,78,75,34,41
519,Lowell MacDonald,Penguins,78,82,43,39
519,Lowell MacDonald,Penguins,71,60,27,33
519,Lowell MacDonald,Penguins,69,73,30,43
519,Lowell MacDonald,Penguins,3,2,1,1
519,Lowell MacDonald,Penguins,19,13,5,8
520,Ron Greschner,Rangers,70,45,8,37
520,Ron Greschner,Rangers,77,27,6,21
520,Ron Greschner,Rangers,80,47,11,36
520,Ron Greschner,Rangers,78,72,24,48
520,Ron Greschner,Rangers,60,53,17,36
520,Ron Greschner,Rangers,76,58,21,37
520,Ron Greschner,Rangers,74,68,27,41
520,Ron Greschner,Rangers,29,16,5,11
520,Ron Greschner,Rangers,10,8,3,5
520,Ron Greschner,Rangers,77,56,12,44
520,Ron Greschner,Rangers,48,45,16,29
520,Ron Greschner,Rangers,78,48,20,28
520,Ron Greschner,Rangers,61,40,6,34
520,Ron Greschner,Rangers,51,6,1,5
520,Ron Greschner,Rangers,58,11,1,10
520,Ron Greschner,Rangers,55,10,1,9
521,Gaetan Duchesne,Capitals,74,23,9,14
521,Gaetan Duchesne,Capitals,77,37,18,19
521,Gaetan Duchesne,Capitals,79,36,17,19
521,Gaetan Duchesne,Capitals,67,38,15,23
521,Gaetan Duchesne,Capitals,80,39,11,28
521,Gaetan Duchesne,Capitals,74,52,17,35
521,Gaetan Duchesne,Nordiques,80,47,24,23
521,Gaetan Duchesne,Nordiques,70,29,8,21
521,Gaetan Duchesne,North Stars,72,20,12,8
521,Gaetan Duchesne,North Stars,68,18,9,9
521,Gaetan Duchesne,North Stars,73,23,8,15
521,Gaetan Duchesne,North Stars,84,29,16,13
521,Gaetan Duchesne,Sharks,84,30,12,18
521,Gaetan Duchesne,Sharks,33,9,2,7
521,Gaetan Duchesne,Panthers,13,3,1,2
522,Earl Ingarfield,Rangers,35,3,1,2
522,Earl Ingarfield,Rangers,20,3,1,2
522,Earl Ingarfield,Rangers,66,34,13,21
522,Earl Ingarfield,Rangers,70,57,26,31
522,Earl Ingarfield,Rangers,69,43,19,24
522,Earl Ingarfield,Rangers,63,26,15,11
522,Earl Ingarfield,Rangers,69,28,15,13
522,Earl Ingarfield,Rangers,68,36,20,16
522,Earl Ingarfield,Rangers,67,34,12,22
522,Earl Ingarfield,Penguins,50,37,15,22
522,Earl Ingarfield,Penguins,40,23,8,15
522,Earl Ingarfield,Seals,26,23,8,15
522,Earl Ingarfield,Seals,54,45,21,24
522,Earl Ingarfield,Seals,49,13,5,8
523,Richard Seiling,Sabres,80,38,19,19
523,Richard Seiling,Sabres,78,42,20,22
523,Richard Seiling,Sabres,80,60,25,35
523,Richard Seiling,Sabres,74,57,30,27
523,Richard Seiling,Sabres,57,47,22,25
523,Richard Seiling,Sabres,75,41,19,22
523,Richard Seiling,Sabres,78,35,13,22
523,Richard Seiling,Sabres,73,31,16,15
523,Richard Seiling,Sabres,69,25,12,13
523,Richard Seiling,Red Wings,74,11,3,8
524,Ryan Malone,Penguins,81,43,22,21
524,Ryan Malone,Penguins,77,44,22,22
524,Ryan Malone,Penguins,64,31,16,15
524,Ryan Malone,Penguins,77,51,27,24
524,Ryan Malone,Lightning,70,45,26,19
524,Ryan Malone,Lightning,69,47,21,26
524,Ryan Malone,Lightning,54,38,14,24
524,Ryan Malone,Lightning,68,48,20,28
524,Ryan Malone,Lightning,24,8,6,2
524,Ryan Malone,Lightning,57,15,5,10
524,Ryan Malone,Rangers,6,0,0,0
525,Derek Roy,Sabres,49,19,9,10
525,Derek Roy,Sabres,70,46,18,28
525,Derek Roy,Sabres,75,63,21,42
525,Derek Roy,Sabres,78,81,32,49
525,Derek Roy,Sabres,82,70,28,42
525,Derek Roy,Sabres,80,69,26,43
525,Derek Roy,Sabres,35,35,10,25
525,Derek Roy,Sabres,80,44,17,27
525,Derek Roy,Stars,30,22,4,18
525,Derek Roy,Canucks,12,6,3,3
525,Derek Roy,Blues,75,37,9,28
525,Derek Roy,Predators,22,10,1,9
526,Mike Richards,Flyers,79,34,11,23
526,Mike Richards,Flyers,59,32,10,22
526,Mike Richards,Flyers,73,75,28,47
526,Mike Richards,Flyers,79,80,30,50
526,Mike Richards,Flyers,82,62,31,31
526,Mike Richards,Flyers,81,66,23,43
526,Mike Richards,Kings,74,44,18,26
526,Mike Richards,Kings,48,32,12,20
526,Mike Richards,Kings,82,41,11,30
526,Mike Richards,Kings,23,10,4,6
527,Ed Litzenberger,Canadiens,2,1,1,0
527,Ed Litzenberger,Canadiens,3,0,0,0
527,Ed Litzenberger,Canadiens,29,11,7,4
527,Ed Litzenberger,Blackhawks,44,40,16,24
527,Ed Litzenberger,Blackhawks,70,39,10,29
527,Ed Litzenberger,Blackhawks,70,64,32,32
527,Ed Litzenberger,Blackhawks,70,62,32,30
527,Ed Litzenberger,Blackhawks,70,77,33,44
527,Ed Litzenberger,Blackhawks,52,30,12,18
527,Ed Litzenberger,Blackhawks,62,32,10,22
527,Ed Litzenberger,Red Wings,32,20,8,12
527,Ed Litzenberger,Maple Leafs,37,20,10,10
527,Ed Litzenberger,Maple Leafs,58,18,5,13
527,Ed Litzenberger,Maple Leafs,19,2,2,0
528,Thomas McCarthy,North Stars,68,36,16,20
528,Thomas McCarthy,North Stars,62,48,23,25
528,Thomas McCarthy,North Stars,40,42,12,30
528,Thomas McCarthy,North Stars,80,76,28,48
528,Thomas McCarthy,North Stars,66,70,39,31
528,Thomas McCarthy,North Stars,44,37,16,21
528,Thomas McCarthy,North Stars,25,24,12,12
528,Thomas McCarthy,Bruins,68,59,30,29
528,Thomas McCarthy,Bruins,7,7,2,5
529,Stephen Heinze,Bruins,14,7,3,4
529,Stephen Heinze,Bruins,73,31,18,13
529,Stephen Heinze,Bruins,77,21,10,11
529,Stephen Heinze,Bruins,36,16,7,9
529,Stephen Heinze,Bruins,76,28,16,12
529,Stephen Heinze,Bruins,30,25,17,8
529,Stephen Heinze,Bruins,61,46,26,20
529,Stephen Heinze,Bruins,73,40,22,18
529,Stephen Heinze,Bruins,75,25,12,13
529,Stephen Heinze,Blue Jackets,65,42,22,20
529,Stephen Heinze,Sabres,14,12,5,7
529,Stephen Heinze,Kings,73,31,15,16
529,Stephen Heinze,Kings,27,12,5,7
530,Dallas Drake,Red Wings,72,44,18,26
530,Dallas Drake,Red Wings,47,32,10,22
530,Dallas Drake,Jets (1979),15,8,3,5
530,Dallas Drake,Jets (1979),43,26,8,18
530,Dallas Drake,Jets (1979),69,39,19,20
530,Dallas Drake,Coyotes,63,36,17,19
530,Dallas Drake,Coyotes,60,40,11,29
530,Dallas Drake,Coyotes,53,31,9,22
530,Dallas Drake,Coyotes,79,45,15,30
530,Dallas Drake,Blues,82,41,12,29
530,Dallas Drake,Blues,80,26,11,15
530,Dallas Drake,Blues,80,30,20,10
530,Dallas Drake,Blues,79,35,13,22
530,Dallas Drake,Blues,62,26,2,24
530,Dallas Drake,Blues,60,12,6,6
530,Dallas Drake,Red Wings,65,6,3,3
531,Stephen Kasper,Bruins,76,56,21,35
531,Stephen Kasper,Bruins,73,51,20,31
531,Stephen Kasper,Bruins,24,8,2,6
531,Stephen Kasper,Bruins,27,14,3,11
531,Stephen Kasper,Bruins,77,40,16,24
531,Stephen Kasper,Bruins,80,40,17,23
531,Stephen Kasper,Bruins,79,50,20,30
531,Stephen Kasper,Bruins,79,70,26,44
531,Stephen Kasper,Bruins,49,26,10,16
531,Stephen Kasper,Kings,29,24,9,15
531,Stephen Kasper,Kings,77,45,17,28
531,Stephen Kasper,Kings,67,28,9,19
531,Stephen Kasper,Flyers,16,5,3,2
531,Stephen Kasper,Flyers,21,4,1,3
531,Stephen Kasper,Lightning,47,7,3,4
532,John Tucker,Sabres,21,16,12,4
532,John Tucker,Sabres,64,49,22,27
532,John Tucker,Sabres,75,65,31,34
532,John Tucker,Sabres,54,51,17,34
532,John Tucker,Sabres,45,38,19,19
532,John Tucker,Sabres,60,44,13,31
532,John Tucker,Sabres,8,3,1,2
532,John Tucker,Capitals,38,28,9,19
532,John Tucker,Sabres,18,4,1,3
532,John Tucker,Islanders,20,7,3,4
532,John Tucker,Lightning,78,56,17,39
532,John Tucker,Lightning,66,40,17,23
532,John Tucker,Lightning,46,25,12,13
532,John Tucker,Lightning,63,10,3,7
533,Michael Peca,Canucks,4,0,0,0
533,Michael Peca,Canucks,33,12,6,6
533,Michael Peca,Sabres,68,31,11,20
533,Michael Peca,Sabres,79,49,20,29
533,Michael Peca,Sabres,61,40,18,22
533,Michael Peca,Sabres,82,56,27,29
533,Michael Peca,Sabres,73,41,20,21
533,Michael Peca,Islanders,80,60,25,35
533,Michael Peca,Islanders,66,42,13,29
533,Michael Peca,Islanders,76,40,11,29
533,Michael Peca,Oilers,71,23,9,14
533,Michael Peca,Maple Leafs,35,15,4,11
533,Michael Peca,Blue Jackets,65,34,8,26
533,Michael Peca,Blue Jackets,71,22,4,18
534,Dennis Ververgaert,Canucks,78,57,26,31
534,Dennis Ververgaert,Canucks,57,51,19,32
534,Dennis Ververgaert,Canucks,80,71,37,34
534,Dennis Ververgaert,Canucks,79,45,27,18
534,Dennis Ververgaert,Canucks,80,54,21,33
534,Dennis Ververgaert,Canucks,35,26,9,17
534,Dennis Ververgaert,Flyers,37,16,9,7
534,Dennis Ververgaert,Flyers,58,31,14,17
534,Dennis Ververgaert,Capitals,79,41,14,27
535,Johnny Gottselig,Blackhawks,44,8,5,3
535,Johnny Gottselig,Blackhawks,39,25,21,4
535,Johnny Gottselig,Blackhawks,42,32,20,12
535,Johnny Gottselig,Blackhawks,44,28,13,15
535,Johnny Gottselig,Blackhawks,41,22,11,11
535,Johnny Gottselig,Blackhawks,48,30,16,14
535,Johnny Gottselig,Blackhawks,48,37,19,18
535,Johnny Gottselig,Blackhawks,40,29,14,15
535,Johnny Gottselig,Blackhawks,47,30,9,21
535,Johnny Gottselig,Blackhawks,48,32,13,19
535,Johnny Gottselig,Blackhawks,48,39,16,23
535,Johnny Gottselig,Blackhawks,39,23,8,15
535,Johnny Gottselig,Blackhawks,5,5,1,4
535,Johnny Gottselig,Blackhawks,10,8,2,6
535,Johnny Gottselig,Blackhawks,45,23,8,15
535,Johnny Gottselig,Blackhawks,1,0,0,0
536,Alex Frolov,Kings,79,31,14,17
536,Alex Frolov,Kings,77,48,24,24
536,Alex Frolov,Kings,69,54,21,33
536,Alex Frolov,Kings,82,71,35,36
536,Alex Frolov,Kings,71,67,23,44
536,Alex Frolov,Kings,77,59,32,27
536,Alex Frolov,Kings,81,51,19,32
536,Alex Frolov,Rangers,43,16,7,9
537,Bobby Ryan,Ducks,23,10,5,5
537,Bobby Ryan,Ducks,64,57,31,26
537,Bobby Ryan,Ducks,81,64,35,29
537,Bobby Ryan,Ducks,82,71,34,37
537,Bobby Ryan,Ducks,82,57,31,26
537,Bobby Ryan,Ducks,46,30,11,19
537,Bobby Ryan,Senators,70,48,23,25
537,Bobby Ryan,Senators,21,13,5,8
538,Randy Wood,Islanders,6,1,1,0
538,Randy Wood,Islanders,75,38,22,16
538,Randy Wood,Islanders,77,28,15,13
538,Randy Wood,Islanders,74,48,24,24
538,Randy Wood,Islanders,76,42,24,18
538,Randy Wood,Islanders,8,4,2,2
538,Randy Wood,Sabres,70,36,20,16
538,Randy Wood,Sabres,82,43,18,25
538,Randy Wood,Sabres,84,38,22,16
538,Randy Wood,Maple Leafs,48,24,13,11
538,Randy Wood,Maple Leafs,46,16,7,9
538,Randy Wood,Stars,30,5,1,4
538,Randy Wood,Islanders,65,11,6,5
539,Valeri Bure,Canadiens,24,4,3,1
539,Valeri Bure,Canadiens,77,42,22,20
539,Valeri Bure,Canadiens,64,35,14,21
539,Valeri Bure,Canadiens,50,29,7,22
539,Valeri Bure,Flames,16,9,5,4
539,Valeri Bure,Flames,80,53,26,27
539,Valeri Bure,Flames,82,75,35,40
539,Valeri Bure,Flames,78,55,27,28
539,Valeri Bure,Panthers,31,18,8,10
539,Valeri Bure,Panthers,46,26,5,21
539,Valeri Bure,Blues,5,2,0,2
539,Valeri Bure,Panthers,55,45,20,25
539,Valeri Bure,Stars,13,7,2,5
540,Jorgen Pettersson,Blues,62,73,37,36
540,Jorgen Pettersson,Blues,77,69,38,31
540,Jorgen Pettersson,Blues,74,73,35,38
540,Jorgen Pettersson,Blues,77,62,28,34
540,Jorgen Pettersson,Blues,75,55,23,32
540,Jorgen Pettersson,Whalers,23,10,5,5
540,Jorgen Pettersson,Capitals,47,24,8,16
541,Greg Polis,Penguins,61,33,18,15
541,Greg Polis,Penguins,76,49,30,19
541,Greg Polis,Penguins,78,49,26,23
541,Greg Polis,Penguins,41,27,14,13
541,Greg Polis,Blues,37,20,8,12
541,Greg Polis,Rangers,76,41,26,15
541,Greg Polis,Rangers,79,36,15,21
541,Greg Polis,Rangers,77,39,16,23
541,Greg Polis,Rangers,37,23,7,16
541,Greg Polis,Rangers,6,2,1,1
541,Greg Polis,Capitals,19,18,12,6
541,Greg Polis,Capitals,28,6,1,5
542,Scott Gomez,Devils,82,70,19,51
542,Scott Gomez,Devils,76,63,14,49
542,Scott Gomez,Devils,76,48,10,38
542,Scott Gomez,Devils,80,55,13,42
542,Scott Gomez,Devils,80,70,14,56
542,Scott Gomez,Devils,82,84,33,51
542,Scott Gomez,Devils,72,60,13,47
542,Scott Gomez,Rangers,81,70,16,54
542,Scott Gomez,Rangers,77,58,16,42
542,Scott Gomez,Canadiens,78,59,12,47
542,Scott Gomez,Canadiens,80,38,7,31
542,Scott Gomez,Canadiens,38,11,2,9
542,Scott Gomez,Sharks,39,15,2,13
542,Scott Gomez,Panthers,46,12,2,10
543,Andrei Kovalenko,Nordiques,81,68,27,41
543,Andrei Kovalenko,Nordiques,58,33,16,17
543,Andrei Kovalenko,Nordiques,45,24,14,10
543,Andrei Kovalenko,Avalanche,26,22,11,11
543,Andrei Kovalenko,Canadiens,51,34,17,17
543,Andrei Kovalenko,Oilers,74,59,32,27
543,Andrei Kovalenko,Oilers,59,23,6,17
543,Andrei Kovalenko,Oilers,43,27,13,14
543,Andrei Kovalenko,Flyers,13,1,0,1
543,Andrei Kovalenko,Hurricanes,18,12,6,6
543,Andrei Kovalenko,Hurricanes,76,39,15,24
543,Andrei Kovalenko,Bruins,76,37,16,21
544,Ruslan Fedotenko,Flyers,74,36,16,20
544,Ruslan Fedotenko,Flyers,78,26,17,9
544,Ruslan Fedotenko,Lightning,76,32,19,13
544,Ruslan Fedotenko,Lightning,77,39,17,22
544,Ruslan Fedotenko,Lightning,80,41,26,15
544,Ruslan Fedotenko,Lightning,80,32,12,20
544,Ruslan Fedotenko,Islanders,67,33,16,17
544,Ruslan Fedotenko,Penguins,65,39,16,23
544,Ruslan Fedotenko,Penguins,80,30,11,19
544,Ruslan Fedotenko,Rangers,66,25,10,15
544,Ruslan Fedotenko,Rangers,73,20,9,11
544,Ruslan Fedotenko,Flyers,47,13,4,9
545,Cooney Weiland,Bruins,42,18,11,7
545,Cooney Weiland,Bruins,44,73,43,30
545,Cooney Weiland,Bruins,44,38,25,13
545,Cooney Weiland,Bruins,46,26,14,12
545,Cooney Weiland,Senators (1917),48,27,16,11
545,Cooney Weiland,Senators (1917),9,2,2,0
545,Cooney Weiland,Red Wings,39,30,11,19
545,Cooney Weiland,Red Wings,48,38,13,25
545,Cooney Weiland,Bruins,48,27,14,13
545,Cooney Weiland,Bruins,48,15,6,9
545,Cooney Weiland,Bruins,48,23,11,12
545,Cooney Weiland,Bruins,45,16,7,9
546,Scott Niedermayer,Devils,4,1,0,1
546,Scott Niedermayer,Devils,80,40,11,29
546,Scott Niedermayer,Devils,81,46,10,36
546,Scott Niedermayer,Devils,48,19,4,15
546,Scott Niedermayer,Devils,79,33,8,25
546,Scott Niedermayer,Devils,81,35,5,30
546,Scott Niedermayer,Devils,81,57,14,43
546,Scott Niedermayer,Devils,72,46,11,35
546,Scott Niedermayer,Devils,71,38,7,31
546,Scott Niedermayer,Devils,57,35,6,29
546,Scott Niedermayer,Devils,76,33,11,22
546,Scott Niedermayer,Devils,81,39,11,28
546,Scott Niedermayer,Devils,81,54,14,40
546,Scott Niedermayer,Ducks,82,63,13,50
546,Scott Niedermayer,Ducks,79,69,15,54
546,Scott Niedermayer,Ducks,48,25,8,17
546,Scott Niedermayer,Ducks,82,59,14,45
546,Scott Niedermayer,Ducks,80,48,10,38
547,Shawn Horcoff,Oilers,49,16,9,7
547,Shawn Horcoff,Oilers,61,22,8,14
547,Shawn Horcoff,Oilers,78,33,12,21
547,Shawn Horcoff,Oilers,80,40,15,25
547,Shawn Horcoff,Oilers,79,73,22,51
547,Shawn Horcoff,Oilers,80,51,16,35
547,Shawn Horcoff,Oilers,53,50,21,29
547,Shawn Horcoff,Oilers,80,53,17,36
547,Shawn Horcoff,Oilers,77,36,13,23
547,Shawn Horcoff,Oilers,47,27,9,18
547,Shawn Horcoff,Oilers,81,34,13,21
547,Shawn Horcoff,Oilers,31,12,7,5
547,Shawn Horcoff,Stars,77,20,7,13
547,Shawn Horcoff,Stars,23,8,3,5
548,Brian MacLellan,Kings,8,3,0,3
548,Brian MacLellan,Kings,72,54,25,29
548,Brian MacLellan,Kings,80,85,31,54
548,Brian MacLellan,Kings,27,13,5,8
548,Brian MacLellan,Rangers,51,32,11,21
548,Brian MacLellan,North Stars,76,63,32,31
548,Brian MacLellan,North Stars,75,48,16,32
548,Brian MacLellan,North Stars,60,39,16,23
548,Brian MacLellan,Flames,12,5,2,3
548,Brian MacLellan,Flames,65,38,20,18
548,Brian MacLellan,Flames,57,27,13,14
548,Brian MacLellan,Red Wings,23,6,1,5
549,Anders Hedberg,Rangers,80,78,33,45
549,Anders Hedberg,Rangers,80,71,32,39
549,Anders Hedberg,Rangers,80,70,30,40
549,Anders Hedberg,Rangers,4,1,0,1
549,Anders Hedberg,Rangers,78,59,25,34
549,Anders Hedberg,Rangers,79,67,32,35
549,Anders Hedberg,Rangers,64,51,20,31
550,Guy Lapointe,Canadiens,1,0,0,0
550,Guy Lapointe,Canadiens,5,0,0,0
550,Guy Lapointe,Canadiens,78,44,15,29
550,Guy Lapointe,Canadiens,69,49,11,38
550,Guy Lapointe,Canadiens,76,54,19,35
550,Guy Lapointe,Canadiens,71,53,13,40
550,Guy Lapointe,Canadiens,80,75,28,47
550,Guy Lapointe,Canadiens,77,68,21,47
550,Guy Lapointe,Canadiens,77,76,25,51
550,Guy Lapointe,Canadiens,49,42,13,29
550,Guy Lapointe,Canadiens,69,55,13,42
550,Guy Lapointe,Canadiens,45,26,6,20
550,Guy Lapointe,Canadiens,33,10,1,9
550,Guy Lapointe,Canadiens,47,20,1,19
550,Guy Lapointe,Blues,8,6,0,6
550,Guy Lapointe,Blues,54,26,3,23
550,Guy Lapointe,Bruins,45,18,2,16
551,Martin Erat,Predators,80,33,9,24
551,Martin Erat,Predators,27,8,1,7
551,Martin Erat,Predators,76,49,16,33
551,Martin Erat,Predators,80,49,20,29
551,Martin Erat,Predators,68,57,16,41
551,Martin Erat,Predators,76,57,23,34
551,Martin Erat,Predators,71,50,17,33
551,Martin Erat,Predators,74,49,21,28
551,Martin Erat,Predators,64,50,17,33
551,Martin Erat,Predators,71,58,19,39
551,Martin Erat,Predators,36,21,4,17
551,Martin Erat,Capitals,9,3,1,2
551,Martin Erat,Capitals,53,24,1,23
551,Martin Erat,Coyotes,17,5,2,3
551,Martin Erat,Coyotes,23,10,4,6
552,Steve Rucchin,Ducks,43,17,6,11
552,Steve Rucchin,Ducks,64,44,19,25
552,Steve Rucchin,Ducks,79,67,19,48
552,Steve Rucchin,Ducks,72,53,17,36
552,Steve Rucchin,Ducks,69,62,23,39
552,Steve Rucchin,Ducks,71,57,19,38
552,Steve Rucchin,Ducks,16,8,3,5
552,Steve Rucchin,Ducks,38,23,7,16
552,Steve Rucchin,Ducks,82,58,20,38
552,Steve Rucchin,Ducks,82,43,20,23
552,Steve Rucchin,Rangers,72,36,13,23
552,Steve Rucchin,Thrashers,47,21,5,16
553,Patrick Boutette,Maple Leafs,77,32,10,22
553,Patrick Boutette,Maple Leafs,80,36,18,18
553,Patrick Boutette,Maple Leafs,80,36,17,19
553,Patrick Boutette,Maple Leafs,80,33,14,19
553,Patrick Boutette,Maple Leafs,32,4,0,4
553,Patrick Boutette,Whalers,47,44,13,31
553,Patrick Boutette,Whalers,80,80,28,52
553,Patrick Boutette,Penguins,80,74,23,51
553,Patrick Boutette,Penguins,80,56,27,29
553,Patrick Boutette,Penguins,73,40,14,26
553,Patrick Boutette,Penguins,14,4,1,3
553,Patrick Boutette,Whalers,33,14,6,8
554,Steve Konowalchuk,Capitals,1,0,0,0
554,Steve Konowalchuk,Capitals,36,11,4,7
554,Steve Konowalchuk,Capitals,62,26,12,14
554,Steve Konowalchuk,Capitals,46,25,11,14
554,Steve Konowalchuk,Capitals,70,45,23,22
554,Steve Konowalchuk,Capitals,78,42,17,25
554,Steve Konowalchuk,Capitals,80,34,10,24
554,Steve Konowalchuk,Capitals,45,24,12,12
554,Steve Konowalchuk,Capitals,82,43,16,27
554,Steve Konowalchuk,Capitals,82,47,24,23
554,Steve Konowalchuk,Capitals,28,14,2,12
554,Steve Konowalchuk,Capitals,77,30,15,15
554,Steve Konowalchuk,Capitals,6,1,0,1
554,Steve Konowalchuk,Avalanche,76,39,19,20
554,Steve Konowalchuk,Avalanche,21,15,6,9
555,Patrick Flatley,Islanders,16,9,2,7
555,Patrick Flatley,Islanders,78,51,20,31
555,Patrick Flatley,Islanders,73,52,18,34
555,Patrick Flatley,Islanders,63,51,16,35
555,Patrick Flatley,Islanders,40,24,9,15
555,Patrick Flatley,Islanders,41,25,10,15
555,Patrick Flatley,Islanders,62,49,17,32
555,Patrick Flatley,Islanders,56,45,20,25
555,Patrick Flatley,Islanders,38,36,8,28
555,Patrick Flatley,Islanders,80,60,13,47
555,Patrick Flatley,Islanders,64,42,12,30
555,Patrick Flatley,Islanders,45,27,7,20
555,Patrick Flatley,Islanders,56,17,8,9
555,Patrick Flatley,Rangers,68,22,10,12
556,Marty McInnis,Islanders,15,8,3,5
556,Marty McInnis,Islanders,56,30,10,20
556,Marty McInnis,Islanders,81,56,25,31
556,Marty McInnis,Islanders,41,16,9,7
556,Marty McInnis,Islanders,74,46,12,34
556,Marty McInnis,Islanders,70,42,20,22
556,Marty McInnis,Flames,10,7,3,4
556,Marty McInnis,Flames,75,44,19,25
556,Marty McInnis,Flames,6,2,1,1
556,Marty McInnis,Ducks,75,52,18,34
556,Marty McInnis,Ducks,62,28,10,18
556,Marty McInnis,Ducks,75,42,20,22
556,Marty McInnis,Ducks,60,23,9,14
556,Marty McInnis,Bruins,19,5,2,3
556,Marty McInnis,Bruins,77,19,9,10
557,Bob Errey,Penguins,65,22,9,13
557,Bob Errey,Penguins,16,2,0,2
557,Bob Errey,Penguins,37,17,11,6
557,Bob Errey,Penguins,72,34,16,18
557,Bob Errey,Penguins,17,9,3,6
557,Bob Errey,Penguins,76,58,26,32
557,Bob Errey,Penguins,78,39,20,19
557,Bob Errey,Penguins,79,42,20,22
557,Bob Errey,Penguins,78,35,19,16
557,Bob Errey,Penguins,54,14,8,6
557,Bob Errey,Sabres,8,4,1,3
557,Bob Errey,Sharks,64,30,12,18
557,Bob Errey,Sharks,13,4,2,2
557,Bob Errey,Red Wings,30,17,6,11
557,Bob Errey,Red Wings,71,32,11,21
557,Bob Errey,Red Wings,36,3,1,2
557,Bob Errey,Sharks,30,9,3,6
557,Bob Errey,Stars,59,11,2,9
557,Bob Errey,Rangers,12,0,0,0
558,R.J. Umberger,Flyers,73,38,20,18
558,R.J. Umberger,Flyers,81,28,16,12
558,R.J. Umberger,Flyers,74,50,13,37
558,R.J. Umberger,Blue Jackets,82,46,26,20
558,R.J. Umberger,Blue Jackets,82,55,23,32
558,R.J. Umberger,Blue Jackets,82,57,25,32
558,R.J. Umberger,Blue Jackets,77,40,20,20
558,R.J. Umberger,Blue Jackets,48,18,8,10
558,R.J. Umberger,Blue Jackets,74,34,18,16
558,R.J. Umberger,Flyers,22,3,1,2
559,James Neal,Stars,77,37,24,13
559,James Neal,Stars,78,55,27,28
559,James Neal,Stars,59,39,21,18
559,James Neal,Penguins,20,6,1,5
559,James Neal,Penguins,80,81,40,41
559,James Neal,Penguins,40,36,21,15
559,James Neal,Penguins,59,61,27,34
559,James Neal,Predators,22,14,9,5
560,Jonathan Cheechoo,Sharks,66,16,9,7
560,Jonathan Cheechoo,Sharks,81,47,28,19
560,Jonathan Cheechoo,Sharks,82,93,56,37
560,Jonathan Cheechoo,Sharks,76,69,37,32
560,Jonathan Cheechoo,Sharks,69,37,23,14
560,Jonathan Cheechoo,Sharks,66,29,12,17
560,Jonathan Cheechoo,Senators,61,14,5,9
561,Igor Larionov,Canucks,74,44,17,27
561,Igor Larionov,Canucks,64,34,13,21
561,Igor Larionov,Canucks,72,65,21,44
561,Igor Larionov,Sharks,60,56,18,38
561,Igor Larionov,Sharks,33,24,4,20
561,Igor Larionov,Sharks,4,2,1,1
561,Igor Larionov,Red Wings,69,71,21,50
561,Igor Larionov,Red Wings,64,54,12,42
561,Igor Larionov,Red Wings,69,47,8,39
561,Igor Larionov,Red Wings,75,63,14,49
561,Igor Larionov,Red Wings,79,47,9,38
561,Igor Larionov,Panthers,26,11,5,6
561,Igor Larionov,Red Wings,39,29,4,25
561,Igor Larionov,Red Wings,70,43,11,32
561,Igor Larionov,Red Wings,74,43,10,33
561,Igor Larionov,Devils,49,11,1,10
562,Carol Vadnais,Canadiens,11,3,0,3
562,Carol Vadnais,Canadiens,31,2,1,1
562,Carol Vadnais,Seals,76,42,15,27
562,Carol Vadnais,Seals,76,44,24,20
562,Carol Vadnais,Seals,42,26,10,16
562,Carol Vadnais,Seals,52,34,14,20
562,Carol Vadnais,Bruins,16,10,4,6
562,Carol Vadnais,Bruins,78,31,7,24
562,Carol Vadnais,Bruins,78,59,16,43
562,Carol Vadnais,Bruins,79,74,18,56
562,Carol Vadnais,Bruins,12,7,2,5
562,Carol Vadnais,Rangers,64,50,20,30
562,Carol Vadnais,Rangers,74,48,11,37
562,Carol Vadnais,Rangers,80,46,6,40
562,Carol Vadnais,Rangers,77,45,8,37
562,Carol Vadnais,Rangers,66,23,3,20
562,Carol Vadnais,Rangers,74,23,3,20
562,Carol Vadnais,Rangers,50,11,5,6
562,Carol Vadnais,Devils,51,9,2,7
563,Carey Wilson,Flames,15,7,2,5
563,Carey Wilson,Flames,74,72,24,48
563,Carey Wilson,Flames,76,58,29,29
563,Carey Wilson,Flames,80,56,20,36
563,Carey Wilson,Flames,34,30,9,21
563,Carey Wilson,Whalers,36,38,18,20
563,Carey Wilson,Whalers,34,22,11,11
563,Carey Wilson,Rangers,41,55,21,34
563,Carey Wilson,Rangers,41,26,9,17
563,Carey Wilson,Whalers,45,23,8,15
563,Carey Wilson,Flames,12,6,3,3
563,Carey Wilson,Flames,42,23,11,12
563,Carey Wilson,Flames,22,11,4,7
564,Andrew Ladd,Hurricanes,29,11,6,5
564,Andrew Ladd,Hurricanes,65,21,11,10
564,Andrew Ladd,Hurricanes,43,18,9,9
564,Andrew Ladd,Blackhawks,20,12,5,7
564,Andrew Ladd,Blackhawks,82,49,15,34
564,Andrew Ladd,Blackhawks,82,38,17,21
564,Andrew Ladd,Thrashers,81,59,29,30
564,Andrew Ladd,Jets,82,50,28,22
564,Andrew Ladd,Jets,48,46,18,28
564,Andrew Ladd,Jets,78,54,23,31
564,Andrew Ladd,Jets,25,16,8,8
565,Gary Sabourin,Blues,50,23,13,10
565,Gary Sabourin,Blues,75,48,25,23
565,Gary Sabourin,Blues,72,42,28,14
565,Gary Sabourin,Blues,59,31,14,17
565,Gary Sabourin,Blues,77,45,28,17
565,Gary Sabourin,Blues,76,48,21,27
565,Gary Sabourin,Blues,54,30,7,23
565,Gary Sabourin,Maple Leafs,55,23,5,18
565,Gary Sabourin,Seals,76,49,21,28
565,Gary Sabourin,Barons,33,18,7,11
566,Mike Keane,Canadiens,69,35,16,19
566,Mike Keane,Canadiens,74,24,9,15
566,Mike Keane,Canadiens,73,36,13,23
566,Mike Keane,Canadiens,67,41,11,30
566,Mike Keane,Canadiens,77,60,15,45
566,Mike Keane,Canadiens,80,46,16,30
566,Mike Keane,Canadiens,48,20,10,10
566,Mike Keane,Canadiens,18,7,0,7
566,Mike Keane,Avalanche,55,20,10,10
566,Mike Keane,Avalanche,81,27,10,17
566,Mike Keane,Rangers,70,18,8,10
566,Mike Keane,Stars,13,5,2,3
566,Mike Keane,Stars,81,29,6,23
566,Mike Keane,Stars,81,34,13,21
566,Mike Keane,Stars,67,24,10,14
566,Mike Keane,Blues,56,10,4,6
566,Mike Keane,Avalanche,22,7,2,5
566,Mike Keane,Avalanche,65,10,5,5
566,Mike Keane,Canucks,64,17,8,9
567,Bill Hicke,Canadiens,43,13,3,10
567,Bill Hicke,Canadiens,70,45,18,27
567,Bill Hicke,Canadiens,70,51,20,31
567,Bill Hicke,Canadiens,70,39,17,22
567,Bill Hicke,Canadiens,48,20,11,9
567,Bill Hicke,Canadiens,17,1,0,1
567,Bill Hicke,Rangers,40,17,6,11
567,Bill Hicke,Rangers,49,27,9,18
567,Bill Hicke,Rangers,48,7,3,4
567,Bill Hicke,Seals,52,40,21,19
567,Bill Hicke,Seals,67,61,25,36
567,Bill Hicke,Seals,69,44,15,29
567,Bill Hicke,Seals,74,35,18,17
567,Bill Hicke,Penguins,12,2,2,0
568,Mike Comrie,Oilers,41,22,8,14
568,Mike Comrie,Oilers,82,60,33,27
568,Mike Comrie,Oilers,69,51,20,31
568,Mike Comrie,Flyers,21,9,4,5
568,Mike Comrie,Coyotes,28,15,8,7
568,Mike Comrie,Coyotes,80,60,30,30
568,Mike Comrie,Coyotes,24,20,7,13
568,Mike Comrie,Senators,41,25,13,12
568,Mike Comrie,Islanders,76,49,21,28
568,Mike Comrie,Islanders,41,20,7,13
568,Mike Comrie,Senators,22,7,3,4
568,Mike Comrie,Oilers,43,21,13,8
568,Mike Comrie,Penguins,21,6,1,5
569,Gilles Tremblay,Canadiens,45,18,7,11
569,Gilles Tremblay,Canadiens,70,54,32,22
569,Gilles Tremblay,Canadiens,60,49,25,24
569,Gilles Tremblay,Canadiens,61,37,22,15
569,Gilles Tremblay,Canadiens,26,16,9,7
569,Gilles Tremblay,Canadiens,70,48,27,21
569,Gilles Tremblay,Canadiens,62,32,13,19
569,Gilles Tremblay,Canadiens,71,51,23,28
569,Gilles Tremblay,Canadiens,44,25,10,15